2022-09-25 18:00,WKS Śląsk II Wrocław(w),72 : 52P,52,13,37,35.1,5,24,20.8,18,61,29.5,11,24,45.8,10,19,29,13,23,21,12,11,0,2,37,AZS AGH Kraków,Sezon 2022/2023
2022-10-01 18:00,Sensation Kotwica Kołobrzeg(d),81 : 92P,81,18,34,52.9,8,28,28.6,26,62,41.9,21,31,67.7,8,18,26,21,22,23,10,8,3,3,83,AZS AGH Kraków,Sezon 2022/2023
2022-10-12 19:00,Dziki Warszawa(w),77 : 64P,64,15,31,48.4,10,31,32.3,25,62,40.3,4,6,66.7,9,20,29,15,20,13,17,6,4,2,62,AZS AGH Kraków,Sezon 2022/2023
2022-10-15 20:00,HydroTruck Radom(d),71 : 80P,71,15,24,62.5,12,39,30.8,27,63,42.9,5,12,41.7,7,25,32,21,16,16,14,6,2,2,75,AZS AGH Kraków,Sezon 2022/2023
2022-10-21 18:00,BS Polonia Bytom(w),77 : 88W,88,18,35,51.4,14,28,50.0,32,63,50.8,10,10,100.0,5,21,26,20,20,17,8,4,1,1,100,AZS AGH Kraków,Sezon 2022/2023
2022-10-29 20:00,Enea Basket Poznań(d),86 : 82W,86,21,34,61.8,8,23,34.8,29,57,50.9,20,32,62.5,6,23,29,21,25,28,15,10,2,1,93,AZS AGH Kraków,Sezon 2022/2023
2022-11-02 17:00,WKK Wrocław(w),89 : 69P,69,23,38,60.5,6,30,20.0,29,68,42.6,5,13,38.5,8,20,28,20,23,19,12,7,3,3,68,AZS AGH Kraków,Sezon 2022/2023
2022-11-05 18:00,MKKS Żak Koszalin(w),86 : 88W,88,26,43,60.5,8,27,29.6,34,70,48.6,12,14,85.7,8,19,27,20,17,16,12,5,0,2,90,AZS AGH Kraków,Sezon 2022/2023
2022-11-11 18:00,Start II Lublin(d),78 : 74W,78,23,44,52.3,9,34,26.5,32,78,41.0,5,9,55.6,12,30,42,16,25,18,10,6,0,3,82,AZS AGH Kraków,Sezon 2022/2023
2022-11-16 19:00,Górnik Trans.eu Zamek Książ Wałbrzych(w),86 : 70P,70,15,26,57.7,8,22,36.4,23,48,47.9,16,26,61.5,3,24,27,22,18,22,18,6,1,2,73,AZS AGH Kraków,Sezon 2022/2023
2022-11-20 18:00,Weegree AZS Politechnika Opolska(d),63 : 72P,63,18,43,41.9,4,20,20.0,22,63,34.9,15,24,62.5,9,16,25,17,24,26,12,9,3,1,55,AZS AGH Kraków,Sezon 2022/2023
2022-11-28 18:00,KKS Polonia Warszawa(w),72 : 70P,70,12,27,44.4,11,34,32.4,23,61,37.7,13,21,61.9,8,23,31,17,25,19,12,5,2,2,67,AZS AGH Kraków,Sezon 2022/2023
2022-12-03 15:00,PGE Turów Zgorzelec(d),79 : 75W,79,24,42,57.1,6,25,24.0,30,67,44.8,13,16,81.3,14,23,37,19,23,18,11,5,3,3,92,AZS AGH Kraków,Sezon 2022/2023
2022-12-10 20:00,GKS Tychy(w),94 : 73P,73,22,34,64.7,5,29,17.2,27,63,42.9,14,21,66.7,6,13,19,15,18,22,11,11,1,2,65,AZS AGH Kraków,Sezon 2022/2023
2022-12-14 20:00,SKS Starogard Gdański(d),61 : 66P,61,16,32,50.0,6,29,20.7,22,61,36.1,11,16,68.8,6,25,31,15,28,18,12,4,2,2,57,AZS AGH Kraków,Sezon 2022/2023
2022-12-17 15:00,Decka Pelplin(w),99 : 80P,80,14,31,45.2,9,27,33.3,23,58,39.7,25,36,69.4,7,17,24,21,23,27,10,7,4,5,80,AZS AGH Kraków,Sezon 2022/2023
2023-01-04 19:00,Miasto Szkła Krosno(d),74 : 73W,74,15,31,48.4,11,30,36.7,26,61,42.6,11,21,52.4,10,21,31,20,21,22,15,6,5,0,76,AZS AGH Kraków,Sezon 2022/2023
2023-01-07 20:00,WKS Śląsk II Wrocław(d),63 : 59W,63,12,29,41.4,8,30,26.7,20,59,33.9,15,20,75.0,6,20,26,14,22,22,19,12,4,1,56,AZS AGH Kraków,Sezon 2022/2023
2023-01-15 15:00,Sensation Kotwica Kołobrzeg(w),66 : 75W,75,12,32,37.5,9,30,30.0,21,62,33.9,24,29,82.8,14,33,47,14,15,23,18,9,3,4,84,AZS AGH Kraków,Sezon 2022/2023
2023-01-18 20:00,Dziki Warszawa(d),73 : 89P,73,21,38,55.3,5,25,20.0,26,63,41.3,16,22,72.7,5,27,32,12,23,21,15,9,2,5,70,AZS AGH Kraków,Sezon 2022/2023
2023-01-25 18:00,HydroTruck Radom(w),90 : 81P,81,20,37,54.1,10,30,33.3,30,67,44.8,11,15,73.3,6,24,30,13,23,20,20,9,3,5,75,AZS AGH Kraków,Sezon 2022/2023
2023-01-28 19:00,BS Polonia Bytom(d),79 : 76W,79,18,43,41.9,8,34,23.5,26,77,33.8,19,27,70.4,14,32,46,17,22,25,10,9,11,2,93,AZS AGH Kraków,Sezon 2022/2023
2023-02-04 15:00,Enea Basket Poznań(w),90 : 85P,85,17,30,56.7,10,41,24.4,27,71,38.0,21,27,77.8,18,23,41,18,26,25,14,9,0,0,89,AZS AGH Kraków,Sezon 2022/2023
2023-02-08 20:00,WKK Wrocław(d),81 : 76W,81,21,37,56.8,8,27,29.6,29,64,45.3,15,16,93.8,15,20,35,20,19,21,12,8,4,3,100,AZS AGH Kraków,Sezon 2022/2023
2023-02-11 15:00,MKKS Żak Koszalin(d),74 : 72W,74,15,34,44.1,9,25,36.0,24,59,40.7,17,23,73.9,10,22,32,18,18,23,17,7,3,1,76,AZS AGH Kraków,Sezon 2022/2023
2023-02-26 18:00,Górnik Trans.eu Zamek Książ Wałbrzych(d),88 : 95P,88,18,39,46.2,12,37,32.4,30,76,39.5,16,18,88.9,9,22,31,25,22,20,13,7,2,5,92,AZS AGH Kraków,Sezon 2022/2023
2023-03-01 17:00,Weegree AZS Politechnika Opolska(w),90 : 84P,84,16,31,51.6,13,31,41.9,29,62,46.8,13,20,65.0,5,21,26,20,24,23,13,8,0,2,85,AZS AGH Kraków,Sezon 2022/2023
2023-03-04 15:00,KKS Polonia Warszawa(d),71 : 79P,71,15,35,42.9,11,32,34.4,26,67,38.8,8,19,42.1,8,16,24,21,24,19,8,11,0,3,67,AZS AGH Kraków,Sezon 2022/2023
2023-03-08 18:00,Start II Lublin(w),64 : 106W,106,25,39,64.1,14,35,40.0,39,74,52.7,14,19,73.7,11,19,30,31,16,16,12,14,2,2,131,AZS AGH Kraków,Sezon 2022/2023
2023-03-12 18:00,PGE Turów Zgorzelec(w),69 : 78W,78,19,42,45.2,8,25,32.0,27,67,40.3,16,21,76.2,12,33,45,22,23,25,11,5,4,2,98,AZS AGH Kraków,Sezon 2022/2023
2023-03-18 15:00,GKS Tychy(d),77 : 91P,77,18,33,54.5,9,23,39.1,27,56,48.2,14,28,50.0,6,21,27,23,26,22,13,6,4,1,81,AZS AGH Kraków,Sezon 2022/2023
2023-03-25 18:00,SKS Starogard Gdański(w),88 : 83P,83,18,44,40.9,11,36,30.6,29,80,36.3,14,27,51.9,18,22,40,14,26,20,14,13,3,6,75,AZS AGH Kraków,Sezon 2022/2023
2023-04-01 18:00,Decka Pelplin(d),84 : 88P,84,16,37,43.2,13,36,36.1,29,73,39.7,13,22,59.1,15,19,34,12,27,23,10,9,6,4,82,AZS AGH Kraków,Sezon 2022/2023
2023-04-05 18:00,Miasto Szkła Krosno(w),68 : 82W,82,13,24,54.2,15,41,36.6,28,65,43.1,11,18,61.1,8,24,32,22,19,21,9,6,3,2,92,AZS AGH Kraków,Sezon 2022/2023
2022-09-24 17:00,HydroTruck Radom(w),99 : 91P,91,22,45,48.9,9,23,39.1,31,68,45.6,20,32,62.5,8,27,35,15,12,24,9,7,6,5,96,BS Polonia Bytom ,Sezon 2022/2023
2022-10-01 20:00,MKKS Żak Koszalin(w),94 : 74P,74,18,35,51.4,9,31,29.0,27,66,40.9,11,15,73.3,9,17,26,11,17,21,23,8,2,2,55,BS Polonia Bytom ,Sezon 2022/2023
2022-10-08 20:00,Enea Basket Poznań(w),83 : 71P,71,20,34,58.8,8,31,25.8,28,65,43.1,7,14,50.0,14,22,36,19,15,19,17,6,1,1,72,BS Polonia Bytom ,Sezon 2022/2023
2022-10-16 18:00,WKK Wrocław(w),96 : 62P,62,19,45,42.2,5,14,35.7,24,59,40.7,9,14,64.3,10,28,38,11,18,18,22,8,1,5,58,BS Polonia Bytom ,Sezon 2022/2023
2022-10-21 18:00,AZS AGH Kraków(d),77 : 88P,77,25,44,56.8,7,21,33.3,32,65,49.2,6,11,54.5,10,21,31,18,17,20,10,6,1,1,85,BS Polonia Bytom ,Sezon 2022/2023
2022-10-30 14:00,Start II Lublin(w),55 : 115W,115,34,55,61.8,11,26,42.3,45,81,55.6,14,21,66.7,16,41,57,28,20,20,14,13,3,1,159,BS Polonia Bytom ,Sezon 2022/2023
2022-11-02 16:00,Górnik Trans.eu Zamek Książ Wałbrzych(d),65 : 85P,65,14,36,38.9,8,22,36.4,22,58,37.9,13,21,61.9,9,26,35,14,12,22,17,3,3,2,59,BS Polonia Bytom ,Sezon 2022/2023
2022-11-06 18:00,Weegree AZS Politechnika Opolska(w),87 : 79P,79,16,30,53.3,12,38,31.6,28,68,41.2,11,12,91.7,9,15,24,17,24,14,12,4,2,3,73,BS Polonia Bytom ,Sezon 2022/2023
2022-11-12 20:00,KKS Polonia Warszawa(w),85 : 75P,75,25,54,46.3,4,15,26.7,29,69,42.0,13,19,68.4,8,23,31,13,18,22,10,7,2,7,72,BS Polonia Bytom ,Sezon 2022/2023
2022-11-16 17:00,PGE Turów Zgorzelec(w),97 : 80P,80,22,41,53.7,5,20,25.0,27,61,44.3,21,28,75.0,8,20,28,19,21,24,14,6,3,1,81,BS Polonia Bytom ,Sezon 2022/2023
2022-11-19 18:00,GKS Tychy(d),81 : 71W,81,14,26,53.8,13,32,40.6,27,58,46.6,14,26,53.8,4,24,28,13,22,25,11,8,0,1,76,BS Polonia Bytom ,Sezon 2022/2023
2022-11-27 15:00,SKS Starogard Gdański(w),97 : 87P,87,21,39,53.8,12,30,40.0,33,69,47.8,9,12,75.0,9,14,23,15,19,17,13,16,4,4,93,BS Polonia Bytom ,Sezon 2022/2023
2022-12-04 15:00,Decka Pelplin(w),83 : 72P,72,22,45,48.9,5,25,20.0,27,70,38.6,13,18,72.2,10,24,34,15,22,23,16,10,1,6,68,BS Polonia Bytom ,Sezon 2022/2023
2022-12-11 18:00,Miasto Szkła Krosno(w),70 : 82W,82,21,47,44.7,9,23,39.1,30,70,42.9,13,17,76.5,10,22,32,14,13,19,12,13,3,5,88,BS Polonia Bytom ,Sezon 2022/2023
2022-12-14 18:00,WKS Śląsk II Wrocław(d),61 : 78P,61,17,41,41.5,5,22,22.7,22,63,34.9,12,19,63.2,9,24,33,11,25,18,11,9,3,1,58,BS Polonia Bytom ,Sezon 2022/2023
2022-12-17 18:00,Sensation Kotwica Kołobrzeg(w),75 : 83W,83,17,38,44.7,11,25,44.0,28,63,44.4,16,26,61.5,11,32,43,11,16,19,11,4,4,2,89,BS Polonia Bytom ,Sezon 2022/2023
2023-01-04 18:00,Dziki Warszawa(d),69 : 88P,69,19,41,46.3,6,21,28.6,25,62,40.3,13,22,59.1,10,32,42,11,26,21,21,3,1,0,59,BS Polonia Bytom ,Sezon 2022/2023
2023-01-08 18:00,HydroTruck Radom(d),67 : 93P,67,17,36,47.2,9,32,28.1,26,68,38.2,6,12,50.0,5,20,25,17,19,16,10,8,2,0,61,BS Polonia Bytom ,Sezon 2022/2023
2023-01-14 20:00,MKKS Żak Koszalin(d),86 : 107P,86,24,41,58.5,6,25,24.0,30,66,45.5,20,30,66.7,13,19,32,14,21,20,12,2,0,1,76,BS Polonia Bytom ,Sezon 2022/2023
2023-01-18 19:00,Enea Basket Poznań(d),70 : 83P,70,20,42,47.6,8,21,38.1,28,63,44.4,6,11,54.5,9,18,27,16,19,18,11,6,2,0,70,BS Polonia Bytom ,Sezon 2022/2023
2023-01-21 15:00,WKK Wrocław(d),76 : 74W,76,22,42,52.4,7,19,36.8,29,61,47.5,11,25,44.0,8,31,39,17,23,17,13,5,4,2,82,BS Polonia Bytom ,Sezon 2022/2023
2023-01-28 19:00,AZS AGH Kraków(w),79 : 76P,76,26,56,46.4,2,14,14.3,28,70,40.0,18,22,81.8,7,33,40,11,25,21,13,4,2,11,74,BS Polonia Bytom ,Sezon 2022/2023
2023-02-01 18:00,Start II Lublin(d),80 : 74W,80,23,44,52.3,8,28,28.6,31,72,43.1,10,16,62.5,11,26,37,15,17,15,7,8,1,2,87,BS Polonia Bytom ,Sezon 2022/2023
2023-02-08 18:00,Górnik Trans.eu Zamek Książ Wałbrzych(w),82 : 71P,71,18,31,58.1,9,29,31.0,27,60,45.0,8,14,57.1,7,28,35,15,19,17,21,8,0,2,69,BS Polonia Bytom ,Sezon 2022/2023
2023-02-11 18:00,Weegree AZS Politechnika Opolska(d),89 : 84W,89,20,37,54.1,9,25,36.0,29,62,46.8,22,32,68.8,10,25,35,15,20,25,12,6,1,0,91,BS Polonia Bytom ,Sezon 2022/2023
2023-02-18 20:00,KKS Polonia Warszawa(d),103 : 111P,103,25,55,45.5,11,24,45.8,36,79,45.6,20,25,80.0,12,21,33,17,20,20,15,7,2,5,99,BS Polonia Bytom ,Sezon 2022/2023
2023-02-25 18:00,PGE Turów Zgorzelec(d),86 : 64W,86,20,41,48.8,12,23,52.2,32,64,50.0,10,17,58.8,7,28,35,20,15,19,16,6,3,1,95,BS Polonia Bytom ,Sezon 2022/2023
2023-03-01 18:00,GKS Tychy(w),96 : 87P,87,25,54,46.3,8,25,32.0,33,79,41.8,13,24,54.2,12,23,35,12,24,21,2,9,3,6,87,BS Polonia Bytom ,Sezon 2022/2023
2023-03-04 18:00,SKS Starogard Gdański(d),86 : 80W,86,27,49,55.1,5,22,22.7,32,71,45.1,17,28,60.7,13,28,41,13,20,21,7,5,2,0,90,BS Polonia Bytom ,Sezon 2022/2023
2023-03-12 15:00,Decka Pelplin(d),86 : 97P,86,19,41,46.3,12,29,41.4,31,70,44.3,12,19,63.2,5,27,32,15,22,20,8,6,1,2,86,BS Polonia Bytom ,Sezon 2022/2023
2023-03-18 18:00,Miasto Szkła Krosno(d),80 : 85P,80,17,43,39.5,10,25,40.0,27,68,39.7,16,25,64.0,13,16,29,16,18,22,8,7,1,2,75,BS Polonia Bytom ,Sezon 2022/2023
2023-03-26 15:00,WKS Śląsk II Wrocław(w),95 : 84P,84,24,43,55.8,7,21,33.3,31,64,48.4,15,24,62.5,9,23,32,15,22,23,18,6,3,3,80,BS Polonia Bytom ,Sezon 2022/2023
2023-04-01 18:00,Sensation Kotwica Kołobrzeg(d),77 : 107P,77,16,41,39.0,9,32,28.1,25,73,34.2,18,30,60.0,9,26,35,15,14,18,7,6,3,3,69,BS Polonia Bytom ,Sezon 2022/2023
2023-04-05 18:00,Dziki Warszawa(w),91 : 90P,90,23,41,56.1,9,22,40.9,32,63,50.8,17,28,60.7,8,24,32,22,21,20,11,8,3,3,102,BS Polonia Bytom ,Sezon 2022/2023
2022-09-24 18:00,Górnik Trans.eu Zamek Książ Wałbrzych(d),68 : 89P,68,13,29,44.8,9,33,27.3,22,62,35.5,15,18,83.3,8,18,26,11,19,21,13,3,1,2,53,Decka Pelplin,Sezon 2022/2023
2022-10-02 18:00,Weegree AZS Politechnika Opolska(w),70 : 79W,79,13,35,37.1,10,27,37.0,23,62,37.1,23,34,67.6,6,26,32,12,25,28,11,12,2,4,76,Decka Pelplin,Sezon 2022/2023
2022-10-08 18:00,KKS Polonia Warszawa(d),79 : 59W,79,20,47,42.6,9,21,42.9,29,68,42.6,12,15,80.0,6,34,40,14,14,17,12,4,2,6,85,Decka Pelplin,Sezon 2022/2023
2022-10-16 15:00,PGE Turów Zgorzelec(w),87 : 86P,86,25,40,62.5,6,18,33.3,31,58,53.4,18,26,69.2,10,22,32,15,19,20,13,5,2,2,92,Decka Pelplin,Sezon 2022/2023
2022-10-22 15:00,GKS Tychy(d),60 : 76P,60,17,35,48.6,5,30,16.7,22,65,33.8,11,20,55.0,12,26,38,11,29,22,9,7,3,0,58,Decka Pelplin,Sezon 2022/2023
2022-10-26 19:00,SKS Starogard Gdański(w),72 : 56P,56,17,54,31.5,6,24,25.0,23,78,29.5,4,8,50.0,13,23,36,12,23,13,10,6,6,7,47,Decka Pelplin,Sezon 2022/2023
2022-11-02 19:00,MKKS Żak Koszalin(d),84 : 86P,84,25,42,59.5,5,12,41.7,30,54,55.6,19,28,67.9,4,30,34,22,23,23,23,13,3,2,100,Decka Pelplin,Sezon 2022/2023
2022-11-06 15:00,Miasto Szkła Krosno(d),74 : 80P,74,18,40,45.0,9,29,31.0,27,69,39.1,11,17,64.7,11,26,37,19,28,18,19,8,7,5,78,Decka Pelplin,Sezon 2022/2023
2022-11-10 18:00,WKS Śląsk II Wrocław(w),68 : 72W,72,19,39,48.7,7,26,26.9,26,65,40.0,13,20,65.0,9,26,35,13,20,23,13,5,2,5,68,Decka Pelplin,Sezon 2022/2023
2022-11-16 20:00,Sensation Kotwica Kołobrzeg(d),74 : 77P,74,21,40,52.5,10,25,40.0,31,65,47.7,2,3,66.7,6,24,30,21,17,15,15,5,3,2,83,Decka Pelplin,Sezon 2022/2023
2022-11-26 15:00,HydroTruck Radom(d),76 : 81P,76,20,38,52.6,10,26,38.5,30,64,46.9,6,10,60.0,9,26,35,18,19,16,16,7,5,5,87,Decka Pelplin,Sezon 2022/2023
2022-12-04 15:00,BS Polonia Bytom(d),83 : 72W,83,20,36,55.6,8,25,32.0,28,61,45.9,19,25,76.0,8,28,36,18,23,21,18,5,6,1,91,Decka Pelplin,Sezon 2022/2023
2022-12-09 20:00,Enea Basket Poznań(d),76 : 69W,76,24,47,51.1,6,28,21.4,30,75,40.0,10,15,66.7,15,24,39,18,22,20,9,5,2,2,81,Decka Pelplin,Sezon 2022/2023
2022-12-14 17:00,WKK Wrocław(w),69 : 82W,82,24,44,54.5,8,28,28.6,32,72,44.4,10,18,55.6,10,34,44,19,26,20,15,6,1,1,89,Decka Pelplin,Sezon 2022/2023
2022-12-17 15:00,AZS AGH Kraków(d),99 : 80W,99,25,51,49.0,10,23,43.5,35,74,47.3,19,26,73.1,19,29,48,20,27,22,10,6,5,4,122,Decka Pelplin,Sezon 2022/2023
2022-12-21 18:00,Dziki Warszawa(w),90 : 93W,93,31,61,50.8,6,19,31.6,37,80,46.3,13,16,81.3,12,29,41,18,30,19,12,8,11,3,113,Decka Pelplin,Sezon 2022/2023
2023-01-04 16:00,Start II Lublin(w),59 : 105W,105,32,44,72.7,12,29,41.4,44,73,60.3,5,8,62.5,8,22,30,25,17,10,11,18,7,1,142,Decka Pelplin,Sezon 2022/2023
2023-01-08 18:00,Górnik Trans.eu Zamek Książ Wałbrzych(w),72 : 60P,60,8,30,26.7,9,30,30.0,17,60,28.3,17,26,65.4,6,24,30,12,21,23,12,6,3,2,47,Decka Pelplin,Sezon 2022/2023
2023-01-14 20:00,Weegree AZS Politechnika Opolska(d),86 : 65W,86,23,40,57.5,10,25,40.0,33,65,50.8,10,16,62.5,5,28,33,21,29,16,13,8,4,4,101,Decka Pelplin,Sezon 2022/2023
2023-01-18 20:00,KKS Polonia Warszawa(w),79 : 72P,72,19,38,50.0,7,20,35.0,26,58,44.8,13,16,81.3,4,24,28,18,20,17,13,8,3,5,81,Decka Pelplin,Sezon 2022/2023
2023-01-22 18:00,PGE Turów Zgorzelec(d),91 : 84W,91,22,42,52.4,11,30,36.7,33,72,45.8,14,27,51.9,13,31,44,17,28,29,16,4,1,6,89,Decka Pelplin,Sezon 2022/2023
2023-01-28 15:00,GKS Tychy(w),81 : 48P,48,14,31,45.2,3,23,13.0,17,54,31.5,11,25,44.0,6,20,26,14,20,18,15,5,3,3,30,Decka Pelplin,Sezon 2022/2023
2023-02-04 18:00,SKS Starogard Gdański(d),104 : 115P,104,27,51,52.9,9,27,33.3,36,78,46.2,23,33,69.7,9,23,32,22,34,27,7,6,2,2,107,Decka Pelplin,Sezon 2022/2023
2023-02-08 18:00,MKKS Żak Koszalin(w),77 : 78W,78,21,37,56.8,6,20,30.0,27,57,47.4,18,23,78.3,6,23,29,20,21,20,13,8,6,4,93,Decka Pelplin,Sezon 2022/2023
2023-02-12 20:00,Miasto Szkła Krosno(w),83 : 82P,82,23,38,60.5,7,17,41.2,30,55,54.5,15,26,57.7,5,21,26,26,18,26,11,6,3,2,96,Decka Pelplin,Sezon 2022/2023
2023-02-22 18:30,WKS Śląsk II Wrocław(d),70 : 64W,70,19,42,45.2,5,17,29.4,24,59,40.7,17,26,65.4,11,23,34,17,18,24,9,12,2,3,82,Decka Pelplin,Sezon 2022/2023
2023-02-25 15:00,Sensation Kotwica Kołobrzeg(w),79 : 68P,68,19,34,55.9,6,25,24.0,25,59,42.4,12,18,66.7,5,27,32,18,24,19,14,4,1,1,69,Decka Pelplin,Sezon 2022/2023
2023-03-01 17:00,Dziki Warszawa(d),62 : 73P,62,17,41,41.5,5,19,26.3,22,60,36.7,13,17,76.5,8,24,32,13,24,18,13,7,1,3,60,Decka Pelplin,Sezon 2022/2023
2023-03-08 19:00,HydroTruck Radom(w),79 : 83W,83,26,43,60.5,6,21,28.6,32,64,50.0,13,21,61.9,7,36,43,24,23,23,16,5,1,1,100,Decka Pelplin,Sezon 2022/2023
2023-03-12 15:00,BS Polonia Bytom(w),86 : 97W,97,27,47,57.4,10,23,43.5,37,70,52.9,13,20,65.0,9,32,41,15,21,22,12,5,2,1,108,Decka Pelplin,Sezon 2022/2023
2023-03-19 18:00,Enea Basket Poznań(w),61 : 71W,71,20,45,44.4,2,15,13.3,22,60,36.7,25,37,67.6,13,33,46,11,24,25,15,6,2,1,71,Decka Pelplin,Sezon 2022/2023
2023-03-26 15:00,WKK Wrocław(d),77 : 72W,77,24,46,52.2,7,20,35.0,31,66,47.0,8,14,57.1,10,28,38,17,21,18,17,6,3,3,83,Decka Pelplin,Sezon 2022/2023
2023-04-01 18:00,AZS AGH Kraków(w),84 : 88W,88,20,39,51.3,6,23,26.1,26,62,41.9,30,42,71.4,18,26,44,16,23,25,15,5,4,6,94,Decka Pelplin,Sezon 2022/2023
2023-04-05 18:00,Start II Lublin(d),130 : 56W,130,41,55,74.5,9,17,52.9,50,72,69.4,21,28,75.0,8,31,39,40,21,19,13,20,7,0,194,Decka Pelplin,Sezon 2022/2023
2023-04-15 16:00,Dziki Warszawa(w),85 : 73P,73,20,40,50.0,5,17,29.4,25,57,43.9,18,26,69.2,8,18,26,12,29,22,18,14,1,2,68,Decka Pelplin,Sezon 2022/2023
2023-04-16 16:00,Dziki Warszawa(w),82 : 69P,69,19,47,40.4,3,13,23.1,22,60,36.7,22,33,66.7,11,28,39,11,33,26,15,10,3,5,68,Decka Pelplin,Sezon 2022/2023
2023-04-22 16:00,Dziki Warszawa(d),62 : 88P,62,19,40,47.5,5,25,20.0,24,65,36.9,9,14,64.3,9,20,29,15,22,15,13,11,3,2,61,Decka Pelplin,Sezon 2022/2023
2022-09-24 18:00,Enea Basket Poznań(d),62 : 54W,62,14,30,46.7,7,25,28.0,21,55,38.2,13,18,72.2,14,25,39,17,24,23,24,7,3,1,65,Dziki Warszawa,Sezon 2022/2023
2022-10-01 20:00,WKK Wrocław(w),73 : 75W,75,15,30,50.0,10,29,34.5,25,59,42.4,15,20,75.0,6,19,25,13,24,23,14,8,3,1,71,Dziki Warszawa,Sezon 2022/2023
2022-10-12 19:00,AZS AGH Kraków(d),77 : 64W,77,24,42,57.1,4,14,28.6,28,56,50.0,17,26,65.4,8,26,34,23,13,20,13,11,2,4,97,Dziki Warszawa,Sezon 2022/2023
2022-10-15 14:00,Start II Lublin(w),63 : 95W,95,31,44,70.5,7,25,28.0,38,69,55.1,12,19,63.2,8,29,37,31,14,16,14,9,5,1,125,Dziki Warszawa,Sezon 2022/2023
2022-10-23 15:00,Górnik Trans.eu Zamek Książ Wałbrzych(d),76 : 72W,76,19,40,47.5,9,19,47.4,28,59,47.5,11,16,68.8,6,24,30,16,17,22,9,5,1,2,83,Dziki Warszawa,Sezon 2022/2023
2022-10-29 15:00,Weegree AZS Politechnika Opolska(w),70 : 54P,54,14,33,42.4,2,16,12.5,16,49,32.7,20,37,54.1,9,13,22,11,21,31,13,11,5,3,40,Dziki Warszawa,Sezon 2022/2023
2022-11-02 18:00,KKS Polonia Warszawa(d),76 : 58W,76,25,48,52.1,4,17,23.5,29,65,44.6,14,22,63.6,8,29,37,25,16,20,9,10,4,5,99,Dziki Warszawa,Sezon 2022/2023
2022-11-05 15:00,PGE Turów Zgorzelec(w),69 : 91W,91,25,42,59.5,6,21,28.6,31,63,49.2,23,25,92.0,8,24,32,22,18,25,6,12,1,2,118,Dziki Warszawa,Sezon 2022/2023
2022-11-13 20:00,GKS Tychy(d),90 : 83W,90,27,42,64.3,8,20,40.0,35,62,56.5,12,17,70.6,10,22,32,27,20,24,18,12,2,3,113,Dziki Warszawa,Sezon 2022/2023
2022-11-17 19:00,SKS Starogard Gdański(w),91 : 71P,71,20,44,45.5,6,23,26.1,26,67,38.8,13,18,72.2,11,25,36,18,21,19,11,5,5,1,78,Dziki Warszawa,Sezon 2022/2023
2022-11-27 18:00,Miasto Szkła Krosno(w),87 : 65P,65,17,42,40.5,8,26,30.8,25,68,36.8,7,14,50.0,12,20,32,18,22,21,11,9,0,3,63,Dziki Warszawa,Sezon 2022/2023
2022-12-03 18:00,WKS Śląsk II Wrocław(d),73 : 63W,73,23,52,44.2,6,16,37.5,29,68,42.6,9,13,69.2,14,22,36,15,17,13,10,8,0,5,79,Dziki Warszawa,Sezon 2022/2023
2022-12-10 18:00,Sensation Kotwica Kołobrzeg(w),62 : 67W,67,19,43,44.2,5,19,26.3,24,62,38.7,14,26,53.8,7,29,36,14,17,22,10,12,4,0,73,Dziki Warszawa,Sezon 2022/2023
2022-12-14 18:00,MKKS Żak Koszalin(d),76 : 60W,76,18,45,40.0,7,29,24.1,25,74,33.8,19,23,82.6,16,21,37,18,17,18,13,17,5,8,87,Dziki Warszawa,Sezon 2022/2023
2022-12-17 18:00,HydroTruck Radom(d),79 : 66W,79,19,40,47.5,11,26,42.3,30,66,45.5,8,16,50.0,11,28,39,23,19,19,16,11,3,1,95,Dziki Warszawa,Sezon 2022/2023
2022-12-21 18:00,Decka Pelplin(d),90 : 93P,90,20,45,44.4,9,31,29.0,29,76,38.2,23,42,54.8,15,26,41,22,19,30,10,7,3,11,87,Dziki Warszawa,Sezon 2022/2023
2023-01-04 18:00,BS Polonia Bytom(w),69 : 88W,88,25,45,55.6,6,24,25.0,31,69,44.9,20,27,74.1,4,31,35,20,21,24,9,13,0,1,102,Dziki Warszawa,Sezon 2022/2023
2023-01-07 20:00,Enea Basket Poznań(w),62 : 70W,70,22,39,56.4,5,17,29.4,27,56,48.2,11,22,50.0,8,26,34,18,23,25,19,11,3,2,77,Dziki Warszawa,Sezon 2022/2023
2023-01-14 18:00,WKK Wrocław(d),95 : 100P,95,27,49,55.1,11,29,37.9,38,78,48.7,8,20,40.0,10,18,28,28,29,24,15,12,1,3,97,Dziki Warszawa,Sezon 2022/2023
2023-01-18 20:00,AZS AGH Kraków(w),73 : 89W,89,29,47,61.7,5,22,22.7,34,69,49.3,16,31,51.6,15,25,40,24,21,22,14,12,5,2,106,Dziki Warszawa,Sezon 2022/2023
2023-01-22 15:00,Start II Lublin(d),110 : 71W,110,27,38,71.1,15,33,45.5,42,71,59.2,11,21,52.4,7,24,31,39,14,17,12,23,5,1,157,Dziki Warszawa,Sezon 2022/2023
2023-01-29 18:00,Górnik Trans.eu Zamek Książ Wałbrzych(w),57 : 45P,45,7,27,25.9,5,19,26.3,12,46,26.1,16,26,61.5,6,29,35,9,15,21,20,7,2,4,34,Dziki Warszawa,Sezon 2022/2023
2023-02-04 20:00,Weegree AZS Politechnika Opolska(d),97 : 50W,97,21,33,63.6,10,19,52.6,31,52,59.6,25,28,89.3,6,21,27,26,20,21,14,15,3,2,130,Dziki Warszawa,Sezon 2022/2023
2023-02-08 20:00,KKS Polonia Warszawa(w),81 : 67P,67,19,39,48.7,4,18,22.2,23,57,40.4,17,25,68.0,8,26,34,10,24,22,19,10,4,3,64,Dziki Warszawa,Sezon 2022/2023
2023-02-12 19:00,PGE Turów Zgorzelec(d),82 : 64W,82,17,39,43.6,10,22,45.5,27,61,44.3,18,25,72.0,13,33,46,23,19,20,11,3,0,3,102,Dziki Warszawa,Sezon 2022/2023
2023-02-18 18:00,GKS Tychy(w),72 : 66P,66,15,32,46.9,7,28,25.0,22,60,36.7,15,18,83.3,6,22,28,13,24,23,10,5,2,2,63,Dziki Warszawa,Sezon 2022/2023
2023-02-25 20:00,SKS Starogard Gdański(d),81 : 75W,81,25,50,50.0,4,20,20.0,29,70,41.4,19,30,63.3,8,26,34,22,23,30,8,7,2,6,86,Dziki Warszawa,Sezon 2022/2023
2023-03-01 17:00,Decka Pelplin(w),62 : 73W,73,20,40,50.0,6,19,31.6,26,59,44.1,15,23,65.2,7,31,38,18,18,24,10,6,3,1,87,Dziki Warszawa,Sezon 2022/2023
2023-03-05 18:00,Miasto Szkła Krosno(d),74 : 70W,74,21,31,67.7,8,23,34.8,29,54,53.7,8,17,47.1,4,25,29,16,19,21,13,5,4,1,81,Dziki Warszawa,Sezon 2022/2023
2023-03-12 15:00,WKS Śląsk II Wrocław(w),73 : 75W,75,22,42,52.4,6,19,31.6,28,61,45.9,13,27,48.1,12,25,37,20,22,25,10,9,1,6,85,Dziki Warszawa,Sezon 2022/2023
2023-03-18 20:00,Sensation Kotwica Kołobrzeg(d),67 : 66W,67,18,33,54.5,6,26,23.1,24,59,40.7,13,22,59.1,7,29,36,18,15,20,12,6,2,1,73,Dziki Warszawa,Sezon 2022/2023
2023-03-26 18:00,MKKS Żak Koszalin(w),82 : 86W,86,22,40,55.0,6,22,27.3,28,62,45.2,24,29,82.8,6,27,33,15,27,29,15,11,1,5,92,Dziki Warszawa,Sezon 2022/2023
2023-03-29 18:30,HydroTruck Radom(w),63 : 91W,91,28,42,66.7,9,22,40.9,37,64,57.8,8,10,80.0,8,22,30,27,22,18,10,17,1,2,127,Dziki Warszawa,Sezon 2022/2023
2023-04-05 18:00,BS Polonia Bytom(d),91 : 90W,91,29,42,69.0,8,27,29.6,37,69,53.6,9,23,39.1,10,27,37,22,20,21,11,6,3,3,102,Dziki Warszawa,Sezon 2022/2023
2023-04-15 16:00,Decka Pelplin(d),85 : 73W,85,19,31,61.3,8,29,27.6,27,60,45.0,23,31,74.2,13,23,36,18,23,28,20,13,2,1,93,Dziki Warszawa,Sezon 2022/2023
2023-04-16 16:00,Decka Pelplin(d),82 : 69W,82,12,29,41.4,9,24,37.5,21,53,39.6,31,42,73.8,8,25,33,23,26,32,14,4,5,3,90,Dziki Warszawa,Sezon 2022/2023
2023-04-22 16:00,Decka Pelplin(w),62 : 88W,88,16,29,55.2,14,31,45.2,30,60,50.0,14,27,51.9,13,28,41,21,15,22,15,8,2,3,102,Dziki Warszawa,Sezon 2022/2023
2023-04-29 17:00,HydroTruck Radom(d),80 : 74W,80,17,42,40.5,11,36,30.6,28,78,35.9,13,23,56.5,18,23,41,19,15,21,6,8,6,2,88,Dziki Warszawa,Sezon 2022/2023
2023-04-30 17:00,HydroTruck Radom(d),86 : 73W,86,19,33,57.6,9,23,39.1,28,56,50.0,21,32,65.6,8,23,31,24,21,22,13,12,2,1,103,Dziki Warszawa,Sezon 2022/2023
2023-05-06 19:00,HydroTruck Radom(w),96 : 87P,87,19,28,67.9,11,31,35.5,30,59,50.8,16,27,59.3,7,19,26,24,20,23,12,7,5,2,97,Dziki Warszawa,Sezon 2022/2023
2023-05-07 19:00,HydroTruck Radom(w),72 : 74W,74,15,27,55.6,8,28,28.6,23,55,41.8,20,31,64.5,8,23,31,19,22,28,16,5,2,1,72,Dziki Warszawa,Sezon 2022/2023
2023-05-13 19:00,Górnik Trans.eu Zamek Książ Wałbrzych(w),66 : 73W,73,21,37,56.8,7,27,25.9,28,64,43.8,10,20,50.0,9,29,38,18,17,23,18,13,3,4,81,Dziki Warszawa,Sezon 2022/2023
2023-05-14 19:00,Górnik Trans.eu Zamek Książ Wałbrzych(w),57 : 72W,72,18,30,60.0,9,28,32.1,27,58,46.6,9,12,75.0,5,27,32,17,21,15,14,7,3,5,83,Dziki Warszawa,Sezon 2022/2023
2023-05-20 20:00,Górnik Trans.eu Zamek Książ Wałbrzych(d),66 : 62W,66,14,43,32.6,9,22,40.9,23,65,35.4,11,18,61.1,9,29,38,16,19,21,9,8,2,7,72,Dziki Warszawa,Sezon 2022/2023
2022-09-24 18:00,Dziki Warszawa(w),62 : 54P,54,11,30,36.7,5,23,21.7,16,53,30.2,17,29,58.6,9,19,28,16,23,23,18,13,1,3,45,Enea Basket Poznań,Sezon 2022/2023
2022-10-01 15:00,HydroTruck Radom(d),89 : 94P,89,21,40,52.5,13,36,36.1,34,76,44.7,8,12,66.7,12,30,42,21,17,20,21,8,2,3,95,Enea Basket Poznań,Sezon 2022/2023
2022-10-08 20:00,BS Polonia Bytom(d),83 : 71W,83,22,39,56.4,11,31,35.5,33,70,47.1,6,9,66.7,9,24,33,21,19,15,8,7,1,1,97,Enea Basket Poznań,Sezon 2022/2023
2022-10-15 18:00,MKKS Żak Koszalin(w),94 : 103W,103,23,34,67.6,14,29,48.3,37,63,58.7,15,24,62.5,7,26,33,22,24,21,18,10,0,1,115,Enea Basket Poznań,Sezon 2022/2023
2022-10-22 20:00,WKK Wrocław(d),80 : 62W,80,14,31,45.2,12,34,35.3,26,65,40.0,16,22,72.7,11,29,40,16,22,15,14,11,2,1,90,Enea Basket Poznań,Sezon 2022/2023
2022-10-29 20:00,AZS AGH Kraków(w),86 : 82P,82,24,37,64.9,5,24,20.8,29,61,47.5,19,28,67.9,11,18,29,17,28,25,17,8,1,2,79,Enea Basket Poznań,Sezon 2022/2023
2022-11-02 20:00,Start II Lublin(d),109 : 51W,109,34,51,66.7,10,35,28.6,44,86,51.2,11,14,78.6,18,29,47,30,13,20,12,22,4,1,155,Enea Basket Poznań,Sezon 2022/2023
2022-11-06 18:00,Górnik Trans.eu Zamek Książ Wałbrzych(w),87 : 81P,81,16,39,41.0,11,30,36.7,27,69,39.1,16,19,84.2,13,18,31,19,22,20,12,9,2,2,85,Enea Basket Poznań,Sezon 2022/2023
2022-11-12 20:00,Weegree AZS Politechnika Opolska(d),93 : 67W,93,15,26,57.7,14,33,42.4,29,59,49.2,21,26,80.8,8,25,33,23,22,24,8,5,2,0,113,Enea Basket Poznań,Sezon 2022/2023
2022-11-16 18:00,KKS Polonia Warszawa(w),69 : 59P,59,17,44,38.6,4,23,17.4,21,67,31.3,13,22,59.1,14,23,37,13,21,23,11,10,2,5,55,Enea Basket Poznań,Sezon 2022/2023
2022-11-20 15:00,PGE Turów Zgorzelec(d),93 : 74W,93,27,45,60.0,10,22,45.5,37,67,55.2,9,10,90.0,9,24,33,26,25,17,15,10,1,0,117,Enea Basket Poznań,Sezon 2022/2023
2022-11-26 20:00,GKS Tychy(w),102 : 94P,94,25,39,64.1,8,37,21.6,33,76,43.4,20,28,71.4,6,28,34,12,32,28,16,4,2,4,79,Enea Basket Poznań,Sezon 2022/2023
2022-12-03 20:00,SKS Starogard Gdański(d),80 : 89P,80,21,36,58.3,10,27,37.0,31,63,49.2,8,15,53.3,6,25,31,18,21,17,9,5,2,1,88,Enea Basket Poznań,Sezon 2022/2023
2022-12-09 20:00,Decka Pelplin(w),76 : 69P,69,16,35,45.7,7,27,25.9,23,62,37.1,16,22,72.7,11,27,38,15,20,22,14,4,2,2,69,Enea Basket Poznań,Sezon 2022/2023
2022-12-14 20:00,Miasto Szkła Krosno(d),62 : 68P,62,13,22,59.1,8,32,25.0,21,54,38.9,12,23,52.2,4,22,26,10,20,23,11,12,1,3,56,Enea Basket Poznań,Sezon 2022/2023
2022-12-18 20:00,WKS Śląsk II Wrocław(w),74 : 58P,58,17,36,47.2,6,24,25.0,23,60,38.3,6,14,42.9,8,23,31,14,19,20,17,5,2,8,48,Enea Basket Poznań,Sezon 2022/2023
2023-01-04 20:00,Sensation Kotwica Kołobrzeg(d),63 : 67P,63,16,32,50.0,6,22,27.3,22,54,40.7,13,18,72.2,7,29,36,17,20,18,21,11,2,4,71,Enea Basket Poznań,Sezon 2022/2023
2023-01-07 20:00,Dziki Warszawa(d),62 : 70P,62,11,35,31.4,7,24,29.2,18,59,30.5,19,25,76.0,11,24,35,12,25,23,17,7,2,3,54,Enea Basket Poznań,Sezon 2022/2023
2023-01-14 15:00,HydroTruck Radom(w),95 : 89P,89,21,37,56.8,11,29,37.9,32,66,48.5,14,19,73.7,12,16,28,14,17,20,10,6,0,2,88,Enea Basket Poznań,Sezon 2022/2023
2023-01-18 19:00,BS Polonia Bytom(w),70 : 83W,83,23,40,57.5,6,18,33.3,29,58,50.0,19,24,79.2,9,25,34,15,18,19,9,4,0,2,93,Enea Basket Poznań,Sezon 2022/2023
2023-01-21 18:00,MKKS Żak Koszalin(d),90 : 77W,90,25,40,62.5,6,23,26.1,31,63,49.2,22,31,71.0,12,31,43,22,23,26,14,11,5,2,116,Enea Basket Poznań,Sezon 2022/2023
2023-01-29 18:00,WKK Wrocław(w),72 : 85W,85,29,47,61.7,7,24,29.2,36,71,50.7,6,6,100.0,9,23,32,26,21,11,11,12,0,1,109,Enea Basket Poznań,Sezon 2022/2023
2023-02-04 15:00,AZS AGH Kraków(d),90 : 85W,90,23,45,51.1,8,19,42.1,31,64,48.4,20,33,60.6,14,26,40,20,25,26,11,7,0,0,100,Enea Basket Poznań,Sezon 2022/2023
2023-02-08 16:00,Start II Lublin(w),72 : 107W,107,38,57,66.7,7,19,36.8,45,76,59.2,10,15,66.7,6,27,33,36,19,19,11,18,4,3,151,Enea Basket Poznań,Sezon 2022/2023
2023-02-12 18:00,Górnik Trans.eu Zamek Książ Wałbrzych(d),66 : 85P,66,18,35,51.4,8,30,26.7,26,65,40.0,6,12,50.0,8,16,24,16,15,15,12,4,2,5,55,Enea Basket Poznań,Sezon 2022/2023
2023-02-19 16:00,Weegree AZS Politechnika Opolska(w),96 : 86P,86,20,40,50.0,6,21,28.6,26,61,42.6,28,38,73.7,8,13,21,17,21,28,15,9,0,3,73,Enea Basket Poznań,Sezon 2022/2023
2023-02-25 15:00,KKS Polonia Warszawa(d),86 : 71W,86,23,40,57.5,9,25,36.0,32,65,49.2,13,19,68.4,9,33,42,20,27,22,17,12,1,2,105,Enea Basket Poznań,Sezon 2022/2023
2023-03-04 15:00,GKS Tychy(d),81 : 65W,81,18,31,58.1,8,27,29.6,26,58,44.8,21,24,87.5,8,29,37,22,24,22,15,8,2,0,100,Enea Basket Poznań,Sezon 2022/2023
2023-03-08 20:00,PGE Turów Zgorzelec(w),84 : 85W,85,27,42,64.3,3,18,16.7,30,60,50.0,22,26,84.6,3,29,32,15,20,23,13,7,2,3,94,Enea Basket Poznań,Sezon 2022/2023
2023-03-11 15:00,SKS Starogard Gdański(w),100 : 82P,82,22,52,42.3,5,23,21.7,27,75,36.0,23,36,63.9,13,21,34,9,27,28,10,8,3,7,65,Enea Basket Poznań,Sezon 2022/2023
2023-03-19 18:00,Decka Pelplin(d),61 : 71P,61,20,37,54.1,2,25,8.0,22,62,35.5,15,21,71.4,8,27,35,10,26,24,11,7,1,2,57,Enea Basket Poznań,Sezon 2022/2023
2023-03-26 20:00,Miasto Szkła Krosno(w),87 : 62P,62,17,41,41.5,5,21,23.8,22,62,35.5,13,20,65.0,5,16,21,14,22,22,18,12,1,2,45,Enea Basket Poznań,Sezon 2022/2023
2023-04-02 15:00,WKS Śląsk II Wrocław(d),78 : 75W,78,25,47,53.2,4,22,18.2,29,69,42.0,16,29,55.2,14,26,40,15,30,26,15,8,2,5,75,Enea Basket Poznań,Sezon 2022/2023
2023-04-05 18:00,Sensation Kotwica Kołobrzeg(w),86 : 89W,89,17,33,51.5,13,29,44.8,30,62,48.4,16,27,59.3,10,27,37,16,17,17,16,8,3,6,94,Enea Basket Poznań,Sezon 2022/2023
2022-09-24 15:00,KKS Polonia Warszawa(d),85 : 63W,85,25,49,51.0,6,16,37.5,31,65,47.7,17,19,89.5,12,24,36,22,23,16,10,8,3,3,108,GKS Tychy,Sezon 2022/2023
2022-10-02 18:00,PGE Turów Zgorzelec(w),61 : 68W,68,16,35,45.7,5,17,29.4,21,52,40.4,21,25,84.0,9,26,35,17,20,25,22,8,1,3,72,GKS Tychy,Sezon 2022/2023
2022-10-08 18:00,MKKS Żak Koszalin(d),98 : 83W,98,24,37,64.9,8,24,33.3,32,61,52.5,26,34,76.5,10,25,35,25,23,25,13,10,2,2,120,GKS Tychy,Sezon 2022/2023
2022-10-15 20:00,SKS Starogard Gdański(d),101 : 55W,101,28,42,66.7,11,22,50.0,39,64,60.9,12,19,63.2,3,29,32,29,25,23,9,18,0,0,139,GKS Tychy,Sezon 2022/2023
2022-10-22 15:00,Decka Pelplin(w),60 : 76W,76,11,29,37.9,10,26,38.5,21,55,38.2,24,34,70.6,8,31,39,18,22,29,12,6,0,3,83,GKS Tychy,Sezon 2022/2023
2022-10-29 18:00,Miasto Szkła Krosno(d),83 : 80W,83,20,40,50.0,7,27,25.9,27,67,40.3,22,28,78.6,13,20,33,21,20,26,11,9,1,0,90,GKS Tychy,Sezon 2022/2023
2022-11-02 20:00,WKS Śląsk II Wrocław(w),56 : 64W,64,11,35,31.4,8,25,32.0,19,60,31.7,18,29,62.1,12,18,30,11,17,22,10,7,0,2,50,GKS Tychy,Sezon 2022/2023
2022-11-05 20:00,Sensation Kotwica Kołobrzeg(d),73 : 82P,73,16,36,44.4,7,24,29.2,23,60,38.3,20,27,74.1,3,29,32,20,20,23,13,10,0,3,78,GKS Tychy,Sezon 2022/2023
2022-11-13 20:00,Dziki Warszawa(w),90 : 83P,83,24,42,57.1,6,20,30.0,30,62,48.4,17,22,77.3,9,15,24,16,24,20,18,10,3,2,81,GKS Tychy,Sezon 2022/2023
2022-11-16 18:00,HydroTruck Radom(d),98 : 96W,98,20,43,46.5,14,32,43.8,34,75,45.3,16,20,80.0,18,20,38,23,24,21,13,6,0,2,107,GKS Tychy,Sezon 2022/2023
2022-11-19 18:00,BS Polonia Bytom(w),81 : 71P,71,19,41,46.3,8,21,38.1,27,62,43.5,9,20,45.0,15,29,44,8,25,22,20,2,1,0,60,GKS Tychy,Sezon 2022/2023
2022-11-26 20:00,Enea Basket Poznań(d),102 : 94W,102,22,41,53.7,9,27,33.3,31,68,45.6,31,38,81.6,7,30,37,19,28,32,20,5,4,2,103,GKS Tychy,Sezon 2022/2023
2022-12-03 15:00,WKK Wrocław(w),65 : 77W,77,20,35,57.1,8,28,28.6,28,63,44.4,13,17,76.5,11,29,40,15,19,15,16,11,1,2,89,GKS Tychy,Sezon 2022/2023
2022-12-10 20:00,AZS AGH Kraków(d),94 : 73W,94,34,46,73.9,3,11,27.3,37,57,64.9,17,19,89.5,5,32,37,26,22,18,18,5,2,1,124,GKS Tychy,Sezon 2022/2023
2022-12-15 18:00,Start II Lublin(w),51 : 76W,76,18,39,46.2,10,22,45.5,28,61,45.9,10,16,62.5,10,38,48,18,23,17,18,7,5,4,97,GKS Tychy,Sezon 2022/2023
2022-12-18 19:00,Górnik Trans.eu Zamek Książ Wałbrzych(d),88 : 68W,88,27,48,56.3,5,16,31.3,32,64,50.0,19,23,82.6,4,32,36,22,16,18,7,6,2,5,111,GKS Tychy,Sezon 2022/2023
2022-12-30 18:00,Weegree AZS Politechnika Opolska(w),88 : 73P,73,15,36,41.7,7,19,36.8,22,55,40.0,22,25,88.0,5,24,29,11,19,27,15,6,1,1,69,GKS Tychy,Sezon 2022/2023
2023-01-08 20:00,KKS Polonia Warszawa(w),64 : 58P,58,14,40,35.0,7,26,26.9,21,66,31.8,9,14,64.3,11,23,34,14,25,17,15,8,1,1,50,GKS Tychy,Sezon 2022/2023
2023-01-14 15:00,PGE Turów Zgorzelec(d),66 : 76P,66,22,47,46.8,1,18,5.6,23,65,35.4,19,26,73.1,14,27,41,16,20,23,15,7,4,5,70,GKS Tychy,Sezon 2022/2023
2023-01-18 18:00,MKKS Żak Koszalin(w),79 : 80W,80,25,44,56.8,7,19,36.8,32,63,50.8,9,18,50.0,8,28,36,14,23,20,15,4,0,2,79,GKS Tychy,Sezon 2022/2023
2023-01-21 16:00,SKS Starogard Gdański(w),85 : 84P,84,25,41,61.0,7,25,28.0,32,66,48.5,13,17,76.5,7,27,34,16,25,21,13,9,1,3,93,GKS Tychy,Sezon 2022/2023
2023-01-28 15:00,Decka Pelplin(d),81 : 48W,81,24,48,50.0,6,20,30.0,30,68,44.1,15,17,88.2,9,31,40,17,18,19,9,11,3,3,103,GKS Tychy,Sezon 2022/2023
2023-02-05 18:00,Miasto Szkła Krosno(w),66 : 72W,72,17,36,47.2,7,25,28.0,24,61,39.3,17,22,77.3,12,23,35,9,13,23,13,10,2,2,73,GKS Tychy,Sezon 2022/2023
2023-02-08 19:00,WKS Śląsk II Wrocław(d),72 : 80P,72,21,48,43.8,3,19,15.8,24,67,35.8,21,31,67.7,16,21,37,17,26,25,10,8,2,3,73,GKS Tychy,Sezon 2022/2023
2023-02-11 18:00,Sensation Kotwica Kołobrzeg(w),82 : 83W,83,16,38,42.1,12,23,52.2,28,61,45.9,15,22,68.2,8,21,29,15,18,19,8,7,0,1,86,GKS Tychy,Sezon 2022/2023
2023-02-18 18:00,Dziki Warszawa(d),72 : 66W,72,14,37,37.8,9,19,47.4,23,56,41.1,17,22,77.3,8,27,35,18,23,24,13,3,2,2,79,GKS Tychy,Sezon 2022/2023
2023-02-24 18:00,HydroTruck Radom(w),79 : 69P,69,12,25,48.0,9,28,32.1,21,53,39.6,18,21,85.7,1,24,25,14,22,25,20,7,2,1,62,GKS Tychy,Sezon 2022/2023
2023-03-01 18:00,BS Polonia Bytom(d),96 : 87W,96,22,37,59.5,10,25,40.0,32,62,51.6,22,31,71.0,8,36,44,18,21,23,14,1,6,3,112,GKS Tychy,Sezon 2022/2023
2023-03-04 15:00,Enea Basket Poznań(w),81 : 65P,65,15,35,42.9,7,28,25.0,22,63,34.9,14,21,66.7,12,22,34,16,23,23,13,8,0,2,62,GKS Tychy,Sezon 2022/2023
2023-03-11 20:00,WKK Wrocław(d),89 : 91P,89,22,46,47.8,10,29,34.5,32,75,42.7,15,15,100.0,15,29,44,19,31,18,16,7,1,3,101,GKS Tychy,Sezon 2022/2023
2023-03-18 15:00,AZS AGH Kraków(w),77 : 91W,91,23,43,53.5,6,20,30.0,29,63,46.0,27,35,77.1,13,22,35,24,22,26,13,3,1,4,99,GKS Tychy,Sezon 2022/2023
2023-03-25 15:00,Start II Lublin(d),110 : 63W,110,38,52,73.1,9,19,47.4,47,71,66.2,7,8,87.5,12,30,42,33,15,15,17,13,5,1,161,GKS Tychy,Sezon 2022/2023
2023-04-01 20:00,Górnik Trans.eu Zamek Książ Wałbrzych(w),77 : 60P,60,12,32,37.5,7,25,28.0,19,57,33.3,15,29,51.7,15,29,44,10,30,24,23,5,0,2,44,GKS Tychy,Sezon 2022/2023
2023-04-05 18:00,Weegree AZS Politechnika Opolska(d),85 : 82W,85,18,30,60.0,8,21,38.1,26,51,51.0,25,34,73.5,6,23,29,19,28,31,19,7,3,0,90,GKS Tychy,Sezon 2022/2023
2023-04-15 20:00,SKS Starogard Gdański(d),73 : 94P,73,17,31,54.8,5,27,18.5,22,58,37.9,24,32,75.0,4,27,31,14,25,26,10,8,2,2,74,GKS Tychy,Sezon 2022/2023
2023-04-16 20:00,SKS Starogard Gdański(d),69 : 56W,69,17,41,41.5,4,15,26.7,21,56,37.5,23,28,82.1,7,24,31,13,20,27,14,11,3,5,73,GKS Tychy,Sezon 2022/2023
2023-04-22 18:00,SKS Starogard Gdański(w),108 : 76P,76,17,43,39.5,7,25,28.0,24,68,35.3,21,36,58.3,17,21,38,13,21,26,19,7,3,6,59,GKS Tychy,Sezon 2022/2023
2023-04-23 18:00,SKS Starogard Gdański(w),88 : 69P,69,10,36,27.8,8,29,27.6,18,65,27.7,25,26,96.2,7,19,26,13,26,24,10,8,1,1,59,GKS Tychy,Sezon 2022/2023
2022-09-24 18:00,Decka Pelplin(w),68 : 89W,89,16,35,45.7,14,27,51.9,30,62,48.4,15,18,83.3,8,24,32,26,21,19,10,5,2,1,109,Górnik Trans.eu Zamek Książ Wałbrzych,Sezon 2022/2023
2022-10-01 18:00,Miasto Szkła Krosno(d),92 : 68W,92,27,47,57.4,8,29,27.6,35,76,46.1,14,22,63.6,14,23,37,21,20,22,5,10,6,1,112,Górnik Trans.eu Zamek Książ Wałbrzych,Sezon 2022/2023
2022-10-09 18:00,WKS Śląsk II Wrocław(w),75 : 58P,58,17,47,36.2,3,20,15.0,20,67,29.9,15,24,62.5,18,22,40,9,19,19,8,2,6,6,51,Górnik Trans.eu Zamek Książ Wałbrzych,Sezon 2022/2023
2022-10-15 18:00,Sensation Kotwica Kołobrzeg(d),84 : 81W,84,9,27,33.3,14,33,42.4,23,60,38.3,24,30,80.0,9,29,38,18,17,23,14,5,5,1,93,Górnik Trans.eu Zamek Książ Wałbrzych,Sezon 2022/2023
2022-10-23 15:00,Dziki Warszawa(w),76 : 72P,72,16,36,44.4,11,28,39.3,27,64,42.2,7,14,50.0,11,20,31,23,22,17,9,2,2,1,77,Górnik Trans.eu Zamek Książ Wałbrzych,Sezon 2022/2023
2022-10-30 18:00,HydroTruck Radom(d),65 : 78P,65,14,36,38.9,5,29,17.2,19,65,29.2,22,29,75.9,11,25,36,16,12,22,8,9,2,4,67,Górnik Trans.eu Zamek Książ Wałbrzych,Sezon 2022/2023
2022-11-02 16:00,BS Polonia Bytom(w),65 : 85W,85,23,45,51.1,11,30,36.7,34,75,45.3,6,7,85.7,11,25,36,18,22,12,7,10,2,3,102,Górnik Trans.eu Zamek Książ Wałbrzych,Sezon 2022/2023
2022-11-06 18:00,Enea Basket Poznań(d),87 : 81W,87,18,32,56.3,12,27,44.4,30,59,50.8,15,21,71.4,10,25,35,21,20,21,21,5,2,2,94,Górnik Trans.eu Zamek Książ Wałbrzych,Sezon 2022/2023
2022-11-13 18:00,WKK Wrocław(d),76 : 74W,76,18,38,47.4,8,25,32.0,26,63,41.3,16,18,88.9,5,36,41,18,27,17,15,11,4,1,96,Górnik Trans.eu Zamek Książ Wałbrzych,Sezon 2022/2023
2022-11-16 19:00,AZS AGH Kraków(d),86 : 70W,86,29,47,61.7,6,17,35.3,35,64,54.7,10,22,45.5,10,21,31,29,22,18,12,9,2,1,104,Górnik Trans.eu Zamek Książ Wałbrzych,Sezon 2022/2023
2022-11-19 13:00,Start II Lublin(w),62 : 114W,114,42,57,73.7,8,31,25.8,50,88,56.8,6,7,85.7,13,32,45,31,17,12,11,16,6,1,162,Górnik Trans.eu Zamek Książ Wałbrzych,Sezon 2022/2023
2022-11-26 18:00,MKKS Żak Koszalin(w),96 : 94P,94,24,42,57.1,10,23,43.5,34,65,52.3,16,25,64.0,10,27,37,24,24,17,15,8,4,0,112,Górnik Trans.eu Zamek Książ Wałbrzych,Sezon 2022/2023
2022-12-03 18:00,Weegree AZS Politechnika Opolska(d),86 : 77W,86,23,39,59.0,10,20,50.0,33,59,55.9,10,22,45.5,5,28,33,19,17,20,9,7,1,2,99,Górnik Trans.eu Zamek Książ Wałbrzych,Sezon 2022/2023
2022-12-09 20:00,KKS Polonia Warszawa(w),88 : 90W,90,19,36,52.8,11,26,42.3,30,62,48.4,19,26,73.1,5,21,26,23,20,24,13,8,0,2,95,Górnik Trans.eu Zamek Książ Wałbrzych,Sezon 2022/2023
2022-12-14 19:00,PGE Turów Zgorzelec(w),66 : 84W,84,28,43,65.1,8,25,32.0,36,68,52.9,4,6,66.7,8,27,35,21,18,10,12,12,3,1,109,Górnik Trans.eu Zamek Książ Wałbrzych,Sezon 2022/2023
2022-12-18 19:00,GKS Tychy(w),88 : 68P,68,23,49,46.9,4,25,16.0,27,74,36.5,10,13,76.9,15,26,41,12,18,15,14,5,5,2,67,Górnik Trans.eu Zamek Książ Wałbrzych,Sezon 2022/2023
2023-01-04 17:00,SKS Starogard Gdański(d),78 : 66W,78,22,56,39.3,7,23,30.4,29,79,36.7,13,17,76.5,18,25,43,22,23,14,4,10,5,1,100,Górnik Trans.eu Zamek Książ Wałbrzych,Sezon 2022/2023
2023-01-08 18:00,Decka Pelplin(d),72 : 60W,72,20,42,47.6,6,21,28.6,26,63,41.3,14,19,73.7,10,38,48,20,23,20,16,10,2,3,94,Górnik Trans.eu Zamek Książ Wałbrzych,Sezon 2022/2023
2023-01-15 18:00,Miasto Szkła Krosno(w),95 : 93P,93,27,44,61.4,4,20,20.0,31,64,48.4,27,36,75.0,8,29,37,21,26,25,17,11,3,1,106,Górnik Trans.eu Zamek Książ Wałbrzych,Sezon 2022/2023
2023-01-18 19:00,WKS Śląsk II Wrocław(d),77 : 75W,77,19,38,50.0,5,20,25.0,24,58,41.4,24,33,72.7,15,24,39,18,24,25,12,10,6,2,95,Górnik Trans.eu Zamek Książ Wałbrzych,Sezon 2022/2023
2023-01-22 20:00,Sensation Kotwica Kołobrzeg(w),72 : 85W,85,22,37,59.5,8,21,38.1,30,58,51.7,17,26,65.4,4,29,33,17,19,24,14,10,5,1,99,Górnik Trans.eu Zamek Książ Wałbrzych,Sezon 2022/2023
2023-01-29 18:00,Dziki Warszawa(d),57 : 45W,57,17,35,48.6,5,32,15.6,22,67,32.8,8,13,61.5,13,30,43,16,21,15,16,15,4,2,69,Górnik Trans.eu Zamek Książ Wałbrzych,Sezon 2022/2023
2023-02-03 18:00,HydroTruck Radom(w),70 : 77W,77,21,36,58.3,10,34,29.4,31,70,44.3,5,13,38.5,19,25,44,20,20,17,14,9,4,1,93,Górnik Trans.eu Zamek Książ Wałbrzych,Sezon 2022/2023
2023-02-08 18:00,BS Polonia Bytom(d),82 : 71W,82,27,44,61.4,7,31,22.6,34,75,45.3,7,18,38.9,15,29,44,30,17,19,14,13,2,0,105,Górnik Trans.eu Zamek Książ Wałbrzych,Sezon 2022/2023
2023-02-12 18:00,Enea Basket Poznań(w),66 : 85W,85,24,35,68.6,9,28,32.1,33,63,52.4,10,11,90.9,11,27,38,32,16,15,12,9,5,2,126,Górnik Trans.eu Zamek Książ Wałbrzych,Sezon 2022/2023
2023-02-16 17:00,WKK Wrocław(w),74 : 96W,96,25,43,58.1,10,28,35.7,35,71,49.3,16,24,66.7,14,25,39,24,24,22,7,11,3,0,122,Górnik Trans.eu Zamek Książ Wałbrzych,Sezon 2022/2023
2023-02-26 18:00,AZS AGH Kraków(w),88 : 95W,95,29,45,64.4,8,21,38.1,37,66,56.1,13,21,61.9,8,30,38,31,20,22,16,7,5,2,123,Górnik Trans.eu Zamek Książ Wałbrzych,Sezon 2022/2023
2023-03-01 16:00,Start II Lublin(d),104 : 67W,104,28,43,65.1,14,37,37.8,42,80,52.5,6,8,75.0,19,25,44,33,15,10,16,15,3,2,143,Górnik Trans.eu Zamek Książ Wałbrzych,Sezon 2022/2023
2023-03-04 20:00,MKKS Żak Koszalin(d),79 : 69W,79,22,42,52.4,7,24,29.2,29,66,43.9,14,35,40.0,13,27,40,19,22,25,14,10,7,1,83,Górnik Trans.eu Zamek Książ Wałbrzych,Sezon 2022/2023
2023-03-11 18:00,Weegree AZS Politechnika Opolska(w),79 : 80W,80,17,31,54.8,8,29,27.6,25,60,41.7,22,31,71.0,11,25,36,18,16,24,17,9,1,3,83,Górnik Trans.eu Zamek Książ Wałbrzych,Sezon 2022/2023
2023-03-18 18:00,KKS Polonia Warszawa(d),84 : 79W,84,26,42,61.9,5,16,31.3,31,58,53.4,17,30,56.7,10,24,34,22,13,20,14,11,6,1,103,Górnik Trans.eu Zamek Książ Wałbrzych,Sezon 2022/2023
2023-03-25 20:00,PGE Turów Zgorzelec(d),70 : 84P,70,25,38,65.8,4,27,14.8,29,65,44.6,8,14,57.1,12,24,36,22,19,16,17,9,4,0,82,Górnik Trans.eu Zamek Książ Wałbrzych,Sezon 2022/2023
2023-04-01 20:00,GKS Tychy(d),77 : 60W,77,18,28,64.3,8,28,28.6,26,56,46.4,17,29,58.6,5,28,33,23,24,30,12,11,2,0,92,Górnik Trans.eu Zamek Książ Wałbrzych,Sezon 2022/2023
2023-04-05 18:00,SKS Starogard Gdański(w),75 : 86W,86,20,38,52.6,12,26,46.2,32,64,50.0,10,16,62.5,8,27,35,23,24,16,9,6,6,3,109,Górnik Trans.eu Zamek Książ Wałbrzych,Sezon 2022/2023
2023-04-15 18:00,KKS Polonia Warszawa(d),86 : 48W,86,26,44,59.1,8,25,32.0,34,69,49.3,10,12,83.3,8,29,37,20,19,21,9,14,2,2,113,Górnik Trans.eu Zamek Książ Wałbrzych,Sezon 2022/2023
2023-04-16 18:00,KKS Polonia Warszawa(d),92 : 83W,92,25,47,53.2,4,15,26.7,29,62,46.8,30,48,62.5,18,25,43,20,21,36,11,6,3,1,102,Górnik Trans.eu Zamek Książ Wałbrzych,Sezon 2022/2023
2023-04-20 20:00,KKS Polonia Warszawa(w),79 : 89W,89,23,43,53.5,8,22,36.4,31,65,47.7,19,27,70.4,13,21,34,23,24,21,12,6,2,4,100,Górnik Trans.eu Zamek Książ Wałbrzych,Sezon 2022/2023
2023-04-29 19:00,SKS Starogard Gdański(d),88 : 69W,88,29,51,56.9,5,25,20.0,34,76,44.7,15,26,57.7,17,32,49,20,20,21,8,9,6,2,111,Górnik Trans.eu Zamek Książ Wałbrzych,Sezon 2022/2023
2023-04-30 19:00,SKS Starogard Gdański(d),92 : 77W,92,17,34,50.0,15,30,50.0,32,64,50.0,13,23,56.5,8,29,37,28,23,21,11,6,2,0,112,Górnik Trans.eu Zamek Książ Wałbrzych,Sezon 2022/2023
2023-05-06 17:00,SKS Starogard Gdański(w),85 : 92W,92,24,43,55.8,7,27,25.9,31,70,44.3,23,30,76.7,11,30,41,23,24,20,10,5,5,2,110,Górnik Trans.eu Zamek Książ Wałbrzych,Sezon 2022/2023
2023-05-13 19:00,Dziki Warszawa(d),66 : 73P,66,21,39,53.8,4,22,18.2,25,61,41.0,12,20,60.0,7,28,35,15,24,17,22,12,4,3,66,Górnik Trans.eu Zamek Książ Wałbrzych,Sezon 2022/2023
2023-05-14 19:00,Dziki Warszawa(d),57 : 72P,57,17,41,41.5,4,23,17.4,21,64,32.8,11,20,55.0,13,17,30,16,16,21,11,10,5,3,55,Górnik Trans.eu Zamek Książ Wałbrzych,Sezon 2022/2023
2023-05-20 20:00,Dziki Warszawa(w),66 : 62P,62,16,38,42.1,7,23,30.4,23,61,37.7,9,19,47.4,9,29,38,19,21,19,12,5,7,2,71,Górnik Trans.eu Zamek Książ Wałbrzych,Sezon 2022/2023
2022-09-24 17:00,BS Polonia Bytom(d),99 : 91W,99,19,42,45.2,18,42,42.9,37,84,44.0,7,10,70.0,13,27,40,22,24,11,9,4,5,6,111,HydroTruck Radom,Sezon 2022/2023
2022-10-01 15:00,Enea Basket Poznań(w),89 : 94W,94,20,37,54.1,15,38,39.5,35,75,46.7,9,14,64.3,8,27,35,28,20,17,15,12,3,2,112,HydroTruck Radom,Sezon 2022/2023
2022-10-08 15:00,WKK Wrocław(d),80 : 70W,80,20,32,62.5,10,34,29.4,30,66,45.5,10,13,76.9,9,33,42,20,20,17,20,11,2,1,96,HydroTruck Radom,Sezon 2022/2023
2022-10-15 20:00,AZS AGH Kraków(w),71 : 80W,80,22,37,59.5,9,28,32.1,31,65,47.7,9,12,75.0,4,24,28,17,16,16,11,10,2,2,89,HydroTruck Radom,Sezon 2022/2023
2022-10-22 18:00,Start II Lublin(d),100 : 89W,100,25,37,67.6,15,39,38.5,40,76,52.6,5,6,83.3,5,23,28,33,13,9,10,14,1,3,129,HydroTruck Radom,Sezon 2022/2023
2022-10-30 18:00,Górnik Trans.eu Zamek Książ Wałbrzych(w),65 : 78W,78,15,29,51.7,15,34,44.1,30,63,47.6,3,5,60.0,8,31,39,18,22,12,11,3,4,2,96,HydroTruck Radom,Sezon 2022/2023
2022-11-02 18:00,Weegree AZS Politechnika Opolska(d),72 : 68W,72,16,36,44.4,8,30,26.7,24,66,36.4,16,24,66.7,15,26,41,11,18,21,10,6,3,5,73,HydroTruck Radom,Sezon 2022/2023
2022-11-07 19:00,KKS Polonia Warszawa(w),72 : 79W,79,16,36,44.4,8,32,25.0,24,68,35.3,23,32,71.9,15,24,39,16,18,25,11,10,1,5,81,HydroTruck Radom,Sezon 2022/2023
2022-11-11 18:00,PGE Turów Zgorzelec(d),89 : 72W,89,29,41,70.7,5,29,17.2,34,70,48.6,16,18,88.9,15,23,38,24,22,17,12,6,2,3,109,HydroTruck Radom,Sezon 2022/2023
2022-11-16 18:00,GKS Tychy(w),98 : 96P,96,24,36,66.7,8,25,32.0,32,61,52.5,24,26,92.3,7,22,29,19,22,24,11,9,2,0,113,HydroTruck Radom,Sezon 2022/2023
2022-11-23 18:00,SKS Starogard Gdański(d),87 : 71W,87,19,39,48.7,13,29,44.8,32,68,47.1,10,12,83.3,8,25,33,23,30,13,10,10,3,4,108,HydroTruck Radom,Sezon 2022/2023
2022-11-26 15:00,Decka Pelplin(w),76 : 81W,81,20,44,45.5,11,27,40.7,31,71,43.7,8,22,36.4,14,24,38,19,16,19,11,9,5,5,87,HydroTruck Radom,Sezon 2022/2023
2022-12-07 18:00,Miasto Szkła Krosno(d),102 : 68W,102,27,45,60.0,13,26,50.0,40,71,56.3,9,12,75.0,9,25,34,29,18,17,13,16,3,1,137,HydroTruck Radom,Sezon 2022/2023
2022-12-10 15:00,WKS Śląsk II Wrocław(w),61 : 91W,91,22,36,61.1,14,31,45.2,36,67,53.7,5,6,83.3,5,31,36,24,21,12,11,5,2,4,115,HydroTruck Radom,Sezon 2022/2023
2022-12-14 17:00,Sensation Kotwica Kołobrzeg(d),82 : 68W,82,18,36,50.0,11,32,34.4,29,68,42.6,13,17,76.5,15,30,45,17,9,15,19,9,2,2,93,HydroTruck Radom,Sezon 2022/2023
2022-12-17 18:00,Dziki Warszawa(w),79 : 66P,66,17,34,50.0,7,20,35.0,24,54,44.4,11,18,61.1,4,26,30,13,19,19,18,10,1,3,65,HydroTruck Radom,Sezon 2022/2023
2023-01-04 18:00,MKKS Żak Koszalin(d),77 : 83P,77,20,35,57.1,5,30,16.7,25,65,38.5,22,29,75.9,10,20,30,18,22,28,15,6,0,1,69,HydroTruck Radom,Sezon 2022/2023
2023-01-08 18:00,BS Polonia Bytom(w),67 : 93W,93,26,39,66.7,10,28,35.7,36,67,53.7,11,16,68.8,9,35,44,24,16,18,14,5,0,2,116,HydroTruck Radom,Sezon 2022/2023
2023-01-14 15:00,Enea Basket Poznań(d),95 : 89W,95,21,26,80.8,14,31,45.2,35,57,61.4,11,12,91.7,4,21,25,22,20,17,11,5,2,0,115,HydroTruck Radom,Sezon 2022/2023
2023-01-18 17:00,WKK Wrocław(w),86 : 69P,69,19,35,54.3,7,26,26.9,26,61,42.6,10,15,66.7,6,24,30,17,20,15,9,5,0,2,72,HydroTruck Radom,Sezon 2022/2023
2023-01-25 18:00,AZS AGH Kraków(d),90 : 81W,90,22,44,50.0,10,24,41.7,32,68,47.1,16,23,69.6,11,24,35,31,20,23,17,13,5,3,114,HydroTruck Radom,Sezon 2022/2023
2023-01-29 16:00,Start II Lublin(w),62 : 95W,95,21,37,56.8,14,33,42.4,35,70,50.0,11,19,57.9,13,27,40,31,20,19,14,11,4,5,124,HydroTruck Radom,Sezon 2022/2023
2023-02-03 18:00,Górnik Trans.eu Zamek Książ Wałbrzych(d),70 : 77P,70,12,22,54.5,9,34,26.5,21,56,37.5,19,21,90.5,7,17,24,15,17,20,15,10,1,4,68,HydroTruck Radom,Sezon 2022/2023
2023-02-08 17:00,Weegree AZS Politechnika Opolska(w),84 : 82P,82,13,24,54.2,13,28,46.4,26,52,50.0,17,23,73.9,2,27,29,14,19,22,18,7,1,1,83,HydroTruck Radom,Sezon 2022/2023
2023-02-15 19:00,KKS Polonia Warszawa(d),88 : 69W,88,20,35,57.1,13,32,40.6,33,67,49.3,9,16,56.3,4,28,32,23,20,16,4,10,4,1,112,HydroTruck Radom,Sezon 2022/2023
2023-02-19 18:00,PGE Turów Zgorzelec(w),87 : 86P,86,28,47,59.6,8,21,38.1,36,68,52.9,6,11,54.5,14,27,41,21,19,18,13,5,2,1,105,HydroTruck Radom,Sezon 2022/2023
2023-02-24 18:00,GKS Tychy(d),79 : 69W,79,20,40,50.0,8,27,29.6,28,67,41.8,15,22,68.2,11,23,34,15,25,22,13,9,1,2,79,HydroTruck Radom,Sezon 2022/2023
2023-03-01 20:00,SKS Starogard Gdański(w),82 : 76P,76,21,43,48.8,6,29,20.7,27,72,37.5,16,20,80.0,8,23,31,17,18,18,6,10,1,0,80,HydroTruck Radom,Sezon 2022/2023
2023-03-08 19:00,Decka Pelplin(d),79 : 83P,79,14,28,50.0,13,42,31.0,27,70,38.6,12,21,57.1,9,23,32,19,23,21,12,12,1,1,79,HydroTruck Radom,Sezon 2022/2023
2023-03-11 20:00,Miasto Szkła Krosno(w),83 : 94W,94,20,33,60.6,11,25,44.0,31,58,53.4,21,24,87.5,8,34,42,25,23,25,14,3,5,2,125,HydroTruck Radom,Sezon 2022/2023
2023-03-19 15:00,WKS Śląsk II Wrocław(d),113 : 56W,113,30,42,71.4,13,25,52.0,43,67,64.2,14,21,66.7,4,35,39,35,17,20,7,7,5,4,161,HydroTruck Radom,Sezon 2022/2023
2023-03-26 18:00,Sensation Kotwica Kołobrzeg(w),93 : 95W,95,21,36,58.3,10,31,32.3,31,67,46.3,23,27,85.2,5,37,42,16,19,23,16,4,1,1,102,HydroTruck Radom,Sezon 2022/2023
2023-03-29 18:30,Dziki Warszawa(d),63 : 91P,63,13,25,52.0,6,27,22.2,19,52,36.5,19,24,79.2,12,20,32,14,18,22,23,5,2,1,55,HydroTruck Radom,Sezon 2022/2023
2023-04-05 18:00,MKKS Żak Koszalin(w),91 : 110W,110,28,46,60.9,11,18,61.1,39,64,60.9,21,27,77.8,8,31,39,27,22,24,15,9,1,3,140,HydroTruck Radom,Sezon 2022/2023
2023-04-15 18:00,Sensation Kotwica Kołobrzeg(d),71 : 65W,71,12,24,50.0,8,32,25.0,20,56,35.7,23,31,74.2,9,34,43,16,20,22,17,7,1,2,77,HydroTruck Radom,Sezon 2022/2023
2023-04-16 18:00,Sensation Kotwica Kołobrzeg(d),83 : 78W,83,16,32,50.0,9,33,27.3,25,65,38.5,24,30,80.0,6,30,36,17,18,24,9,9,3,2,93,HydroTruck Radom,Sezon 2022/2023
2023-04-22 20:00,Sensation Kotwica Kołobrzeg(w),73 : 64P,64,10,25,40.0,11,38,28.9,21,63,33.3,11,14,78.6,9,28,37,15,16,14,15,6,1,1,63,HydroTruck Radom,Sezon 2022/2023
2023-04-23 20:00,Sensation Kotwica Kołobrzeg(w),76 : 86W,86,13,26,50.0,12,42,28.6,25,68,36.8,24,32,75.0,12,28,40,17,17,25,16,10,1,7,87,HydroTruck Radom,Sezon 2022/2023
2023-04-29 17:00,Dziki Warszawa(w),80 : 74P,74,15,38,39.5,12,26,46.2,27,64,42.2,8,12,66.7,12,29,41,13,22,15,14,4,2,6,79,HydroTruck Radom,Sezon 2022/2023
2023-04-30 17:00,Dziki Warszawa(w),86 : 73P,73,17,36,47.2,6,23,26.1,23,59,39.0,21,25,84.0,7,25,32,13,24,20,16,8,1,2,71,HydroTruck Radom,Sezon 2022/2023
2023-05-06 19:00,Dziki Warszawa(d),96 : 87W,96,19,33,57.6,14,25,56.0,33,58,56.9,16,22,72.7,6,26,32,21,24,19,14,10,2,5,116,HydroTruck Radom,Sezon 2022/2023
2023-05-07 19:00,Dziki Warszawa(d),72 : 74P,72,18,35,51.4,5,25,20.0,23,60,38.3,21,25,84.0,12,23,35,15,28,22,12,9,1,2,79,HydroTruck Radom,Sezon 2022/2023
2023-05-13 17:00,SKS Starogard Gdański(w),110 : 79P,79,24,47,51.1,6,32,18.8,30,79,38.0,13,20,65.0,14,22,36,21,28,18,5,4,2,3,81,HydroTruck Radom,Sezon 2022/2023
2023-05-17 18:00,SKS Starogard Gdański(d),89 : 60W,89,17,39,43.6,12,27,44.4,29,66,43.9,19,24,79.2,8,38,46,24,25,23,13,9,1,3,114,HydroTruck Radom,Sezon 2022/2023
2022-09-24 15:00,GKS Tychy(w),85 : 63P,63,15,25,60.0,4,31,12.9,19,56,33.9,21,28,75.0,6,22,28,10,16,23,11,3,3,3,52,KKS Polonia Warszawa,Sezon 2022/2023
2022-10-01 15:00,SKS Starogard Gdański(d),74 : 86P,74,23,42,54.8,5,28,17.9,28,70,40.0,13,17,76.5,9,22,31,15,27,15,10,8,4,2,76,KKS Polonia Warszawa,Sezon 2022/2023
2022-10-08 18:00,Decka Pelplin(w),79 : 59P,59,17,46,37.0,5,29,17.2,22,75,29.3,10,17,58.8,15,28,43,13,17,13,10,8,6,2,59,KKS Polonia Warszawa,Sezon 2022/2023
2022-10-15 15:00,Miasto Szkła Krosno(d),83 : 71W,83,22,38,57.9,7,29,24.1,29,67,43.3,18,23,78.3,8,17,25,19,26,24,13,11,4,1,86,KKS Polonia Warszawa,Sezon 2022/2023
2022-10-23 18:00,WKS Śląsk II Wrocław(w),67 : 64P,64,9,23,39.1,12,31,38.7,21,54,38.9,10,11,90.9,7,26,33,16,20,12,20,6,6,3,71,KKS Polonia Warszawa,Sezon 2022/2023
2022-10-29 15:00,Sensation Kotwica Kołobrzeg(d),74 : 82P,74,12,31,38.7,10,29,34.5,22,60,36.7,20,26,76.9,9,28,37,20,12,18,13,4,6,6,84,KKS Polonia Warszawa,Sezon 2022/2023
2022-11-02 18:00,Dziki Warszawa(w),76 : 58P,58,11,29,37.9,10,30,33.3,21,59,35.6,6,10,60.0,7,22,29,16,21,16,13,7,5,4,60,KKS Polonia Warszawa,Sezon 2022/2023
2022-11-07 19:00,HydroTruck Radom(d),72 : 79P,72,17,35,48.6,8,34,23.5,25,69,36.2,14,18,77.8,16,29,45,19,25,18,14,3,5,1,82,KKS Polonia Warszawa,Sezon 2022/2023
2022-11-12 20:00,BS Polonia Bytom(d),85 : 75W,85,23,43,53.5,11,27,40.7,34,70,48.6,6,9,66.7,10,30,40,19,22,17,15,6,7,2,103,KKS Polonia Warszawa,Sezon 2022/2023
2022-11-16 18:00,Enea Basket Poznań(d),69 : 59W,69,20,37,54.1,5,23,21.7,25,60,41.7,14,24,58.3,11,27,38,18,23,21,15,6,5,2,76,KKS Polonia Warszawa,Sezon 2022/2023
2022-11-20 18:00,WKK Wrocław(w),76 : 66P,66,25,44,56.8,3,24,12.5,28,68,41.2,7,11,63.6,11,28,39,19,25,18,16,5,2,2,71,KKS Polonia Warszawa,Sezon 2022/2023
2022-11-28 18:00,AZS AGH Kraków(d),72 : 70W,72,21,44,47.7,5,17,29.4,26,61,42.6,15,26,57.7,12,30,42,15,19,25,15,9,2,2,79,KKS Polonia Warszawa,Sezon 2022/2023
2022-12-02 19:00,Start II Lublin(w),70 : 96W,96,27,45,60.0,9,24,37.5,36,69,52.2,15,19,78.9,15,23,38,30,19,15,15,16,8,5,136,KKS Polonia Warszawa,Sezon 2022/2023
2022-12-09 20:00,Górnik Trans.eu Zamek Książ Wałbrzych(d),88 : 90P,88,22,38,57.9,9,24,37.5,31,62,50.0,17,21,81.0,9,25,34,18,25,20,18,6,2,0,95,KKS Polonia Warszawa,Sezon 2022/2023
2022-12-14 19:00,Weegree AZS Politechnika Opolska(w),84 : 82P,82,21,32,65.6,8,21,38.1,29,53,54.7,16,22,72.7,3,28,31,18,16,21,11,6,2,0,98,KKS Polonia Warszawa,Sezon 2022/2023
2022-12-17 20:00,MKKS Żak Koszalin(w),84 : 85W,85,20,39,51.3,9,20,45.0,29,59,49.2,18,22,81.8,9,27,36,16,25,20,17,6,2,3,94,KKS Polonia Warszawa,Sezon 2022/2023
2023-01-04 19:00,PGE Turów Zgorzelec(d),87 : 64W,87,14,30,46.7,15,29,51.7,29,59,49.2,14,22,63.6,8,31,39,20,21,22,16,3,1,2,96,KKS Polonia Warszawa,Sezon 2022/2023
2023-01-08 20:00,GKS Tychy(d),64 : 58W,64,18,36,50.0,4,22,18.2,22,58,37.9,16,25,64.0,8,29,37,11,17,24,17,7,1,1,58,KKS Polonia Warszawa,Sezon 2022/2023
2023-01-14 18:00,SKS Starogard Gdański(w),84 : 88W,88,25,46,54.3,8,23,34.8,33,69,47.8,14,23,60.9,17,23,40,15,22,21,13,7,7,3,99,KKS Polonia Warszawa,Sezon 2022/2023
2023-01-18 20:00,Decka Pelplin(d),79 : 72W,79,18,38,47.4,11,24,45.8,29,62,46.8,10,14,71.4,6,26,32,21,17,20,12,6,5,3,94,KKS Polonia Warszawa,Sezon 2022/2023
2023-01-21 18:00,Miasto Szkła Krosno(w),76 : 64P,64,17,29,58.6,7,20,35.0,24,49,49.0,9,14,64.3,1,15,16,16,17,18,13,10,0,3,63,KKS Polonia Warszawa,Sezon 2022/2023
2023-01-29 19:00,WKS Śląsk II Wrocław(d),68 : 57W,68,18,36,50.0,7,19,36.8,25,55,45.5,11,19,57.9,1,38,39,18,26,15,16,7,5,2,83,KKS Polonia Warszawa,Sezon 2022/2023
2023-02-04 15:00,Sensation Kotwica Kołobrzeg(w),47 : 86W,86,21,39,53.8,10,29,34.5,31,68,45.6,14,15,93.3,10,36,46,22,17,17,12,7,7,3,118,KKS Polonia Warszawa,Sezon 2022/2023
2023-02-08 20:00,Dziki Warszawa(d),81 : 67W,81,16,41,39.0,11,22,50.0,27,63,42.9,16,24,66.7,11,25,36,18,23,23,17,15,3,4,92,KKS Polonia Warszawa,Sezon 2022/2023
2023-02-15 19:00,HydroTruck Radom(w),88 : 69P,69,17,31,54.8,8,32,25.0,25,63,39.7,11,17,64.7,9,27,36,17,16,20,15,2,1,4,66,KKS Polonia Warszawa,Sezon 2022/2023
2023-02-18 20:00,BS Polonia Bytom(w),103 : 111W,111,26,42,61.9,16,34,47.1,42,76,55.3,11,15,73.3,8,27,35,24,21,20,18,6,5,2,125,KKS Polonia Warszawa,Sezon 2022/2023
2023-02-25 15:00,Enea Basket Poznań(w),86 : 71P,71,14,31,45.2,8,28,28.6,22,59,37.3,19,34,55.9,5,24,29,11,22,25,16,9,2,1,54,KKS Polonia Warszawa,Sezon 2022/2023
2023-03-04 15:00,AZS AGH Kraków(w),71 : 79W,79,28,40,70.0,3,16,18.8,31,56,55.4,14,21,66.7,9,32,41,16,19,24,19,7,3,0,95,KKS Polonia Warszawa,Sezon 2022/2023
2023-03-12 17:00,Start II Lublin(d),100 : 64W,100,35,47,74.5,9,28,32.1,44,75,58.7,3,9,33.3,11,28,39,33,15,8,10,14,5,2,144,KKS Polonia Warszawa,Sezon 2022/2023
2023-03-18 18:00,Górnik Trans.eu Zamek Książ Wałbrzych(w),84 : 79P,79,16,35,45.7,13,31,41.9,29,66,43.9,8,10,80.0,6,21,27,22,20,13,16,6,1,6,80,KKS Polonia Warszawa,Sezon 2022/2023
2023-03-22 19:00,WKK Wrocław(d),98 : 92W,98,24,39,61.5,10,31,32.3,34,70,48.6,20,24,83.3,8,26,34,21,32,22,10,8,5,1,116,KKS Polonia Warszawa,Sezon 2022/2023
2023-03-26 19:00,Weegree AZS Politechnika Opolska(d),94 : 69W,94,19,31,61.3,14,35,40.0,33,66,50.0,14,16,87.5,6,26,32,21,18,18,10,13,3,2,118,KKS Polonia Warszawa,Sezon 2022/2023
2023-04-02 18:00,MKKS Żak Koszalin(d),75 : 87P,75,12,34,35.3,7,31,22.6,19,65,29.2,30,40,75.0,13,32,45,15,27,28,15,7,4,5,75,KKS Polonia Warszawa,Sezon 2022/2023
2023-04-05 18:00,PGE Turów Zgorzelec(w),91 : 102W,102,28,46,60.9,12,22,54.5,40,68,58.8,10,12,83.3,6,23,29,27,21,20,14,10,3,1,127,KKS Polonia Warszawa,Sezon 2022/2023
2023-04-15 18:00,Górnik Trans.eu Zamek Książ Wałbrzych(w),86 : 48P,48,12,26,46.2,6,27,22.2,18,53,34.0,6,18,33.3,7,25,32,13,21,19,19,5,2,2,34,KKS Polonia Warszawa,Sezon 2022/2023
2023-04-16 18:00,Górnik Trans.eu Zamek Książ Wałbrzych(w),92 : 83P,83,21,41,51.2,10,30,33.3,31,71,43.7,11,17,64.7,11,26,37,22,36,21,13,7,1,3,91,KKS Polonia Warszawa,Sezon 2022/2023
2023-04-20 20:00,Górnik Trans.eu Zamek Książ Wałbrzych(d),79 : 89P,79,14,31,45.2,11,25,44.0,25,56,44.6,18,34,52.9,11,21,32,23,21,24,11,7,4,2,87,KKS Polonia Warszawa,Sezon 2022/2023
2022-09-25 18:30,Start II Lublin(d),116 : 74W,116,35,51,68.6,12,30,40.0,47,81,58.0,10,16,62.5,18,30,48,31,14,14,14,14,3,3,158,Miasto Szkła Krosno,Sezon 2022/2023
2022-10-01 18:00,Górnik Trans.eu Zamek Książ Wałbrzych(w),92 : 68P,68,21,47,44.7,6,25,24.0,27,72,37.5,8,17,47.1,13,24,37,14,22,20,14,2,1,6,54,Miasto Szkła Krosno,Sezon 2022/2023
2022-10-09 18:00,Weegree AZS Politechnika Opolska(d),82 : 79W,82,27,35,77.1,5,21,23.8,32,56,57.1,13,21,61.9,7,26,33,17,22,20,17,5,0,2,88,Miasto Szkła Krosno,Sezon 2022/2023
2022-10-15 15:00,KKS Polonia Warszawa(w),83 : 71P,71,23,39,59.0,3,12,25.0,26,51,51.0,16,32,50.0,8,20,28,17,25,26,20,8,1,4,64,Miasto Szkła Krosno,Sezon 2022/2023
2022-10-26 18:00,PGE Turów Zgorzelec(d),74 : 73W,74,27,44,61.4,4,21,19.0,31,65,47.7,8,15,53.3,11,24,35,13,17,14,14,10,2,3,79,Miasto Szkła Krosno,Sezon 2022/2023
2022-10-29 18:00,GKS Tychy(w),83 : 80P,80,17,33,51.5,9,29,31.0,26,62,41.9,19,23,82.6,6,20,26,21,26,20,16,6,0,1,77,Miasto Szkła Krosno,Sezon 2022/2023
2022-11-02 17:00,SKS Starogard Gdański(d),66 : 77P,66,17,36,47.2,8,30,26.7,25,66,37.9,8,15,53.3,8,25,33,19,18,20,8,6,2,1,70,Miasto Szkła Krosno,Sezon 2022/2023
2022-11-06 15:00,Decka Pelplin(w),74 : 80W,80,19,50,38.0,5,16,31.3,24,66,36.4,27,37,73.0,14,23,37,14,20,27,13,10,5,7,81,Miasto Szkła Krosno,Sezon 2022/2023
2022-11-13 18:00,MKKS Żak Koszalin(d),90 : 97P,90,26,45,57.8,6,22,27.3,32,67,47.8,20,27,74.1,13,25,38,14,28,25,17,6,2,2,91,Miasto Szkła Krosno,Sezon 2022/2023
2022-11-16 17:00,WKS Śląsk II Wrocław(d),91 : 65W,91,19,34,55.9,12,24,50.0,31,58,53.4,17,21,81.0,9,28,37,23,16,21,11,9,1,1,119,Miasto Szkła Krosno,Sezon 2022/2023
2022-11-19 18:00,Sensation Kotwica Kołobrzeg(w),85 : 59P,59,14,34,41.2,7,26,26.9,21,60,35.0,10,13,76.9,10,24,34,17,12,11,11,5,2,6,64,Miasto Szkła Krosno,Sezon 2022/2023
2022-11-27 18:00,Dziki Warszawa(d),87 : 65W,87,15,29,51.7,12,25,48.0,27,54,50.0,21,28,75.0,9,29,38,22,21,22,14,5,3,0,107,Miasto Szkła Krosno,Sezon 2022/2023
2022-12-07 18:00,HydroTruck Radom(w),102 : 68P,68,15,31,48.4,9,23,39.1,24,54,44.4,11,16,68.8,4,21,25,19,17,18,23,7,1,3,62,Miasto Szkła Krosno,Sezon 2022/2023
2022-12-11 18:00,BS Polonia Bytom(d),70 : 82P,70,17,35,48.6,9,26,34.6,26,61,42.6,9,14,64.3,9,28,37,18,19,12,20,5,5,3,75,Miasto Szkła Krosno,Sezon 2022/2023
2022-12-14 20:00,Enea Basket Poznań(w),62 : 68W,68,14,30,46.7,10,31,32.3,24,61,39.3,10,14,71.4,13,28,41,21,23,20,21,9,3,1,80,Miasto Szkła Krosno,Sezon 2022/2023
2022-12-17 20:00,WKK Wrocław(d),83 : 61W,83,25,41,61.0,9,29,31.0,34,70,48.6,6,11,54.5,11,28,39,20,18,16,13,10,3,1,101,Miasto Szkła Krosno,Sezon 2022/2023
2023-01-04 19:00,AZS AGH Kraków(w),74 : 73P,73,21,37,56.8,6,19,31.6,27,56,48.2,13,22,59.1,9,20,29,14,22,21,15,6,0,5,69,Miasto Szkła Krosno,Sezon 2022/2023
2023-01-07 15:00,Start II Lublin(w),77 : 114W,114,29,39,74.4,13,28,46.4,42,67,62.7,17,23,73.9,9,23,32,34,16,18,11,11,2,4,151,Miasto Szkła Krosno,Sezon 2022/2023
2023-01-15 18:00,Górnik Trans.eu Zamek Książ Wałbrzych(d),95 : 93W,95,15,33,45.5,16,38,42.1,31,71,43.7,17,26,65.4,12,21,33,22,26,25,19,6,1,3,89,Miasto Szkła Krosno,Sezon 2022/2023
2023-01-18 18:00,Weegree AZS Politechnika Opolska(w),80 : 77P,77,20,36,55.6,8,27,29.6,28,63,44.4,13,17,76.5,8,26,34,17,22,20,19,12,1,3,83,Miasto Szkła Krosno,Sezon 2022/2023
2023-01-21 18:00,KKS Polonia Warszawa(d),76 : 64W,76,25,39,64.1,7,28,25.0,32,67,47.8,5,13,38.5,17,25,42,16,19,17,14,4,3,0,84,Miasto Szkła Krosno,Sezon 2022/2023
2023-01-28 15:00,PGE Turów Zgorzelec(w),62 : 86W,86,24,36,66.7,9,26,34.6,33,62,53.2,11,18,61.1,11,29,40,24,21,24,19,10,2,1,107,Miasto Szkła Krosno,Sezon 2022/2023
2023-02-05 18:00,GKS Tychy(d),66 : 72P,66,17,32,53.1,8,23,34.8,25,55,45.5,8,12,66.7,4,21,25,17,23,13,17,8,2,2,67,Miasto Szkła Krosno,Sezon 2022/2023
2023-02-08 19:00,SKS Starogard Gdański(w),82 : 63P,63,18,37,48.6,6,27,22.2,24,64,37.5,9,15,60.0,8,20,28,12,25,12,6,7,3,3,61,Miasto Szkła Krosno,Sezon 2022/2023
2023-02-12 20:00,Decka Pelplin(d),83 : 82W,83,21,34,61.8,9,32,28.1,30,66,45.5,14,17,82.4,12,19,31,24,26,18,14,9,2,3,96,Miasto Szkła Krosno,Sezon 2022/2023
2023-02-19 18:00,MKKS Żak Koszalin(w),75 : 68P,68,14,29,48.3,10,28,35.7,24,57,42.1,10,11,90.9,4,22,26,18,29,17,14,6,0,2,70,Miasto Szkła Krosno,Sezon 2022/2023
2023-03-01 18:00,Sensation Kotwica Kołobrzeg(d),64 : 70P,64,13,28,46.4,7,25,28.0,20,53,37.7,17,22,77.3,3,23,26,20,20,15,10,7,4,1,73,Miasto Szkła Krosno,Sezon 2022/2023
2023-03-05 18:00,Dziki Warszawa(w),74 : 70P,70,15,32,46.9,9,29,31.0,24,61,39.3,13,18,72.2,9,22,31,13,21,19,13,8,1,4,68,Miasto Szkła Krosno,Sezon 2022/2023
2023-03-11 20:00,HydroTruck Radom(d),83 : 94P,83,22,47,46.8,8,28,28.6,30,75,40.0,15,23,65.2,12,14,26,18,25,23,5,9,2,5,80,Miasto Szkła Krosno,Sezon 2022/2023
2023-03-18 18:00,BS Polonia Bytom(w),80 : 85W,85,29,45,64.4,6,23,26.1,35,68,51.5,9,17,52.9,13,28,41,18,22,18,16,4,2,1,93,Miasto Szkła Krosno,Sezon 2022/2023
2023-03-26 20:00,Enea Basket Poznań(d),87 : 62W,87,22,38,57.9,11,22,50.0,33,60,55.0,10,20,50.0,12,32,44,24,22,22,22,13,2,1,111,Miasto Szkła Krosno,Sezon 2022/2023
2023-03-30 18:00,WKS Śląsk II Wrocław(w),58 : 67W,67,14,27,51.9,7,25,28.0,21,52,40.4,18,25,72.0,5,26,31,16,16,25,15,8,5,3,74,Miasto Szkła Krosno,Sezon 2022/2023
2023-04-01 13:00,WKK Wrocław(w),78 : 77P,77,16,34,47.1,10,29,34.5,26,63,41.3,15,21,71.4,9,25,34,17,25,20,10,8,2,2,85,Miasto Szkła Krosno,Sezon 2022/2023
2023-04-05 18:00,AZS AGH Kraków(d),68 : 82P,68,23,38,60.5,3,19,15.8,26,57,45.6,13,22,59.1,8,26,34,12,22,18,13,4,2,3,67,Miasto Szkła Krosno,Sezon 2022/2023
2022-09-24 13:00,PGE Turów Zgorzelec(w),100 : 103W,103,27,51,52.9,8,14,57.1,35,65,53.8,25,31,80.6,8,19,27,17,21,26,11,7,1,2,108,MKKS Żak Koszalin,Sezon 2022/2023
2022-10-01 20:00,BS Polonia Bytom(d),94 : 74W,94,28,48,58.3,7,26,26.9,35,74,47.3,17,25,68.0,15,25,40,25,22,17,17,17,2,2,114,MKKS Żak Koszalin,Sezon 2022/2023
2022-10-08 18:00,GKS Tychy(w),98 : 83P,83,11,26,42.3,13,31,41.9,24,57,42.1,22,33,66.7,9,21,30,19,26,23,20,6,2,2,76,MKKS Żak Koszalin,Sezon 2022/2023
2022-10-15 18:00,Enea Basket Poznań(d),94 : 103P,94,22,36,61.1,11,29,37.9,33,65,50.8,17,21,81.0,7,20,27,18,21,24,15,11,1,0,100,MKKS Żak Koszalin,Sezon 2022/2023
2022-10-20 19:00,SKS Starogard Gdański(w),91 : 76P,76,19,46,41.3,7,25,28.0,26,71,36.6,17,27,63.0,9,25,34,12,24,20,13,13,1,3,68,MKKS Żak Koszalin,Sezon 2022/2023
2022-10-29 18:00,WKK Wrocław(d),89 : 81W,89,21,35,60.0,10,36,27.8,31,71,43.7,17,24,70.8,12,28,40,22,26,20,8,5,3,0,104,MKKS Żak Koszalin,Sezon 2022/2023
2022-11-02 19:00,Decka Pelplin(w),84 : 86W,86,11,33,33.3,16,34,47.1,27,67,40.3,16,21,76.2,9,19,28,24,23,22,17,16,2,3,94,MKKS Żak Koszalin,Sezon 2022/2023
2022-11-05 18:00,AZS AGH Kraków(d),86 : 88P,86,25,36,69.4,8,22,36.4,33,58,56.9,12,22,54.5,7,22,29,23,16,17,9,6,2,0,102,MKKS Żak Koszalin,Sezon 2022/2023
2022-11-13 18:00,Miasto Szkła Krosno(w),90 : 97W,97,21,41,51.2,10,22,45.5,31,63,49.2,25,35,71.4,6,22,28,25,26,28,9,9,2,2,110,MKKS Żak Koszalin,Sezon 2022/2023
2022-11-16 20:00,Start II Lublin(d),114 : 72W,114,35,50,70.0,12,31,38.7,47,81,58.0,8,12,66.7,12,23,35,33,18,16,11,16,6,1,155,MKKS Żak Koszalin,Sezon 2022/2023
2022-11-19 20:00,WKS Śląsk II Wrocław(w),88 : 68P,68,15,33,45.5,7,20,35.0,22,53,41.5,17,20,85.0,6,20,26,15,19,20,20,10,4,2,69,MKKS Żak Koszalin,Sezon 2022/2023
2022-11-26 18:00,Górnik Trans.eu Zamek Książ Wałbrzych(d),96 : 94W,96,17,40,42.5,13,28,46.4,30,68,44.1,23,24,95.8,11,19,30,17,18,23,12,4,0,4,96,MKKS Żak Koszalin,Sezon 2022/2023
2022-12-03 20:00,Sensation Kotwica Kołobrzeg(w),75 : 64P,64,17,41,41.5,8,27,29.6,25,68,36.8,6,8,75.0,11,23,34,10,15,18,16,7,1,6,55,MKKS Żak Koszalin,Sezon 2022/2023
2022-12-10 15:00,Weegree AZS Politechnika Opolska(d),92 : 73W,92,23,36,63.9,11,25,44.0,34,61,55.7,13,18,72.2,7,27,34,22,18,19,13,7,2,2,112,MKKS Żak Koszalin,Sezon 2022/2023
2022-12-14 18:00,Dziki Warszawa(w),76 : 60P,60,15,31,48.4,6,23,26.1,21,54,38.9,12,14,85.7,7,29,36,14,18,17,27,10,8,5,66,MKKS Żak Koszalin,Sezon 2022/2023
2022-12-17 20:00,KKS Polonia Warszawa(d),84 : 85P,84,18,38,47.4,10,25,40.0,28,63,44.4,18,27,66.7,10,20,30,16,22,24,11,6,3,2,84,MKKS Żak Koszalin,Sezon 2022/2023
2023-01-04 18:00,HydroTruck Radom(w),77 : 83W,83,19,33,57.6,10,26,38.5,29,59,49.2,15,28,53.6,8,30,38,16,29,22,17,6,1,0,84,MKKS Żak Koszalin,Sezon 2022/2023
2023-01-07 18:00,PGE Turów Zgorzelec(d),94 : 84W,94,22,47,46.8,8,21,38.1,30,68,44.1,26,28,92.9,13,26,39,17,23,24,14,8,1,2,105,MKKS Żak Koszalin,Sezon 2022/2023
2023-01-14 20:00,BS Polonia Bytom(w),86 : 107W,107,24,34,70.6,12,30,40.0,36,64,56.3,23,27,85.2,10,24,34,17,21,21,12,6,1,0,121,MKKS Żak Koszalin,Sezon 2022/2023
2023-01-18 18:00,GKS Tychy(d),79 : 80P,79,16,37,43.2,8,27,29.6,24,64,37.5,23,27,85.2,7,21,28,23,20,23,12,9,2,0,85,MKKS Żak Koszalin,Sezon 2022/2023
2023-01-21 18:00,Enea Basket Poznań(w),90 : 77P,77,12,36,33.3,13,31,41.9,25,67,37.3,14,22,63.6,12,20,32,20,26,23,15,11,2,5,77,MKKS Żak Koszalin,Sezon 2022/2023
2023-01-28 20:00,SKS Starogard Gdański(d),84 : 59W,84,29,51,56.9,3,15,20.0,32,66,48.5,17,22,77.3,12,32,44,16,20,17,12,6,7,2,106,MKKS Żak Koszalin,Sezon 2022/2023
2023-02-04 18:00,WKK Wrocław(w),75 : 85W,85,22,37,59.5,9,24,37.5,31,61,50.8,14,16,87.5,5,30,35,22,24,19,12,5,2,1,105,MKKS Żak Koszalin,Sezon 2022/2023
2023-02-08 18:00,Decka Pelplin(d),77 : 78P,77,11,31,35.5,13,35,37.1,24,66,36.4,16,25,64.0,16,19,35,17,21,20,17,10,4,6,75,MKKS Żak Koszalin,Sezon 2022/2023
2023-02-11 15:00,AZS AGH Kraków(w),74 : 72P,72,21,41,51.2,4,21,19.0,25,62,40.3,18,21,85.7,12,22,34,13,23,18,15,10,1,3,75,MKKS Żak Koszalin,Sezon 2022/2023
2023-02-19 18:00,Miasto Szkła Krosno(d),75 : 68W,75,17,31,54.8,7,27,25.9,24,58,41.4,20,29,69.0,5,26,31,16,17,29,12,9,2,0,78,MKKS Żak Koszalin,Sezon 2022/2023
2023-02-26 18:00,Start II Lublin(w),74 : 116W,116,41,65,63.1,7,28,25.0,48,93,51.6,13,16,81.3,18,26,44,33,24,14,15,24,4,4,158,MKKS Żak Koszalin,Sezon 2022/2023
2023-03-04 20:00,Górnik Trans.eu Zamek Książ Wałbrzych(w),79 : 69P,69,15,33,45.5,8,27,29.6,23,60,38.3,15,25,60.0,6,26,32,11,26,22,20,7,1,7,53,MKKS Żak Koszalin,Sezon 2022/2023
2023-03-11 18:00,Sensation Kotwica Kołobrzeg(d),83 : 95P,83,20,38,52.6,8,24,33.3,28,62,45.2,19,26,73.1,12,22,34,20,18,25,12,4,2,3,90,MKKS Żak Koszalin,Sezon 2022/2023
2023-03-18 15:00,Weegree AZS Politechnika Opolska(w),98 : 106W,106,23,43,53.5,10,28,35.7,33,71,46.5,30,35,85.7,10,25,35,16,24,28,15,11,3,4,113,MKKS Żak Koszalin,Sezon 2022/2023
2023-03-23 18:00,WKS Śląsk II Wrocław(d),76 : 88P,76,25,53,47.2,3,21,14.3,28,74,37.8,17,23,73.9,9,24,33,11,21,22,9,7,4,2,70,MKKS Żak Koszalin,Sezon 2022/2023
2023-03-26 18:00,Dziki Warszawa(d),82 : 86P,82,20,35,57.1,6,29,20.7,26,64,40.6,24,33,72.7,14,25,39,14,29,27,19,10,5,1,84,MKKS Żak Koszalin,Sezon 2022/2023
2023-04-02 18:00,KKS Polonia Warszawa(w),75 : 87W,87,18,35,51.4,10,30,33.3,28,65,43.1,21,30,70.0,5,34,39,17,32,27,15,11,5,4,98,MKKS Żak Koszalin,Sezon 2022/2023
2023-04-05 18:00,HydroTruck Radom(d),91 : 110P,91,11,27,40.7,17,40,42.5,28,67,41.8,18,22,81.8,5,20,25,26,25,22,12,6,3,1,96,MKKS Żak Koszalin,Sezon 2022/2023
2022-09-24 13:00,MKKS Żak Koszalin(d),100 : 103P,100,16,28,57.1,15,35,42.9,31,63,49.2,23,29,79.3,8,22,30,20,26,21,11,7,2,1,110,PGE Turów Zgorzelec,Sezon 2022/2023
2022-10-02 18:00,GKS Tychy(d),61 : 68P,61,14,34,41.2,7,30,23.3,21,64,32.8,12,14,85.7,10,21,31,15,25,20,14,14,3,1,65,PGE Turów Zgorzelec,Sezon 2022/2023
2022-10-12 19:00,SKS Starogard Gdański(w),62 : 75W,75,24,43,55.8,6,16,37.5,30,59,50.8,9,18,50.0,5,23,28,14,22,16,16,8,2,3,73,PGE Turów Zgorzelec,Sezon 2022/2023
2022-10-16 15:00,Decka Pelplin(d),87 : 86W,87,20,39,51.3,12,24,50.0,32,63,50.8,11,18,61.1,11,15,26,19,20,19,11,9,2,2,94,PGE Turów Zgorzelec,Sezon 2022/2023
2022-10-26 18:00,Miasto Szkła Krosno(w),74 : 73P,73,25,45,55.6,4,18,22.2,29,63,46.0,11,15,73.3,10,21,31,12,15,17,15,11,3,2,77,PGE Turów Zgorzelec,Sezon 2022/2023
2022-10-30 15:00,WKS Śląsk II Wrocław(d),74 : 90P,74,22,37,59.5,7,27,25.9,29,64,45.3,9,11,81.8,6,13,19,18,20,19,13,11,2,2,74,PGE Turów Zgorzelec,Sezon 2022/2023
2022-11-02 19:00,Sensation Kotwica Kołobrzeg(w),92 : 57P,57,16,30,53.3,7,23,30.4,23,53,43.4,4,12,33.3,3,20,23,11,9,14,20,4,0,3,37,PGE Turów Zgorzelec,Sezon 2022/2023
2022-11-05 15:00,Dziki Warszawa(d),69 : 91P,69,14,33,42.4,11,24,45.8,25,57,43.9,8,16,50.0,10,19,29,19,25,18,19,3,2,1,63,PGE Turów Zgorzelec,Sezon 2022/2023
2022-11-11 18:00,HydroTruck Radom(w),89 : 72P,72,14,28,50.0,10,32,31.3,24,60,40.0,14,21,66.7,11,17,28,17,17,22,10,7,3,2,74,PGE Turów Zgorzelec,Sezon 2022/2023
2022-11-16 17:00,BS Polonia Bytom(d),97 : 80W,97,33,48,68.8,6,21,28.6,39,69,56.5,13,20,65.0,12,23,35,20,24,19,13,7,1,3,110,PGE Turów Zgorzelec,Sezon 2022/2023
2022-11-20 15:00,Enea Basket Poznań(w),93 : 74P,74,15,32,46.9,10,23,43.5,25,55,45.5,14,26,53.8,8,16,24,19,17,25,16,6,0,1,65,PGE Turów Zgorzelec,Sezon 2022/2023
2022-11-26 18:00,WKK Wrocław(w),72 : 55P,55,15,43,34.9,5,24,20.8,20,67,29.9,10,21,47.6,13,27,40,10,20,18,14,11,4,4,48,PGE Turów Zgorzelec,Sezon 2022/2023
2022-12-03 15:00,AZS AGH Kraków(w),79 : 75P,75,24,46,52.2,5,21,23.8,29,67,43.3,12,25,48.0,11,23,34,15,18,23,7,7,3,3,76,PGE Turów Zgorzelec,Sezon 2022/2023
2022-12-10 18:00,Start II Lublin(w),87 : 129W,129,34,47,72.3,16,27,59.3,50,74,67.6,13,16,81.3,4,26,30,36,21,13,10,9,1,2,168,PGE Turów Zgorzelec,Sezon 2022/2023
2022-12-14 19:00,Górnik Trans.eu Zamek Książ Wałbrzych(d),66 : 84P,66,17,43,39.5,5,15,33.3,22,58,37.9,17,19,89.5,7,22,29,16,10,18,16,6,1,3,64,PGE Turów Zgorzelec,Sezon 2022/2023
2022-12-18 18:00,Weegree AZS Politechnika Opolska(d),88 : 92P,88,16,27,59.3,11,28,39.3,27,55,49.1,23,33,69.7,6,23,29,18,25,29,18,10,1,0,90,PGE Turów Zgorzelec,Sezon 2022/2023
2023-01-04 19:00,KKS Polonia Warszawa(w),87 : 64P,64,21,43,48.8,1,13,7.7,22,56,39.3,19,21,90.5,2,21,23,16,22,21,15,9,2,1,63,PGE Turów Zgorzelec,Sezon 2022/2023
2023-01-07 18:00,MKKS Żak Koszalin(w),94 : 84P,84,23,48,47.9,6,24,25.0,29,72,40.3,20,21,95.2,10,18,28,19,24,22,12,7,2,1,84,PGE Turów Zgorzelec,Sezon 2022/2023
2023-01-14 15:00,GKS Tychy(w),66 : 76W,76,21,36,58.3,7,24,29.2,28,60,46.7,13,19,68.4,6,24,30,15,23,20,12,9,5,4,85,PGE Turów Zgorzelec,Sezon 2022/2023
2023-01-18 17:00,SKS Starogard Gdański(d),100 : 106P,100,28,56,50.0,9,22,40.9,37,78,47.4,17,28,60.7,7,27,34,25,32,24,11,9,4,0,109,PGE Turów Zgorzelec,Sezon 2022/2023
2023-01-22 18:00,Decka Pelplin(w),91 : 84P,84,21,41,51.2,6,25,24.0,27,66,40.9,24,38,63.2,7,23,30,15,29,28,8,11,6,1,85,PGE Turów Zgorzelec,Sezon 2022/2023
2023-01-28 15:00,Miasto Szkła Krosno(d),62 : 86P,62,13,34,38.2,6,21,28.6,19,55,34.5,18,22,81.8,6,18,24,12,24,21,20,12,1,2,51,PGE Turów Zgorzelec,Sezon 2022/2023
2023-02-01 18:30,WKS Śląsk II Wrocław(w),67 : 75W,75,21,46,45.7,7,18,38.9,28,64,43.8,12,17,70.6,9,22,31,19,18,17,11,9,2,2,84,PGE Turów Zgorzelec,Sezon 2022/2023
2023-02-08 17:00,Sensation Kotwica Kołobrzeg(d),72 : 79P,72,24,41,58.5,5,24,20.8,29,65,44.6,9,17,52.9,9,25,34,25,20,14,12,7,1,4,83,PGE Turów Zgorzelec,Sezon 2022/2023
2023-02-12 19:00,Dziki Warszawa(w),82 : 64P,64,16,37,43.2,7,26,26.9,23,63,36.5,11,21,52.4,8,21,29,15,20,19,5,6,3,0,62,PGE Turów Zgorzelec,Sezon 2022/2023
2023-02-19 18:00,HydroTruck Radom(d),87 : 86W,87,17,38,44.7,13,28,46.4,30,66,45.5,14,21,66.7,9,17,26,20,18,18,6,9,1,2,94,PGE Turów Zgorzelec,Sezon 2022/2023
2023-02-25 18:00,BS Polonia Bytom(w),86 : 64P,64,23,52,44.2,3,17,17.6,26,69,37.7,9,15,60.0,9,27,36,12,20,15,13,10,1,3,61,PGE Turów Zgorzelec,Sezon 2022/2023
2023-03-08 20:00,Enea Basket Poznań(d),84 : 85P,84,19,40,47.5,13,26,50.0,32,66,48.5,7,16,43.8,8,20,28,21,23,20,13,5,3,2,85,PGE Turów Zgorzelec,Sezon 2022/2023
2023-03-12 18:00,AZS AGH Kraków(d),69 : 78P,69,22,45,48.9,5,20,25.0,27,65,41.5,10,21,47.6,7,25,32,17,25,22,10,6,2,4,67,PGE Turów Zgorzelec,Sezon 2022/2023
2023-03-16 18:00,WKK Wrocław(d),79 : 101P,79,24,44,54.5,6,21,28.6,30,65,46.2,13,20,65.0,3,22,25,23,24,19,14,11,2,1,84,PGE Turów Zgorzelec,Sezon 2022/2023
2023-03-21 18:00,Start II Lublin(d),85 : 70W,85,24,42,57.1,10,24,41.7,34,66,51.5,7,11,63.6,7,25,32,26,19,13,18,8,2,2,99,PGE Turów Zgorzelec,Sezon 2022/2023
2023-03-25 20:00,Górnik Trans.eu Zamek Książ Wałbrzych(w),70 : 84W,84,15,38,39.5,13,24,54.2,28,62,45.2,15,16,93.8,6,25,31,20,16,18,12,12,0,4,100,PGE Turów Zgorzelec,Sezon 2022/2023
2023-04-02 15:00,Weegree AZS Politechnika Opolska(w),112 : 88P,88,28,46,60.9,7,21,33.3,35,67,52.2,11,15,73.3,6,20,26,14,11,21,13,7,0,3,86,PGE Turów Zgorzelec,Sezon 2022/2023
2023-04-05 18:00,KKS Polonia Warszawa(d),91 : 102P,91,23,39,59.0,8,18,44.4,31,57,54.4,21,22,95.5,1,19,20,26,20,21,14,5,1,3,102,PGE Turów Zgorzelec,Sezon 2022/2023
2022-09-24 18:00,WKK Wrocław(d),64 : 66P,64,14,35,40.0,10,33,30.3,24,68,35.3,6,10,60.0,10,27,37,14,22,13,11,8,4,0,68,Sensation Kotwica Kołobrzeg,Sezon 2022/2023
2022-10-01 18:00,AZS AGH Kraków(w),81 : 92W,92,18,35,51.4,12,22,54.5,30,57,52.6,20,24,83.3,8,24,32,17,23,22,12,4,3,3,105,Sensation Kotwica Kołobrzeg,Sezon 2022/2023
2022-10-07 19:00,Start II Lublin(d),113 : 51W,113,36,49,73.5,13,38,34.2,49,87,56.3,2,5,40.0,13,31,44,31,12,8,5,19,2,1,163,Sensation Kotwica Kołobrzeg,Sezon 2022/2023
2022-10-15 18:00,Górnik Trans.eu Zamek Książ Wałbrzych(w),84 : 81P,81,12,23,52.2,17,46,37.0,29,69,42.0,6,11,54.5,7,23,30,19,24,17,15,6,1,5,77,Sensation Kotwica Kołobrzeg,Sezon 2022/2023
2022-10-22 18:00,Weegree AZS Politechnika Opolska(d),83 : 67W,83,9,22,40.9,18,37,48.6,27,59,45.8,11,18,61.1,7,26,33,20,25,15,18,8,3,0,90,Sensation Kotwica Kołobrzeg,Sezon 2022/2023
2022-10-29 15:00,KKS Polonia Warszawa(w),74 : 82W,82,24,45,53.3,10,21,47.6,34,66,51.5,4,10,40.0,5,21,26,19,19,12,5,10,6,6,100,Sensation Kotwica Kołobrzeg,Sezon 2022/2023
2022-11-02 19:00,PGE Turów Zgorzelec(d),92 : 57W,92,17,33,51.5,19,32,59.4,36,65,55.4,1,3,33.3,6,28,34,28,14,9,13,7,3,0,120,Sensation Kotwica Kołobrzeg,Sezon 2022/2023
2022-11-05 20:00,GKS Tychy(w),73 : 82W,82,15,23,65.2,12,38,31.6,27,61,44.3,16,18,88.9,4,32,36,15,23,20,14,11,3,0,97,Sensation Kotwica Kołobrzeg,Sezon 2022/2023
2022-11-12 18:00,SKS Starogard Gdański(d),94 : 101P,94,13,28,46.4,19,38,50.0,32,66,48.5,11,17,64.7,7,22,29,14,25,16,5,4,6,2,102,Sensation Kotwica Kołobrzeg,Sezon 2022/2023
2022-11-16 20:00,Decka Pelplin(w),74 : 77W,77,23,38,60.5,9,25,36.0,32,63,50.8,4,10,40.0,8,26,34,18,15,17,13,7,2,3,88,Sensation Kotwica Kołobrzeg,Sezon 2022/2023
2022-11-19 18:00,Miasto Szkła Krosno(d),85 : 59W,85,10,26,38.5,19,39,48.7,29,65,44.6,8,10,80.0,8,25,33,24,12,12,8,4,6,2,106,Sensation Kotwica Kołobrzeg,Sezon 2022/2023
2022-11-27 18:00,WKS Śląsk II Wrocław(w),69 : 85W,85,16,29,55.2,11,30,36.7,27,59,45.8,20,27,74.1,12,24,36,21,16,20,12,13,1,2,105,Sensation Kotwica Kołobrzeg,Sezon 2022/2023
2022-12-03 20:00,MKKS Żak Koszalin(d),75 : 64W,75,10,22,45.5,15,34,44.1,25,56,44.6,10,14,71.4,8,23,31,17,18,15,14,8,6,1,88,Sensation Kotwica Kołobrzeg,Sezon 2022/2023
2022-12-10 18:00,Dziki Warszawa(d),62 : 67P,62,13,24,54.2,9,37,24.3,22,61,36.1,9,15,60.0,7,33,40,13,23,16,17,7,0,4,60,Sensation Kotwica Kołobrzeg,Sezon 2022/2023
2022-12-14 17:00,HydroTruck Radom(w),82 : 68P,68,17,34,50.0,9,38,23.7,26,72,36.1,7,9,77.8,11,22,33,23,16,9,14,14,2,2,78,Sensation Kotwica Kołobrzeg,Sezon 2022/2023
2022-12-17 18:00,BS Polonia Bytom(d),75 : 83P,75,18,35,51.4,10,38,26.3,28,73,38.4,9,12,75.0,11,28,39,20,19,16,9,6,2,4,85,Sensation Kotwica Kołobrzeg,Sezon 2022/2023
2023-01-04 20:00,Enea Basket Poznań(w),63 : 67W,67,13,34,38.2,8,27,29.6,21,61,34.4,17,23,73.9,10,24,34,18,18,20,16,16,4,2,77,Sensation Kotwica Kołobrzeg,Sezon 2022/2023
2023-01-11 18:00,WKK Wrocław(w),71 : 75W,75,21,44,47.7,8,33,24.2,29,77,37.7,9,12,75.0,9,28,37,15,23,14,8,10,2,3,80,Sensation Kotwica Kołobrzeg,Sezon 2022/2023
2023-01-15 15:00,AZS AGH Kraków(d),66 : 75P,66,11,26,42.3,11,38,28.9,22,64,34.4,11,16,68.8,6,27,33,10,23,15,15,9,4,3,60,Sensation Kotwica Kołobrzeg,Sezon 2022/2023
2023-01-18 16:00,Start II Lublin(w),77 : 103W,103,28,43,65.1,10,37,27.0,38,80,47.5,17,20,85.0,13,24,37,30,18,18,6,18,4,7,141,Sensation Kotwica Kołobrzeg,Sezon 2022/2023
2023-01-22 20:00,Górnik Trans.eu Zamek Książ Wałbrzych(d),72 : 85P,72,15,27,55.6,12,36,33.3,27,63,42.9,6,13,46.2,9,25,34,14,24,19,17,11,1,5,72,Sensation Kotwica Kołobrzeg,Sezon 2022/2023
2023-01-28 18:00,Weegree AZS Politechnika Opolska(w),85 : 69P,69,12,26,46.2,8,27,29.6,20,53,37.7,21,27,77.8,8,23,31,15,24,23,16,5,4,3,69,Sensation Kotwica Kołobrzeg,Sezon 2022/2023
2023-02-04 15:00,KKS Polonia Warszawa(d),47 : 86P,47,13,33,39.4,6,27,22.2,19,60,31.7,3,11,27.3,4,23,27,18,17,16,13,7,3,7,40,Sensation Kotwica Kołobrzeg,Sezon 2022/2023
2023-02-08 17:00,PGE Turów Zgorzelec(w),72 : 79W,79,17,39,43.6,9,22,40.9,26,61,42.6,18,22,81.8,8,26,34,20,15,20,12,10,4,1,96,Sensation Kotwica Kołobrzeg,Sezon 2022/2023
2023-02-11 18:00,GKS Tychy(d),82 : 83P,82,17,31,54.8,12,32,37.5,29,63,46.0,12,17,70.6,9,28,37,19,19,17,11,5,1,0,94,Sensation Kotwica Kołobrzeg,Sezon 2022/2023
2023-02-18 17:00,SKS Starogard Gdański(w),71 : 78W,78,16,34,47.1,12,31,38.7,28,65,43.1,10,11,90.9,5,32,37,20,23,15,7,1,4,3,95,Sensation Kotwica Kołobrzeg,Sezon 2022/2023
2023-02-25 15:00,Decka Pelplin(d),79 : 68W,79,13,27,48.1,12,36,33.3,25,63,39.7,17,29,58.6,12,25,37,16,19,24,10,9,1,1,82,Sensation Kotwica Kołobrzeg,Sezon 2022/2023
2023-03-01 18:00,Miasto Szkła Krosno(w),64 : 70W,70,19,30,63.3,7,28,25.0,26,58,44.8,11,15,73.3,5,29,34,18,15,20,13,5,1,4,79,Sensation Kotwica Kołobrzeg,Sezon 2022/2023
2023-03-11 18:00,MKKS Żak Koszalin(w),83 : 95W,95,26,40,65.0,11,29,37.9,37,69,53.6,10,16,62.5,4,20,24,22,25,18,8,3,3,2,101,Sensation Kotwica Kołobrzeg,Sezon 2022/2023
2023-03-18 20:00,Dziki Warszawa(w),67 : 66P,66,16,28,57.1,10,32,31.3,26,60,43.3,4,10,40.0,2,27,29,13,20,15,11,7,1,2,65,Sensation Kotwica Kołobrzeg,Sezon 2022/2023
2023-03-22 18:00,WKS Śląsk II Wrocław(d),71 : 69W,71,17,27,63.0,8,29,27.6,25,56,44.6,13,21,61.9,4,24,28,13,17,18,16,11,2,2,70,Sensation Kotwica Kołobrzeg,Sezon 2022/2023
2023-03-26 18:00,HydroTruck Radom(d),93 : 95P,93,10,26,38.5,19,51,37.3,29,77,37.7,16,21,76.2,9,28,37,22,24,18,13,10,1,1,97,Sensation Kotwica Kołobrzeg,Sezon 2022/2023
2023-04-01 18:00,BS Polonia Bytom(w),77 : 107W,107,24,34,70.6,17,39,43.6,41,73,56.2,8,13,61.5,5,39,44,22,18,14,9,4,3,3,134,Sensation Kotwica Kołobrzeg,Sezon 2022/2023
2023-04-05 18:00,Enea Basket Poznań(d),86 : 89P,86,24,39,61.5,9,33,27.3,33,72,45.8,11,14,78.6,10,22,32,22,20,17,12,9,6,3,101,Sensation Kotwica Kołobrzeg,Sezon 2022/2023
2023-04-15 18:00,HydroTruck Radom(w),71 : 65P,65,19,37,51.4,7,31,22.6,26,68,38.2,6,9,66.7,6,28,34,18,22,20,12,10,2,1,72,Sensation Kotwica Kołobrzeg,Sezon 2022/2023
2023-04-16 18:00,HydroTruck Radom(w),83 : 78P,78,15,25,60.0,13,38,34.2,28,63,44.4,9,12,75.0,3,28,31,19,24,18,15,3,2,3,80,Sensation Kotwica Kołobrzeg,Sezon 2022/2023
2023-04-22 20:00,HydroTruck Radom(d),73 : 64W,73,12,32,37.5,12,29,41.4,24,61,39.3,13,17,76.5,5,31,36,11,14,16,12,9,1,1,77,Sensation Kotwica Kołobrzeg,Sezon 2022/2023
2023-04-23 20:00,HydroTruck Radom(d),76 : 86P,76,17,30,56.7,10,31,32.3,27,61,44.3,12,18,66.7,5,26,31,19,27,17,19,7,7,1,81,Sensation Kotwica Kołobrzeg,Sezon 2022/2023
2022-09-24 18:00,Weegree AZS Politechnika Opolska(d),79 : 61W,79,24,38,63.2,5,20,25.0,29,58,50.0,16,24,66.7,12,30,42,22,16,20,15,7,4,2,102,SKS Starogard Gdański,Sezon 2022/2023
2022-10-01 15:00,KKS Polonia Warszawa(w),74 : 86W,86,18,34,52.9,9,16,56.3,27,50,54.0,23,34,67.6,4,32,36,22,16,27,16,3,2,4,99,SKS Starogard Gdański,Sezon 2022/2023
2022-10-12 19:00,PGE Turów Zgorzelec(d),62 : 75P,62,20,39,51.3,2,19,10.5,22,58,37.9,16,21,76.2,10,24,34,10,16,22,19,5,3,2,54,SKS Starogard Gdański,Sezon 2022/2023
2022-10-15 20:00,GKS Tychy(w),101 : 55P,55,12,28,42.9,4,25,16.0,16,53,30.2,19,23,82.6,5,23,28,11,23,25,23,3,0,0,33,SKS Starogard Gdański,Sezon 2022/2023
2022-10-20 19:00,MKKS Żak Koszalin(d),91 : 76W,91,25,45,55.6,8,27,29.6,33,72,45.8,17,23,73.9,10,35,45,26,20,22,15,7,3,1,112,SKS Starogard Gdański,Sezon 2022/2023
2022-10-26 19:00,Decka Pelplin(d),72 : 56W,72,12,31,38.7,10,26,38.5,22,57,38.6,18,24,75.0,6,33,39,17,13,23,10,4,7,6,88,SKS Starogard Gdański,Sezon 2022/2023
2022-11-02 17:00,Miasto Szkła Krosno(w),66 : 77W,77,18,33,54.5,10,31,32.3,28,64,43.8,11,16,68.8,7,31,38,19,20,18,12,5,1,2,87,SKS Starogard Gdański,Sezon 2022/2023
2022-11-06 15:00,WKS Śląsk II Wrocław(d),84 : 74W,84,25,40,62.5,6,12,50.0,31,52,59.6,16,26,61.5,2,30,32,18,20,24,15,7,2,4,97,SKS Starogard Gdański,Sezon 2022/2023
2022-11-12 18:00,Sensation Kotwica Kołobrzeg(w),94 : 101W,101,17,32,53.1,12,25,48.0,29,57,50.9,31,42,73.8,6,26,32,16,16,24,5,2,2,6,109,SKS Starogard Gdański,Sezon 2022/2023
2022-11-17 19:00,Dziki Warszawa(d),91 : 71W,91,23,41,56.1,9,21,42.9,32,62,51.6,18,24,75.0,6,29,35,21,19,21,8,8,1,5,112,SKS Starogard Gdański,Sezon 2022/2023
2022-11-23 18:00,HydroTruck Radom(w),87 : 71P,71,15,36,41.7,6,24,25.0,21,60,35.0,23,37,62.2,13,23,36,18,13,29,14,3,4,3,65,SKS Starogard Gdański,Sezon 2022/2023
2022-11-27 15:00,BS Polonia Bytom(d),97 : 87W,97,22,32,68.8,14,23,60.9,36,55,65.5,11,15,73.3,2,26,28,25,18,19,21,5,4,4,115,SKS Starogard Gdański,Sezon 2022/2023
2022-12-03 20:00,Enea Basket Poznań(w),80 : 89W,89,21,38,55.3,9,25,36.0,30,63,47.6,20,23,87.0,5,26,31,19,17,21,9,7,1,2,102,SKS Starogard Gdański,Sezon 2022/2023
2022-12-11 15:00,WKK Wrocław(w),87 : 66P,66,17,33,51.5,7,26,26.9,24,59,40.7,11,18,61.1,10,26,36,15,20,21,18,6,5,2,68,SKS Starogard Gdański,Sezon 2022/2023
2022-12-14 20:00,AZS AGH Kraków(w),61 : 66W,66,19,42,45.2,1,12,8.3,20,54,37.0,25,34,73.5,9,33,42,20,18,27,15,6,2,2,78,SKS Starogard Gdański,Sezon 2022/2023
2022-12-17 16:00,Start II Lublin(d),103 : 73W,103,24,33,72.7,16,39,41.0,40,72,55.6,7,9,77.8,6,31,37,37,11,9,12,12,5,2,148,SKS Starogard Gdański,Sezon 2022/2023
2023-01-04 17:00,Górnik Trans.eu Zamek Książ Wałbrzych(w),78 : 66P,66,9,23,39.1,10,28,35.7,19,51,37.3,18,22,81.8,6,30,36,16,14,23,15,1,1,5,69,SKS Starogard Gdański,Sezon 2022/2023
2023-01-07 18:00,Weegree AZS Politechnika Opolska(w),97 : 92P,92,19,37,51.4,7,32,21.9,26,69,37.7,33,41,80.5,11,28,39,12,21,29,13,6,1,5,86,SKS Starogard Gdański,Sezon 2022/2023
2023-01-14 18:00,KKS Polonia Warszawa(d),84 : 88P,84,19,35,54.3,8,21,38.1,27,56,48.2,22,32,68.8,5,18,23,18,21,22,10,7,3,7,86,SKS Starogard Gdański,Sezon 2022/2023
2023-01-18 17:00,PGE Turów Zgorzelec(w),100 : 106W,106,29,48,60.4,4,22,18.2,33,70,47.1,36,43,83.7,7,37,44,22,25,32,15,8,0,4,121,SKS Starogard Gdański,Sezon 2022/2023
2023-01-21 16:00,GKS Tychy(d),85 : 84W,85,20,36,55.6,8,31,25.8,28,67,41.8,21,26,80.8,10,23,33,16,22,25,13,7,3,1,87,SKS Starogard Gdański,Sezon 2022/2023
2023-01-28 20:00,MKKS Żak Koszalin(w),84 : 59P,59,15,38,39.5,6,20,30.0,21,58,36.2,11,17,64.7,2,19,21,9,18,20,9,3,2,7,42,SKS Starogard Gdański,Sezon 2022/2023
2023-02-04 18:00,Decka Pelplin(w),104 : 115W,115,23,36,63.9,13,28,46.4,36,64,56.3,30,45,66.7,7,30,37,26,27,33,13,4,2,2,128,SKS Starogard Gdański,Sezon 2022/2023
2023-02-08 19:00,Miasto Szkła Krosno(d),82 : 63W,82,15,28,53.6,12,28,42.9,27,56,48.2,16,23,69.6,6,31,37,20,12,25,10,4,3,3,100,SKS Starogard Gdański,Sezon 2022/2023
2023-02-12 18:00,WKS Śląsk II Wrocław(w),71 : 75W,75,22,47,46.8,7,20,35.0,29,67,43.3,10,21,47.6,6,27,33,22,17,22,13,5,2,5,75,SKS Starogard Gdański,Sezon 2022/2023
2023-02-18 17:00,Sensation Kotwica Kołobrzeg(d),71 : 78P,71,18,44,40.9,6,22,27.3,24,66,36.4,17,23,73.9,9,30,39,8,15,23,3,7,3,4,77,SKS Starogard Gdański,Sezon 2022/2023
2023-02-25 20:00,Dziki Warszawa(w),81 : 75P,75,19,37,51.4,8,26,30.8,27,63,42.9,13,18,72.2,7,29,36,16,30,23,20,6,6,2,78,SKS Starogard Gdański,Sezon 2022/2023
2023-03-01 20:00,HydroTruck Radom(d),82 : 76W,82,19,37,51.4,9,26,34.6,28,63,44.4,17,21,81.0,10,35,45,12,18,18,15,2,0,1,87,SKS Starogard Gdański,Sezon 2022/2023
2023-03-04 18:00,BS Polonia Bytom(w),86 : 80P,80,23,42,54.8,5,21,23.8,28,63,44.4,19,22,86.4,5,24,29,12,22,20,10,3,0,2,76,SKS Starogard Gdański,Sezon 2022/2023
2023-03-11 15:00,Enea Basket Poznań(d),100 : 82W,100,17,29,58.6,11,23,47.8,28,52,53.8,33,41,80.5,6,30,36,20,28,27,17,6,7,3,120,SKS Starogard Gdański,Sezon 2022/2023
2023-03-19 18:00,WKK Wrocław(d),68 : 79P,68,20,43,46.5,5,34,14.7,25,77,32.5,13,19,68.4,16,34,50,13,21,20,12,8,2,4,71,SKS Starogard Gdański,Sezon 2022/2023
2023-03-25 18:00,AZS AGH Kraków(d),88 : 83W,88,20,36,55.6,8,24,33.3,28,60,46.7,24,32,75.0,6,31,37,17,20,26,18,3,6,3,93,SKS Starogard Gdański,Sezon 2022/2023
2023-03-28 19:00,Start II Lublin(w),74 : 114W,114,32,45,71.1,11,30,36.7,43,75,57.3,17,21,81.0,14,34,48,37,17,18,14,12,4,1,165,SKS Starogard Gdański,Sezon 2022/2023
2023-04-05 18:00,Górnik Trans.eu Zamek Książ Wałbrzych(d),75 : 86P,75,20,37,54.1,4,23,17.4,24,60,40.0,23,29,79.3,4,23,27,18,16,24,10,5,3,6,76,SKS Starogard Gdański,Sezon 2022/2023
2023-04-15 20:00,GKS Tychy(w),73 : 94W,94,23,34,67.6,10,27,37.0,33,61,54.1,18,23,78.3,4,29,33,20,26,24,13,6,2,2,109,SKS Starogard Gdański,Sezon 2022/2023
2023-04-16 20:00,GKS Tychy(w),69 : 56P,56,7,23,30.4,11,28,39.3,18,51,35.3,9,15,60.0,2,25,27,11,28,19,25,6,5,3,41,SKS Starogard Gdański,Sezon 2022/2023
2023-04-22 18:00,GKS Tychy(d),108 : 76W,108,16,29,55.2,18,33,54.5,34,62,54.8,22,24,91.7,7,27,34,25,29,21,13,8,6,3,138,SKS Starogard Gdański,Sezon 2022/2023
2023-04-23 18:00,GKS Tychy(d),88 : 69W,88,10,19,52.6,13,31,41.9,23,50,46.0,29,34,85.3,4,30,34,14,24,26,20,3,1,1,88,SKS Starogard Gdański,Sezon 2022/2023
2023-04-29 19:00,Górnik Trans.eu Zamek Książ Wałbrzych(w),88 : 69P,69,16,36,44.4,7,26,26.9,23,62,37.1,16,26,61.5,5,30,35,16,21,19,15,1,2,6,59,SKS Starogard Gdański,Sezon 2022/2023
2023-04-30 19:00,Górnik Trans.eu Zamek Książ Wałbrzych(w),92 : 77P,77,7,25,28.0,14,30,46.7,21,55,38.2,21,23,91.3,2,23,25,14,21,22,13,2,0,2,69,SKS Starogard Gdański,Sezon 2022/2023
2023-05-06 17:00,Górnik Trans.eu Zamek Książ Wałbrzych(d),85 : 92P,85,17,35,48.6,9,29,31.0,26,64,40.6,24,27,88.9,6,26,32,16,20,24,8,6,2,5,92,SKS Starogard Gdański,Sezon 2022/2023
2023-05-13 17:00,HydroTruck Radom(d),110 : 79W,110,18,30,60.0,14,30,46.7,32,60,53.3,32,39,82.1,3,35,38,21,18,28,5,4,3,2,136,SKS Starogard Gdański,Sezon 2022/2023
2023-05-17 18:00,HydroTruck Radom(w),89 : 60P,60,13,29,44.8,6,28,21.4,19,57,33.3,16,30,53.3,6,23,29,8,23,25,13,5,3,1,40,SKS Starogard Gdański,Sezon 2022/2023
2022-09-25 18:30,Miasto Szkła Krosno(w),116 : 74P,74,16,37,43.2,11,34,32.4,27,71,38.0,9,12,75.0,12,15,27,12,14,14,17,6,3,3,58,Start II Lublin,Sezon 2022/2023
2022-10-02 19:00,WKS Śląsk II Wrocław(w),118 : 55P,55,14,32,43.8,5,30,16.7,19,62,30.6,12,18,66.7,11,14,25,6,20,19,25,7,6,5,25,Start II Lublin,Sezon 2022/2023
2022-10-07 19:00,Sensation Kotwica Kołobrzeg(w),113 : 51P,51,15,40,37.5,5,21,23.8,20,61,32.8,6,12,50.0,11,24,35,6,8,12,23,3,1,2,26,Start II Lublin,Sezon 2022/2023
2022-10-15 14:00,Dziki Warszawa(d),63 : 95P,63,15,36,41.7,8,23,34.8,23,59,39.0,9,14,64.3,6,22,28,11,16,14,20,6,1,5,48,Start II Lublin,Sezon 2022/2023
2022-10-22 18:00,HydroTruck Radom(w),100 : 89P,89,27,39,69.2,9,32,28.1,36,71,50.7,8,14,57.1,9,28,37,22,9,13,17,8,3,1,101,Start II Lublin,Sezon 2022/2023
2022-10-30 14:00,BS Polonia Bytom(d),55 : 115P,55,17,48,35.4,3,18,16.7,20,66,30.3,12,22,54.5,9,18,27,10,20,20,20,6,1,3,23,Start II Lublin,Sezon 2022/2023
2022-11-02 20:00,Enea Basket Poznań(w),109 : 51P,51,19,47,40.4,3,13,23.1,22,60,36.7,4,11,36.4,10,20,30,14,20,13,30,6,1,4,27,Start II Lublin,Sezon 2022/2023
2022-11-05 14:30,WKK Wrocław(d),96 : 79W,96,21,34,61.8,12,36,33.3,33,70,47.1,18,22,81.8,12,34,46,18,19,21,16,9,2,1,114,Start II Lublin,Sezon 2022/2023
2022-11-11 18:00,AZS AGH Kraków(w),78 : 74P,74,17,41,41.5,6,29,20.7,23,70,32.9,22,27,81.5,15,33,48,14,18,25,15,5,3,0,77,Start II Lublin,Sezon 2022/2023
2022-11-16 20:00,MKKS Żak Koszalin(w),114 : 72P,72,25,44,56.8,4,16,25.0,29,60,48.3,10,13,76.9,5,15,20,23,16,17,23,7,1,6,66,Start II Lublin,Sezon 2022/2023
2022-11-19 13:00,Górnik Trans.eu Zamek Książ Wałbrzych(d),62 : 114P,62,21,50,42.0,3,21,14.3,24,71,33.8,11,15,73.3,12,21,33,10,12,16,24,6,1,6,37,Start II Lublin,Sezon 2022/2023
2022-11-26 20:00,Weegree AZS Politechnika Opolska(w),128 : 73P,73,21,40,52.5,6,25,24.0,27,65,41.5,13,23,56.5,8,18,26,12,15,19,23,6,3,2,49,Start II Lublin,Sezon 2022/2023
2022-12-02 19:00,KKS Polonia Warszawa(d),70 : 96P,70,20,46,43.5,5,18,27.8,25,64,39.1,15,23,65.2,12,15,27,9,15,19,21,8,5,8,51,Start II Lublin,Sezon 2022/2023
2022-12-10 18:00,PGE Turów Zgorzelec(d),87 : 129P,87,27,43,62.8,6,25,24.0,33,68,48.5,15,23,65.2,8,19,27,16,13,21,18,7,2,1,78,Start II Lublin,Sezon 2022/2023
2022-12-15 18:00,GKS Tychy(d),51 : 76P,51,10,33,30.3,6,28,21.4,16,61,26.2,13,18,72.2,7,25,32,10,17,23,16,7,4,5,38,Start II Lublin,Sezon 2022/2023
2022-12-17 16:00,SKS Starogard Gdański(w),103 : 73P,73,21,52,40.4,9,20,45.0,30,72,41.7,4,8,50.0,9,23,32,13,9,11,16,9,2,5,67,Start II Lublin,Sezon 2022/2023
2023-01-04 16:00,Decka Pelplin(d),59 : 105P,59,15,34,44.1,5,19,26.3,20,53,37.7,14,20,70.0,7,17,24,9,10,17,30,4,1,7,28,Start II Lublin,Sezon 2022/2023
2023-01-07 15:00,Miasto Szkła Krosno(d),77 : 114P,77,21,46,45.7,8,16,50.0,29,62,46.8,11,15,73.3,9,17,26,23,18,16,17,6,4,2,82,Start II Lublin,Sezon 2022/2023
2023-01-15 20:00,WKS Śląsk II Wrocław(d),68 : 108P,68,15,34,44.1,7,21,33.3,22,55,40.0,17,23,73.9,9,17,26,11,20,19,22,6,4,1,54,Start II Lublin,Sezon 2022/2023
2023-01-18 16:00,Sensation Kotwica Kołobrzeg(d),77 : 103P,77,12,29,41.4,12,24,50.0,24,53,45.3,17,26,65.4,3,26,29,20,18,18,23,2,7,4,74,Start II Lublin,Sezon 2022/2023
2023-01-22 15:00,Dziki Warszawa(w),110 : 71P,71,23,45,51.1,6,19,31.6,29,64,45.3,7,8,87.5,6,23,29,11,17,14,28,9,1,5,57,Start II Lublin,Sezon 2022/2023
2023-01-29 16:00,HydroTruck Radom(d),62 : 95P,62,21,34,61.8,2,28,7.1,23,62,37.1,14,20,70.0,10,22,32,11,19,20,18,7,5,4,54,Start II Lublin,Sezon 2022/2023
2023-02-01 18:00,BS Polonia Bytom(w),80 : 74P,74,28,48,58.3,4,20,20.0,32,68,47.1,6,12,50.0,9,27,36,13,15,16,13,2,2,1,72,Start II Lublin,Sezon 2022/2023
2023-02-08 16:00,Enea Basket Poznań(d),72 : 107P,72,19,41,46.3,8,22,36.4,27,63,42.9,10,13,76.9,7,22,29,18,19,19,27,6,3,4,62,Start II Lublin,Sezon 2022/2023
2023-02-12 15:00,WKK Wrocław(w),104 : 74P,74,24,44,54.5,5,19,26.3,29,63,46.0,11,13,84.6,6,21,27,19,22,17,18,9,0,2,75,Start II Lublin,Sezon 2022/2023
2023-02-26 18:00,MKKS Żak Koszalin(d),74 : 116P,74,21,47,44.7,6,17,35.3,27,64,42.2,14,26,53.8,11,25,36,13,14,24,32,7,4,4,53,Start II Lublin,Sezon 2022/2023
2023-03-01 16:00,Górnik Trans.eu Zamek Książ Wałbrzych(w),104 : 67P,67,19,36,52.8,6,20,30.0,25,56,44.6,11,18,61.1,6,18,24,10,10,15,23,4,2,3,46,Start II Lublin,Sezon 2022/2023
2023-03-05 15:00,Weegree AZS Politechnika Opolska(d),73 : 101P,73,16,32,50.0,9,25,36.0,25,57,43.9,14,26,53.8,9,22,31,13,19,24,20,7,2,2,62,Start II Lublin,Sezon 2022/2023
2023-03-08 18:00,AZS AGH Kraków(d),64 : 106P,64,26,42,61.9,1,17,5.9,27,59,45.8,9,12,75.0,8,23,31,18,16,16,27,8,2,2,61,Start II Lublin,Sezon 2022/2023
2023-03-12 17:00,KKS Polonia Warszawa(w),100 : 64P,64,23,53,43.4,2,10,20.0,25,63,39.7,12,18,66.7,13,20,33,10,8,15,17,8,2,5,56,Start II Lublin,Sezon 2022/2023
2023-03-21 18:00,PGE Turów Zgorzelec(w),85 : 70P,70,14,34,41.2,6,25,24.0,20,59,33.9,24,30,80.0,7,21,28,10,13,19,17,8,2,2,56,Start II Lublin,Sezon 2022/2023
2023-03-25 15:00,GKS Tychy(w),110 : 63P,63,16,33,48.5,7,30,23.3,23,63,36.5,10,15,66.7,6,11,17,12,15,15,18,11,1,5,41,Start II Lublin,Sezon 2022/2023
2023-03-28 19:00,SKS Starogard Gdański(d),74 : 114P,74,18,43,41.9,11,29,37.9,29,72,40.3,5,12,41.7,9,19,28,17,18,17,16,12,1,4,66,Start II Lublin,Sezon 2022/2023
2023-04-05 18:00,Decka Pelplin(w),130 : 56P,56,13,34,38.2,6,19,31.6,19,53,35.8,12,22,54.5,4,14,18,9,19,21,27,9,0,7,21,Start II Lublin,Sezon 2022/2023
2022-09-24 18:00,SKS Starogard Gdański(w),79 : 61P,61,16,36,44.4,7,28,25.0,23,64,35.9,8,11,72.7,9,20,29,10,20,16,13,8,2,4,53,Weegree AZS Politechnika Opolska,Sezon 2022/2023
2022-10-02 18:00,Decka Pelplin(d),70 : 79P,70,14,33,42.4,6,25,24.0,20,58,34.5,24,30,80.0,7,30,37,13,28,25,20,4,4,2,64,Weegree AZS Politechnika Opolska,Sezon 2022/2023
2022-10-09 18:00,Miasto Szkła Krosno(w),82 : 79P,79,15,30,50.0,11,32,34.4,26,62,41.9,16,24,66.7,10,19,29,15,20,21,15,7,2,0,73,Weegree AZS Politechnika Opolska,Sezon 2022/2023
2022-10-16 18:00,WKS Śląsk II Wrocław(d),86 : 79W,86,24,35,68.6,5,19,26.3,29,54,53.7,23,26,88.5,3,26,29,19,19,22,19,9,7,0,103,Weegree AZS Politechnika Opolska,Sezon 2022/2023
2022-10-22 18:00,Sensation Kotwica Kołobrzeg(w),83 : 67P,67,20,33,60.6,3,23,13.0,23,56,41.1,18,31,58.1,8,26,34,11,16,24,13,9,0,3,62,Weegree AZS Politechnika Opolska,Sezon 2022/2023
2022-10-29 15:00,Dziki Warszawa(d),70 : 54W,70,13,27,48.1,9,22,40.9,22,49,44.9,17,22,77.3,8,24,32,19,31,21,18,9,3,5,83,Weegree AZS Politechnika Opolska,Sezon 2022/2023
2022-11-02 18:00,HydroTruck Radom(w),72 : 68P,68,23,41,56.1,5,25,20.0,28,66,42.4,7,12,58.3,11,29,40,15,21,18,13,6,5,3,78,Weegree AZS Politechnika Opolska,Sezon 2022/2023
2022-11-06 18:00,BS Polonia Bytom(d),87 : 79W,87,15,29,51.7,12,35,34.3,27,64,42.2,21,27,77.8,18,25,43,20,14,24,14,5,3,2,101,Weegree AZS Politechnika Opolska,Sezon 2022/2023
2022-11-12 20:00,Enea Basket Poznań(w),93 : 67P,67,15,30,50.0,8,27,29.6,23,57,40.4,13,25,52.0,10,21,31,16,24,22,10,4,0,2,62,Weegree AZS Politechnika Opolska,Sezon 2022/2023
2022-11-16 19:00,WKK Wrocław(d),70 : 59W,70,18,32,56.3,8,35,22.9,26,67,38.8,10,12,83.3,7,28,35,22,22,17,16,16,3,2,87,Weegree AZS Politechnika Opolska,Sezon 2022/2023
2022-11-20 18:00,AZS AGH Kraków(w),63 : 72W,72,17,35,48.6,6,20,30.0,23,55,41.8,20,24,83.3,10,30,40,12,26,24,23,6,1,3,72,Weegree AZS Politechnika Opolska,Sezon 2022/2023
2022-11-26 20:00,Start II Lublin(d),128 : 73W,128,30,41,73.2,18,47,38.3,48,88,54.5,14,16,87.5,17,32,49,40,19,15,12,13,2,3,178,Weegree AZS Politechnika Opolska,Sezon 2022/2023
2022-12-03 18:00,Górnik Trans.eu Zamek Książ Wałbrzych(w),86 : 77P,77,16,33,48.5,11,34,32.4,27,67,40.3,12,15,80.0,10,28,38,18,20,17,12,5,2,1,85,Weegree AZS Politechnika Opolska,Sezon 2022/2023
2022-12-10 15:00,MKKS Żak Koszalin(w),92 : 73P,73,18,39,46.2,7,25,28.0,25,64,39.1,16,22,72.7,9,20,29,16,19,18,14,8,2,2,69,Weegree AZS Politechnika Opolska,Sezon 2022/2023
2022-12-14 19:00,KKS Polonia Warszawa(d),84 : 82W,84,20,35,57.1,13,34,38.2,33,69,47.8,5,6,83.3,6,23,29,27,21,16,9,6,0,2,100,Weegree AZS Politechnika Opolska,Sezon 2022/2023
2022-12-18 18:00,PGE Turów Zgorzelec(w),88 : 92W,92,14,25,56.0,13,30,43.3,27,55,49.1,25,30,83.3,6,22,28,18,29,25,18,9,0,1,96,Weegree AZS Politechnika Opolska,Sezon 2022/2023
2022-12-30 18:00,GKS Tychy(d),88 : 73W,88,21,32,65.6,12,37,32.4,33,69,47.8,10,12,83.3,9,22,31,23,27,19,9,7,1,1,103,Weegree AZS Politechnika Opolska,Sezon 2022/2023
2023-01-07 18:00,SKS Starogard Gdański(d),97 : 92W,97,26,42,61.9,6,37,16.2,32,79,40.5,27,29,93.1,13,33,46,22,30,21,10,6,5,1,117,Weegree AZS Politechnika Opolska,Sezon 2022/2023
2023-01-14 20:00,Decka Pelplin(w),86 : 65P,65,15,32,46.9,5,26,19.2,20,58,34.5,20,34,58.8,12,29,41,10,16,28,20,10,4,4,58,Weegree AZS Politechnika Opolska,Sezon 2022/2023
2023-01-18 18:00,Miasto Szkła Krosno(d),80 : 77W,80,22,41,53.7,8,25,32.0,30,66,45.5,12,14,85.7,8,27,35,25,21,22,17,12,3,1,100,Weegree AZS Politechnika Opolska,Sezon 2022/2023
2023-01-22 18:00,WKS Śląsk II Wrocław(w),55 : 70W,70,18,45,40.0,8,26,30.8,26,71,36.6,10,12,83.3,17,28,45,17,24,16,15,10,5,3,85,Weegree AZS Politechnika Opolska,Sezon 2022/2023
2023-01-28 18:00,Sensation Kotwica Kołobrzeg(d),85 : 69W,85,15,27,55.6,10,30,33.3,25,57,43.9,25,30,83.3,6,25,31,20,23,22,11,7,3,4,98,Weegree AZS Politechnika Opolska,Sezon 2022/2023
2023-02-04 20:00,Dziki Warszawa(w),97 : 50P,50,13,31,41.9,6,23,26.1,19,54,35.2,6,12,50.0,8,13,21,15,21,20,26,6,2,3,27,Weegree AZS Politechnika Opolska,Sezon 2022/2023
2023-02-08 17:00,HydroTruck Radom(d),84 : 82W,84,16,36,44.4,14,31,45.2,30,67,44.8,10,13,76.9,9,22,31,28,22,19,11,13,1,1,106,Weegree AZS Politechnika Opolska,Sezon 2022/2023
2023-02-11 18:00,BS Polonia Bytom(w),89 : 84P,84,18,38,47.4,12,28,42.9,30,66,45.5,12,16,75.0,6,27,33,18,25,20,13,4,0,1,86,Weegree AZS Politechnika Opolska,Sezon 2022/2023
2023-02-19 16:00,Enea Basket Poznań(d),96 : 86W,96,24,37,64.9,11,25,44.0,35,62,56.5,15,20,75.0,10,26,36,30,28,21,19,11,3,0,125,Weegree AZS Politechnika Opolska,Sezon 2022/2023
2023-02-25 18:00,WKK Wrocław(w),83 : 82P,82,17,36,47.2,11,33,33.3,28,69,40.6,15,20,75.0,6,19,25,20,24,22,14,12,3,2,82,Weegree AZS Politechnika Opolska,Sezon 2022/2023
2023-03-01 17:00,AZS AGH Kraków(d),90 : 84W,90,25,40,62.5,7,23,30.4,32,63,50.8,19,23,82.6,9,26,35,23,23,22,16,9,2,0,108,Weegree AZS Politechnika Opolska,Sezon 2022/2023
2023-03-05 15:00,Start II Lublin(w),73 : 101W,101,27,41,65.9,12,33,36.4,39,74,52.7,11,14,78.6,10,26,36,31,24,19,10,9,2,2,131,Weegree AZS Politechnika Opolska,Sezon 2022/2023
2023-03-11 18:00,Górnik Trans.eu Zamek Książ Wałbrzych(d),79 : 80P,79,17,32,53.1,12,31,38.7,29,63,46.0,9,11,81.8,5,24,29,23,24,16,16,9,3,1,91,Weegree AZS Politechnika Opolska,Sezon 2022/2023
2023-03-18 15:00,MKKS Żak Koszalin(d),98 : 106P,98,27,39,69.2,7,22,31.8,34,61,55.7,23,29,79.3,2,31,33,30,28,23,18,7,4,3,121,Weegree AZS Politechnika Opolska,Sezon 2022/2023
2023-03-26 19:00,KKS Polonia Warszawa(w),94 : 69P,69,14,38,36.8,9,27,33.3,23,65,35.4,14,15,93.3,11,23,34,18,19,18,18,4,2,3,66,Weegree AZS Politechnika Opolska,Sezon 2022/2023
2023-04-02 15:00,PGE Turów Zgorzelec(d),112 : 88W,112,27,40,67.5,17,30,56.7,44,70,62.9,7,10,70.0,5,26,31,36,21,11,10,7,3,0,150,Weegree AZS Politechnika Opolska,Sezon 2022/2023
2023-04-05 18:00,GKS Tychy(w),85 : 82P,82,21,33,63.6,7,35,20.0,28,68,41.2,19,28,67.9,14,16,30,13,31,28,15,8,0,3,69,Weegree AZS Politechnika Opolska,Sezon 2022/2023
2022-09-24 18:00,Sensation Kotwica Kołobrzeg(w),64 : 66W,66,13,32,40.6,7,24,29.2,20,56,35.7,19,32,59.4,4,32,36,11,14,22,13,5,0,4,56,WKK Wrocław,Sezon 2022/2023
2022-10-01 20:00,Dziki Warszawa(d),73 : 75P,73,11,30,36.7,8,25,32.0,19,55,34.5,27,31,87.1,13,28,41,23,23,24,19,4,1,3,83,WKK Wrocław,Sezon 2022/2023
2022-10-08 15:00,HydroTruck Radom(w),80 : 70P,70,15,41,36.6,9,31,29.0,24,72,33.3,13,17,76.5,13,24,37,16,18,20,17,11,1,2,66,WKK Wrocław,Sezon 2022/2023
2022-10-16 18:00,BS Polonia Bytom(d),96 : 62W,96,25,46,54.3,11,20,55.0,36,66,54.5,13,17,76.5,4,27,31,30,18,18,11,12,5,1,129,WKK Wrocław,Sezon 2022/2023
2022-10-22 20:00,Enea Basket Poznań(w),80 : 62P,62,16,38,42.1,6,28,21.4,22,66,33.3,12,19,63.2,12,25,37,14,17,20,19,4,1,2,48,WKK Wrocław,Sezon 2022/2023
2022-10-29 18:00,MKKS Żak Koszalin(w),89 : 81P,81,23,42,54.8,5,28,17.9,28,70,40.0,20,24,83.3,11,27,38,16,21,23,9,4,0,3,84,WKK Wrocław,Sezon 2022/2023
2022-11-02 17:00,AZS AGH Kraków(d),89 : 69W,89,21,38,55.3,8,21,38.1,29,59,49.2,23,33,69.7,11,31,42,25,19,23,12,7,3,3,114,WKK Wrocław,Sezon 2022/2023
2022-11-05 14:30,Start II Lublin(w),96 : 79P,79,24,40,60.0,7,36,19.4,31,76,40.8,10,14,71.4,11,24,35,21,21,19,12,9,1,2,84,WKK Wrocław,Sezon 2022/2023
2022-11-13 18:00,Górnik Trans.eu Zamek Książ Wałbrzych(w),76 : 74P,74,11,29,37.9,8,32,25.0,19,61,31.1,28,34,82.4,4,25,29,13,18,27,15,9,1,4,63,WKK Wrocław,Sezon 2022/2023
2022-11-16 19:00,Weegree AZS Politechnika Opolska(w),70 : 59P,59,15,31,48.4,6,19,31.6,21,50,42.0,11,21,52.4,4,26,30,14,17,22,22,7,2,3,51,WKK Wrocław,Sezon 2022/2023
2022-11-20 18:00,KKS Polonia Warszawa(d),76 : 66W,76,21,40,52.5,5,17,29.4,26,57,45.6,19,29,65.5,4,29,33,20,18,25,9,9,2,2,90,WKK Wrocław,Sezon 2022/2023
2022-11-26 18:00,PGE Turów Zgorzelec(d),72 : 55W,72,19,41,46.3,6,19,31.6,25,60,41.7,16,27,59.3,10,36,46,22,18,20,17,5,4,4,86,WKK Wrocław,Sezon 2022/2023
2022-12-03 15:00,GKS Tychy(d),65 : 77P,65,16,37,43.2,7,21,33.3,23,58,39.7,12,17,70.6,5,24,29,15,15,19,17,10,2,1,64,WKK Wrocław,Sezon 2022/2023
2022-12-11 15:00,SKS Starogard Gdański(d),87 : 66W,87,26,49,53.1,7,22,31.8,33,71,46.5,14,21,66.7,8,25,33,23,21,19,8,14,2,5,106,WKK Wrocław,Sezon 2022/2023
2022-12-14 17:00,Decka Pelplin(d),69 : 82P,69,18,39,46.2,6,24,25.0,24,63,38.1,15,27,55.6,3,27,30,19,20,25,12,9,1,1,65,WKK Wrocław,Sezon 2022/2023
2022-12-17 20:00,Miasto Szkła Krosno(w),83 : 61P,61,14,36,38.9,7,24,29.2,21,60,35.0,12,20,60.0,9,21,30,16,17,17,15,3,1,3,49,WKK Wrocław,Sezon 2022/2023
2023-01-04 20:00,WKS Śląsk II Wrocław(d),80 : 71W,80,15,38,39.5,11,24,45.8,26,62,41.9,17,27,63.0,7,22,29,20,19,21,13,8,1,6,79,WKK Wrocław,Sezon 2022/2023
2023-01-11 18:00,Sensation Kotwica Kołobrzeg(d),71 : 75P,71,12,32,37.5,8,24,33.3,20,56,35.7,23,30,76.7,6,34,40,18,15,23,16,5,3,2,78,WKK Wrocław,Sezon 2022/2023
2023-01-14 18:00,Dziki Warszawa(w),95 : 100W,100,18,31,58.1,13,30,43.3,31,61,50.8,25,34,73.5,8,24,32,18,25,27,17,4,3,1,101,WKK Wrocław,Sezon 2022/2023
2023-01-18 17:00,HydroTruck Radom(d),86 : 69W,86,18,35,51.4,13,29,44.8,31,64,48.4,11,14,78.6,6,28,34,28,16,20,8,5,2,0,111,WKK Wrocław,Sezon 2022/2023
2023-01-21 15:00,BS Polonia Bytom(w),76 : 74P,74,18,36,50.0,7,25,28.0,25,61,41.0,17,26,65.4,5,28,33,14,18,23,12,9,2,4,75,WKK Wrocław,Sezon 2022/2023
2023-01-29 18:00,Enea Basket Poznań(d),72 : 85P,72,14,22,63.6,10,30,33.3,24,52,46.2,14,21,66.7,5,23,28,24,11,21,20,8,1,0,78,WKK Wrocław,Sezon 2022/2023
2023-02-04 18:00,MKKS Żak Koszalin(d),75 : 85P,75,16,30,53.3,8,25,32.0,24,55,43.6,19,29,65.5,5,24,29,21,20,24,11,6,1,2,80,WKK Wrocław,Sezon 2022/2023
2023-02-08 20:00,AZS AGH Kraków(w),81 : 76P,76,15,39,38.5,11,23,47.8,26,62,41.9,13,20,65.0,14,17,31,23,21,19,14,8,3,4,84,WKK Wrocław,Sezon 2022/2023
2023-02-12 15:00,Start II Lublin(d),104 : 74W,104,22,30,73.3,14,37,37.8,36,67,53.7,18,25,72.0,11,24,35,39,17,22,13,13,2,0,142,WKK Wrocław,Sezon 2022/2023
2023-02-16 17:00,Górnik Trans.eu Zamek Książ Wałbrzych(d),74 : 96P,74,15,30,50.0,10,27,37.0,25,57,43.9,14,17,82.4,7,22,29,17,22,24,15,4,0,3,74,WKK Wrocław,Sezon 2022/2023
2023-02-25 18:00,Weegree AZS Politechnika Opolska(d),83 : 82W,83,16,30,53.3,9,25,36.0,25,55,45.5,24,25,96.0,7,23,30,22,22,24,21,6,2,3,91,WKK Wrocław,Sezon 2022/2023
2023-03-11 20:00,GKS Tychy(w),89 : 91W,91,16,31,51.6,12,33,36.4,28,64,43.8,23,27,85.2,3,19,22,19,18,31,12,10,3,1,93,WKK Wrocław,Sezon 2022/2023
2023-03-16 18:00,PGE Turów Zgorzelec(w),79 : 101W,101,23,39,59.0,11,28,39.3,34,67,50.7,22,31,71.0,10,33,43,26,19,24,15,8,1,2,122,WKK Wrocław,Sezon 2022/2023
2023-03-19 18:00,SKS Starogard Gdański(w),68 : 79W,79,16,36,44.4,10,28,35.7,26,64,40.6,17,23,73.9,3,33,36,18,21,20,12,5,4,2,86,WKK Wrocław,Sezon 2022/2023
2023-03-22 19:00,KKS Polonia Warszawa(w),98 : 92P,92,22,39,56.4,6,23,26.1,28,62,45.2,30,38,78.9,6,23,29,20,22,31,11,7,1,5,96,WKK Wrocław,Sezon 2022/2023
2023-03-26 15:00,Decka Pelplin(w),77 : 72P,72,19,35,54.3,6,28,21.4,25,63,39.7,16,23,69.6,5,21,26,16,19,20,10,9,3,3,71,WKK Wrocław,Sezon 2022/2023
2023-04-01 13:00,Miasto Szkła Krosno(d),78 : 77W,78,23,36,63.9,5,20,25.0,28,56,50.0,17,25,68.0,7,26,33,26,20,25,14,2,2,2,91,WKK Wrocław,Sezon 2022/2023
2023-04-05 18:00,WKS Śląsk II Wrocław(w),74 : 89W,89,22,44,50.0,8,22,36.4,30,66,45.5,21,27,77.8,6,35,41,20,23,25,11,5,7,4,109,WKK Wrocław,Sezon 2022/2023
2022-09-25 18:00,AZS AGH Kraków(d),72 : 52W,72,20,36,55.6,3,13,23.1,23,49,46.9,23,31,74.2,7,33,40,13,21,23,16,3,2,0,80,WKS Śląsk II Wrocław,Sezon 2022/2023
2022-10-02 19:00,Start II Lublin(d),118 : 55W,118,41,56,73.2,7,21,33.3,48,77,62.3,15,22,68.2,16,31,47,30,19,20,9,20,5,6,175,WKS Śląsk II Wrocław,Sezon 2022/2023
2022-10-09 18:00,Górnik Trans.eu Zamek Książ Wałbrzych(d),75 : 58W,75,18,33,54.5,8,30,26.7,26,63,41.3,15,17,88.2,10,29,39,18,19,19,9,6,6,6,96,WKS Śląsk II Wrocław,Sezon 2022/2023
2022-10-16 18:00,Weegree AZS Politechnika Opolska(w),86 : 79P,79,22,44,50.0,8,20,40.0,30,64,46.9,11,17,64.7,6,20,26,17,22,19,15,10,0,7,77,WKS Śląsk II Wrocław,Sezon 2022/2023
2022-10-23 18:00,KKS Polonia Warszawa(d),67 : 64W,67,19,40,47.5,5,19,26.3,24,59,40.7,14,20,70.0,7,20,27,10,12,20,11,12,3,6,67,WKS Śląsk II Wrocław,Sezon 2022/2023
2022-10-30 15:00,PGE Turów Zgorzelec(w),74 : 90W,90,22,40,55.0,10,17,58.8,32,57,56.1,16,20,80.0,11,27,38,28,19,20,16,5,2,2,118,WKS Śląsk II Wrocław,Sezon 2022/2023
2022-11-02 20:00,GKS Tychy(d),56 : 64P,56,13,24,54.2,8,29,27.6,21,53,39.6,6,13,46.2,10,30,40,13,23,17,19,3,2,0,56,WKS Śląsk II Wrocław,Sezon 2022/2023
2022-11-06 15:00,SKS Starogard Gdański(w),84 : 74P,74,18,40,45.0,7,29,24.1,25,69,36.2,17,23,73.9,10,22,32,11,24,20,14,7,4,2,64,WKS Śląsk II Wrocław,Sezon 2022/2023
2022-11-10 18:00,Decka Pelplin(d),68 : 72P,68,16,36,44.4,7,27,25.9,23,63,36.5,15,19,78.9,9,25,34,14,23,20,12,4,5,2,69,WKS Śląsk II Wrocław,Sezon 2022/2023
2022-11-16 17:00,Miasto Szkła Krosno(w),91 : 65P,65,17,34,50.0,9,26,34.6,26,60,43.3,4,14,28.6,10,16,26,14,22,16,14,6,1,1,54,WKS Śląsk II Wrocław,Sezon 2022/2023
2022-11-19 20:00,MKKS Żak Koszalin(d),88 : 68W,88,17,35,48.6,14,30,46.7,31,65,47.7,12,18,66.7,11,23,34,20,20,18,14,13,2,4,103,WKS Śląsk II Wrocław,Sezon 2022/2023
2022-11-27 18:00,Sensation Kotwica Kołobrzeg(d),69 : 85P,69,16,30,53.3,9,27,33.3,25,57,43.9,10,16,62.5,6,22,28,17,20,16,17,5,2,1,66,WKS Śląsk II Wrocław,Sezon 2022/2023
2022-12-03 18:00,Dziki Warszawa(w),73 : 63P,63,13,24,54.2,9,29,31.0,22,53,41.5,10,17,58.8,7,18,25,14,15,17,12,6,5,0,63,WKS Śląsk II Wrocław,Sezon 2022/2023
2022-12-10 15:00,HydroTruck Radom(d),61 : 91P,61,13,30,43.3,7,28,25.0,20,58,34.5,14,19,73.7,4,22,26,12,12,21,15,6,4,2,51,WKS Śląsk II Wrocław,Sezon 2022/2023
2022-12-14 18:00,BS Polonia Bytom(w),61 : 78W,78,21,51,41.2,6,23,26.1,27,74,36.5,18,27,66.7,22,29,51,9,18,24,13,5,1,3,75,WKS Śląsk II Wrocław,Sezon 2022/2023
2022-12-18 20:00,Enea Basket Poznań(d),74 : 58W,74,24,43,55.8,5,18,27.8,29,61,47.5,11,15,73.3,8,25,33,16,20,19,15,6,8,2,86,WKS Śląsk II Wrocław,Sezon 2022/2023
2023-01-04 20:00,WKK Wrocław(w),80 : 71P,71,18,35,51.4,6,20,30.0,24,55,43.6,17,23,73.9,4,25,29,17,21,19,14,5,6,1,77,WKS Śląsk II Wrocław,Sezon 2022/2023
2023-01-07 20:00,AZS AGH Kraków(w),63 : 59P,59,19,47,40.4,4,14,28.6,23,61,37.7,9,20,45.0,15,26,41,14,22,21,21,13,1,4,58,WKS Śląsk II Wrocław,Sezon 2022/2023
2023-01-15 20:00,Start II Lublin(w),68 : 108W,108,37,64,57.8,7,23,30.4,44,87,50.6,13,21,61.9,25,25,50,27,19,20,10,11,1,4,136,WKS Śląsk II Wrocław,Sezon 2022/2023
2023-01-18 19:00,Górnik Trans.eu Zamek Książ Wałbrzych(w),77 : 75P,75,20,38,52.6,7,20,35.0,27,58,46.6,14,24,58.3,6,22,28,17,25,23,14,7,2,6,74,WKS Śląsk II Wrocław,Sezon 2022/2023
2023-01-22 18:00,Weegree AZS Politechnika Opolska(d),55 : 70P,55,12,38,31.6,4,17,23.5,16,55,29.1,19,27,70.4,10,20,30,10,16,24,17,6,3,5,40,WKS Śląsk II Wrocław,Sezon 2022/2023
2023-01-29 19:00,KKS Polonia Warszawa(w),68 : 57P,57,15,42,35.7,5,20,25.0,20,62,32.3,12,27,44.4,8,29,37,9,17,26,13,9,2,5,44,WKS Śląsk II Wrocław,Sezon 2022/2023
2023-02-01 18:30,PGE Turów Zgorzelec(d),67 : 75P,67,18,37,48.6,7,20,35.0,25,57,43.9,10,14,71.4,8,29,37,16,18,17,18,2,2,2,70,WKS Śląsk II Wrocław,Sezon 2022/2023
2023-02-08 19:00,GKS Tychy(w),72 : 80W,80,22,36,61.1,4,17,23.5,26,53,49.1,24,29,82.8,6,26,32,15,25,26,12,5,3,2,91,WKS Śląsk II Wrocław,Sezon 2022/2023
2023-02-12 18:00,SKS Starogard Gdański(d),71 : 75P,71,23,48,47.9,4,21,19.0,27,69,39.1,13,18,72.2,11,36,47,13,22,17,14,7,5,2,82,WKS Śląsk II Wrocław,Sezon 2022/2023
2023-02-22 18:30,Decka Pelplin(w),70 : 64P,64,12,29,41.4,9,27,33.3,21,56,37.5,13,18,72.2,6,24,30,12,25,18,18,8,3,2,59,WKS Śląsk II Wrocław,Sezon 2022/2023
2023-03-12 15:00,Dziki Warszawa(d),73 : 75P,73,17,31,54.8,9,23,39.1,26,54,48.1,12,23,52.2,5,22,27,17,25,21,14,8,6,1,78,WKS Śląsk II Wrocław,Sezon 2022/2023
2023-03-19 15:00,HydroTruck Radom(w),113 : 56P,56,15,39,38.5,3,29,10.3,18,68,26.5,17,22,77.3,13,24,37,15,20,17,16,2,4,5,43,WKS Śląsk II Wrocław,Sezon 2022/2023
2023-03-22 18:00,Sensation Kotwica Kołobrzeg(w),71 : 69P,69,18,34,52.9,8,27,29.6,26,61,42.6,9,20,45.0,11,26,37,15,18,17,20,9,2,2,66,WKS Śląsk II Wrocław,Sezon 2022/2023
2023-03-23 18:00,MKKS Żak Koszalin(w),76 : 88W,88,29,52,55.8,3,17,17.6,32,69,46.4,21,26,80.8,10,35,45,17,22,21,14,7,2,4,103,WKS Śląsk II Wrocław,Sezon 2022/2023
2023-03-26 15:00,BS Polonia Bytom(d),95 : 84W,95,26,50,52.0,7,20,35.0,33,70,47.1,22,32,68.8,15,22,37,23,23,21,15,10,3,3,106,WKS Śląsk II Wrocław,Sezon 2022/2023
2023-03-30 18:00,Miasto Szkła Krosno(d),58 : 67P,58,21,45,46.7,2,20,10.0,23,65,35.4,10,16,62.5,14,24,38,12,25,15,16,2,3,5,49,WKS Śląsk II Wrocław,Sezon 2022/2023
2023-04-02 15:00,Enea Basket Poznań(w),78 : 75P,75,21,43,48.8,4,19,21.1,25,62,40.3,21,35,60.0,12,29,41,15,26,30,15,6,5,2,76,WKS Śląsk II Wrocław,Sezon 2022/2023
2023-04-05 18:00,WKK Wrocław(d),74 : 89P,74,21,54,38.9,4,23,17.4,25,77,32.5,20,32,62.5,16,29,45,15,25,23,10,4,4,7,68,WKS Śląsk II Wrocław,Sezon 2022/2023
2021-09-24 17:00,KS Księżak Łowicz(d),88 : 80W,88,24,49,49.0,10,28,35.7,34,77,44.2,10,16,62.5,14,24,38,21,19,17,9,10,3,2,102, AZS UMCS Start II Lublin,Sezon 2021/2022
2021-10-01 19:00,SKS Starogard Gdański(w),98 : 94P,94,24,39,61.5,9,23,39.1,33,62,53.2,19,25,76.0,9,19,28,19,18,19,15,10,1,3,102, AZS UMCS Start II Lublin,Sezon 2021/2022
2021-10-10 18:30,Znicz Basket Pruszków(d),103 : 64W,103,22,32,68.8,14,30,46.7,36,62,58.1,17,22,77.3,9,38,47,28,25,22,17,10,5,2,145, AZS UMCS Start II Lublin,Sezon 2021/2022
2021-10-17 19:00,TBS Śląsk II Wrocław(w),88 : 92W,92,22,47,46.8,8,23,34.8,30,70,42.9,24,27,88.9,11,29,40,15,23,24,15,8,3,1,100, AZS UMCS Start II Lublin,Sezon 2021/2022
2021-10-20 18:00,Rawlplug Sokół Łańcut(w),83 : 69P,69,19,36,52.8,5,23,21.7,24,59,40.7,16,19,84.2,3,29,32,16,19,18,17,12,1,3,75, AZS UMCS Start II Lublin,Sezon 2021/2022
2021-10-23 19:00,GKS Tychy(w),93 : 62P,62,15,33,45.5,6,25,24.0,21,58,36.2,14,16,87.5,6,21,27,13,14,21,17,5,3,2,54, AZS UMCS Start II Lublin,Sezon 2021/2022
2021-11-06 18:00,Górnik Trans.eu Wałbrzych(w),81 : 66P,66,22,42,52.4,2,26,7.7,24,68,35.3,16,22,72.7,8,28,36,14,10,21,6,11,3,2,74, AZS UMCS Start II Lublin,Sezon 2021/2022
2021-11-14 18:00,Sensation Kotwica Kołobrzeg(d),74 : 70W,74,18,35,51.4,8,25,32.0,26,60,43.3,14,21,66.7,9,33,42,14,18,24,13,1,5,1,82, AZS UMCS Start II Lublin,Sezon 2021/2022
2021-11-17 18:00,AZS AGH Kraków(w),95 : 68P,68,22,41,53.7,5,21,23.8,27,62,43.5,9,24,37.5,7,15,22,15,15,25,10,9,2,2,56, AZS UMCS Start II Lublin,Sezon 2021/2022
2021-11-20 15:00,MKKS Żak Koszalin(d),95 : 84W,95,15,42,35.7,15,27,55.6,30,69,43.5,20,25,80.0,9,19,28,19,20,25,7,8,2,5,101, AZS UMCS Start II Lublin,Sezon 2021/2022
2021-11-27 18:00,PGE Turów Zgorzelec(w),80 : 75P,75,26,52,50.0,4,20,20.0,30,72,41.7,11,18,61.1,8,28,36,17,28,20,8,9,2,4,82, AZS UMCS Start II Lublin,Sezon 2021/2022
2021-12-01 19:00,Decka Pelplin(d),92 : 70W,92,24,44,54.5,8,20,40.0,32,64,50.0,20,26,76.9,5,33,38,24,16,22,11,7,0,3,112, AZS UMCS Start II Lublin,Sezon 2021/2022
2021-12-11 17:00,Miasto Szkła Krosno(w),92 : 81P,81,21,42,50.0,7,22,31.8,28,64,43.8,18,25,72.0,11,21,32,11,20,18,13,7,0,4,75, AZS UMCS Start II Lublin,Sezon 2021/2022
2021-12-15 14:00,WKK Wrocław(d),83 : 67W,83,17,36,47.2,12,29,41.4,29,65,44.6,13,16,81.3,8,33,41,19,20,14,16,9,2,3,99, AZS UMCS Start II Lublin,Sezon 2021/2022
2021-12-19 16:00,Weegree AZS Politechnika Opolska(d),91 : 89W,91,21,42,50.0,10,23,43.5,31,65,47.7,19,25,76.0,11,25,36,22,23,25,15,6,4,1,104, AZS UMCS Start II Lublin,Sezon 2021/2022
2022-01-02 18:00,Dziki Warszawa(w),71 : 66P,66,17,46,37.0,7,25,28.0,24,71,33.8,11,15,73.3,10,29,39,15,20,18,9,6,4,4,70, AZS UMCS Start II Lublin,Sezon 2021/2022
2022-01-08 16:00,KS Księżak Łowicz(w),82 : 87W,87,21,43,48.8,10,22,45.5,31,65,47.7,15,20,75.0,5,22,27,17,17,22,9,7,2,1,92, AZS UMCS Start II Lublin,Sezon 2021/2022
2022-01-15 19:00,SKS Starogard Gdański(d),95 : 88W,95,19,34,55.9,13,28,46.4,32,62,51.6,18,20,90.0,5,23,28,21,19,18,14,7,2,2,107, AZS UMCS Start II Lublin,Sezon 2021/2022
2022-01-22 18:00,Znicz Basket Pruszków(w),74 : 61P,61,17,34,50.0,4,17,23.5,21,51,41.2,15,21,71.4,4,28,32,19,23,21,19,9,4,1,70, AZS UMCS Start II Lublin,Sezon 2021/2022
2022-01-29 18:00,TBS Śląsk II Wrocław(d),71 : 91P,71,25,50,50.0,2,20,10.0,27,70,38.6,15,25,60.0,10,29,39,18,19,20,8,4,2,2,73, AZS UMCS Start II Lublin,Sezon 2021/2022
2022-02-02 19:00,Rawlplug Sokół Łańcut(d),90 : 75W,90,22,55,40.0,10,19,52.6,32,74,43.2,16,22,72.7,14,33,47,20,16,17,12,7,3,3,107, AZS UMCS Start II Lublin,Sezon 2021/2022
2022-02-05 17:00,GKS Tychy(d),74 : 69W,74,18,33,54.5,7,23,30.4,25,56,44.6,17,27,63.0,9,28,37,18,17,21,9,4,3,0,86, AZS UMCS Start II Lublin,Sezon 2021/2022
2022-02-20 15:00,Górnik Trans.eu Wałbrzych(d),81 : 91P,81,19,44,43.2,9,28,32.1,28,72,38.9,16,25,64.0,8,23,31,14,13,20,11,7,0,5,69, AZS UMCS Start II Lublin,Sezon 2021/2022
2022-02-26 18:00,Sensation Kotwica Kołobrzeg(w),81 : 65P,65,15,39,38.5,7,24,29.2,22,63,34.9,14,23,60.9,4,23,27,18,19,21,12,4,1,6,53, AZS UMCS Start II Lublin,Sezon 2021/2022
2022-03-05 17:00,MKKS Żak Koszalin(w),68 : 81W,81,19,39,48.7,6,16,37.5,25,55,45.5,25,30,83.3,5,23,28,20,21,22,10,10,1,4,95, AZS UMCS Start II Lublin,Sezon 2021/2022
2022-03-13 14:00,PGE Turów Zgorzelec(d),99 : 82W,99,25,37,67.6,9,26,34.6,34,63,54.0,22,29,75.9,7,25,32,22,17,21,9,8,2,0,118, AZS UMCS Start II Lublin,Sezon 2021/2022
2022-03-19 17:00,Decka Pelplin(w),72 : 76W,76,20,40,50.0,8,28,28.6,28,68,41.2,12,18,66.7,7,28,35,23,19,20,9,7,0,1,86, AZS UMCS Start II Lublin,Sezon 2021/2022
2022-03-22 19:00,AZS AGH Kraków(d),73 : 103P,73,22,47,46.8,4,16,25.0,26,63,41.3,17,24,70.8,7,18,25,14,21,25,15,6,2,3,61, AZS UMCS Start II Lublin,Sezon 2021/2022
2022-03-26 14:00,Miasto Szkła Krosno(d),72 : 110P,72,17,41,41.5,5,28,17.9,22,69,31.9,23,28,82.1,9,15,24,11,19,21,8,9,0,7,56, AZS UMCS Start II Lublin,Sezon 2021/2022
2022-03-30 18:00,WKK Wrocław(w),93 : 84P,84,23,46,50.0,8,20,40.0,31,66,47.0,14,15,93.3,5,28,33,17,23,20,14,11,0,1,95, AZS UMCS Start II Lublin,Sezon 2021/2022
2022-04-02 18:00,Weegree AZS Politechnika Opolska(w),79 : 82W,82,25,47,53.2,7,27,25.9,32,74,43.2,11,15,73.3,14,32,46,13,20,18,10,7,3,1,95, AZS UMCS Start II Lublin,Sezon 2021/2022
2022-04-10 18:00,Dziki Warszawa(d),72 : 84P,72,15,37,40.5,9,21,42.9,24,58,41.4,15,22,68.2,9,23,32,12,19,18,18,10,2,2,69, AZS UMCS Start II Lublin,Sezon 2021/2022
2021-09-25 18:00,GKS Tychy(d),59 : 84P,59,14,38,36.8,5,32,15.6,19,70,27.1,16,22,72.7,16,23,39,19,23,21,15,6,3,2,54,AZS AGH Kraków,Sezon 2021/2022
2021-10-08 19:00,Górnik Trans.eu Wałbrzych(d),61 : 94P,61,17,30,56.7,4,28,14.3,21,58,36.2,15,23,65.2,12,22,34,14,27,23,23,8,2,0,51,AZS AGH Kraków,Sezon 2021/2022
2021-10-16 18:00,Sensation Kotwica Kołobrzeg(w),92 : 73P,73,18,38,47.4,5,19,26.3,23,57,40.4,22,38,57.9,10,17,27,10,24,28,17,16,0,2,59,AZS AGH Kraków,Sezon 2021/2022
2021-10-20 18:30,WKK Wrocław(d),53 : 83P,53,16,41,39.0,4,27,14.8,20,68,29.4,9,15,60.0,14,26,40,12,28,19,20,12,0,3,43,AZS AGH Kraków,Sezon 2021/2022
2021-10-23 18:00,MKKS Żak Koszalin(d),66 : 50W,66,15,29,51.7,7,31,22.6,22,60,36.7,15,17,88.2,11,25,36,14,20,13,17,15,0,0,74,AZS AGH Kraków,Sezon 2021/2022
2021-10-30 18:00,PGE Turów Zgorzelec(w),67 : 85W,85,22,32,68.8,11,36,30.6,33,68,48.5,8,14,57.1,11,27,38,24,29,19,20,6,2,1,94,AZS AGH Kraków,Sezon 2021/2022
2021-11-06 18:00,Decka Pelplin(d),75 : 58W,75,23,38,60.5,6,27,22.2,29,65,44.6,11,15,73.3,9,18,27,19,26,18,10,11,1,5,83,AZS AGH Kraków,Sezon 2021/2022
2021-11-13 17:00,Miasto Szkła Krosno(w),74 : 78W,78,17,32,53.1,9,24,37.5,26,56,46.4,17,30,56.7,8,20,28,12,24,28,16,7,0,2,66,AZS AGH Kraków,Sezon 2021/2022
2021-11-17 18:00,AZS UMCS Start II Lublin(d),95 : 68W,95,25,41,61.0,13,31,41.9,38,72,52.8,6,9,66.7,16,28,44,29,25,14,13,6,2,2,126,AZS AGH Kraków,Sezon 2021/2022
2021-11-21 17:30,Weegree AZS Politechnika Opolska(w),88 : 72P,72,16,41,39.0,10,27,37.0,26,68,38.2,10,13,76.9,8,13,21,22,25,18,13,10,1,6,68,AZS AGH Kraków,Sezon 2021/2022
2021-11-27 20:00,Dziki Warszawa(d),75 : 58W,75,19,34,55.9,10,30,33.3,29,64,45.3,7,17,41.2,14,23,37,21,21,20,13,9,0,3,84,AZS AGH Kraków,Sezon 2021/2022
2021-12-04 16:00,KS Księżak Łowicz(w),90 : 99W,99,26,39,66.7,8,28,28.6,34,67,50.7,23,27,85.2,9,18,27,20,25,24,10,10,1,2,110,AZS AGH Kraków,Sezon 2021/2022
2021-12-11 20:00,SKS Starogard Gdański(d),76 : 86P,76,18,40,45.0,12,37,32.4,30,77,39.0,4,7,57.1,11,22,33,17,27,15,12,5,2,7,71,AZS AGH Kraków,Sezon 2021/2022
2021-12-15 19:00,Znicz Basket Pruszków(w),68 : 86W,86,20,39,51.3,12,28,42.9,32,67,47.8,10,14,71.4,6,23,29,16,24,13,10,13,2,3,97,AZS AGH Kraków,Sezon 2021/2022
2021-12-19 18:00,TBS Śląsk II Wrocław(d),69 : 72P,69,22,42,52.4,4,31,12.9,26,73,35.6,13,23,56.5,12,23,35,15,25,19,9,10,2,3,65,AZS AGH Kraków,Sezon 2021/2022
2021-12-30 18:00,Rawlplug Sokół Łańcut(w),99 : 89P,89,18,37,48.6,15,42,35.7,33,79,41.8,8,9,88.9,9,22,31,16,24,20,11,8,1,2,87,AZS AGH Kraków,Sezon 2021/2022
2022-01-12 18:00,GKS Tychy(w),84 : 99W,99,21,37,56.8,11,32,34.4,32,69,46.4,24,29,82.8,12,18,30,25,26,29,9,9,0,1,112,AZS AGH Kraków,Sezon 2021/2022
2022-01-22 17:00,Górnik Trans.eu Wałbrzych(w),90 : 75P,75,16,36,44.4,8,34,23.5,24,70,34.3,19,27,70.4,13,21,34,16,23,24,12,14,1,3,74,AZS AGH Kraków,Sezon 2021/2022
2022-01-29 18:00,Sensation Kotwica Kołobrzeg(d),87 : 80W,87,19,36,52.8,12,34,35.3,31,70,44.3,13,18,72.2,6,23,29,17,18,16,4,5,1,5,91,AZS AGH Kraków,Sezon 2021/2022
2022-02-03 18:00,WKK Wrocław(w),95 : 99W,99,22,34,64.7,12,31,38.7,34,65,52.3,19,22,86.4,6,24,30,23,27,21,14,4,4,1,112,AZS AGH Kraków,Sezon 2021/2022
2022-02-05 13:00,MKKS Żak Koszalin(w),98 : 100W,100,22,38,57.9,11,32,34.4,33,70,47.1,23,27,85.2,5,20,25,17,23,23,18,15,1,1,99,AZS AGH Kraków,Sezon 2021/2022
2022-02-12 18:00,PGE Turów Zgorzelec(d),83 : 78W,83,24,40,60.0,7,32,21.9,31,72,43.1,14,16,87.5,10,21,31,22,28,18,13,9,3,2,92,AZS AGH Kraków,Sezon 2021/2022
2022-02-19 17:00,Decka Pelplin(w),76 : 74P,74,22,42,52.4,4,27,14.8,26,69,37.7,18,21,85.7,12,23,35,18,16,24,14,8,1,7,76,AZS AGH Kraków,Sezon 2021/2022
2022-02-26 18:30,Miasto Szkła Krosno(d),76 : 64W,76,20,35,57.1,6,35,17.1,26,70,37.1,18,27,66.7,17,26,43,14,28,19,13,7,3,5,77,AZS AGH Kraków,Sezon 2021/2022
2022-03-05 18:00,Weegree AZS Politechnika Opolska(d),65 : 72P,65,18,40,45.0,6,27,22.2,24,67,35.8,11,19,57.9,9,23,32,16,24,21,10,6,1,1,59,AZS AGH Kraków,Sezon 2021/2022
2022-03-12 18:00,Dziki Warszawa(w),76 : 79W,79,22,40,55.0,3,22,13.6,25,62,40.3,26,42,61.9,9,26,35,19,23,30,9,11,1,0,83,AZS AGH Kraków,Sezon 2021/2022
2022-03-19 18:00,KS Księżak Łowicz(d),122 : 91W,122,30,40,75.0,16,37,43.2,46,77,59.7,14,16,87.5,10,19,29,26,25,19,12,7,2,1,141,AZS AGH Kraków,Sezon 2021/2022
2022-03-22 19:00,AZS UMCS Start II Lublin(w),73 : 103W,103,22,35,62.9,14,29,48.3,36,64,56.3,17,24,70.8,9,23,32,31,25,21,12,9,3,2,131,AZS AGH Kraków,Sezon 2021/2022
2022-03-26 18:00,SKS Starogard Gdański(w),75 : 65P,65,23,45,51.1,5,28,17.9,28,73,38.4,4,11,36.4,10,28,38,14,25,15,11,8,3,1,65,AZS AGH Kraków,Sezon 2021/2022
2022-03-30 19:30,Znicz Basket Pruszków(d),79 : 83P,79,22,43,51.2,8,27,29.6,30,70,42.9,11,18,61.1,13,22,35,19,26,19,13,6,3,0,82,AZS AGH Kraków,Sezon 2021/2022
2022-04-03 13:00,TBS Śląsk II Wrocław(w),83 : 68P,68,21,41,51.2,6,36,16.7,27,77,35.1,8,10,80.0,10,26,36,19,24,17,16,10,0,2,65,AZS AGH Kraków,Sezon 2021/2022
2022-04-10 18:00,Rawlplug Sokół Łańcut(d),74 : 80P,74,19,40,47.5,9,30,30.0,28,70,40.0,9,21,42.9,8,23,31,23,24,20,12,7,1,3,70,AZS AGH Kraków,Sezon 2021/2022
2022-04-19 19:00,Górnik Trans.eu Wałbrzych(w),85 : 92W,92,21,36,58.3,10,31,32.3,31,67,46.3,20,34,58.8,9,28,37,22,24,25,16,9,0,1,94,AZS AGH Kraków,Sezon 2021/2022
2022-04-20 19:00,Górnik Trans.eu Wałbrzych(w),77 : 67P,67,19,47,40.4,8,32,25.0,27,79,34.2,5,9,55.6,14,29,43,16,18,20,13,9,2,3,68,AZS AGH Kraków,Sezon 2021/2022
2022-04-23 18:00,Górnik Trans.eu Wałbrzych(d),75 : 91P,75,19,35,54.3,8,31,25.8,27,66,40.9,13,23,56.5,5,21,26,17,23,21,14,8,3,2,66,AZS AGH Kraków,Sezon 2021/2022
2022-04-24 18:00,Górnik Trans.eu Wałbrzych(d),66 : 94P,66,17,38,44.7,6,34,17.6,23,72,31.9,14,29,48.3,17,17,34,13,23,22,11,4,1,3,43,AZS AGH Kraków,Sezon 2021/2022
2021-09-25 17:00,Znicz Basket Pruszków(d),63 : 58W,63,12,28,42.9,9,34,26.5,21,62,33.9,12,15,80.0,12,33,45,13,22,19,18,2,1,1,62,Decka Pelplin,Sezon 2021/2022
2021-10-02 12:00,TBS Śląsk II Wrocław(w),87 : 62P,62,16,42,38.1,7,21,33.3,23,63,36.5,9,18,50.0,12,22,34,10,16,18,20,6,4,4,47,Decka Pelplin,Sezon 2021/2022
2021-10-09 17:00,Rawlplug Sokół Łańcut(d),79 : 91P,79,25,44,56.8,8,29,27.6,33,73,45.2,5,7,71.4,18,21,39,22,22,14,14,10,2,2,96,Decka Pelplin,Sezon 2021/2022
2021-10-16 18:00,GKS Tychy(w),84 : 85W,85,20,31,64.5,10,31,32.3,30,62,48.4,15,21,71.4,8,24,32,23,20,22,15,5,5,2,97,Decka Pelplin,Sezon 2021/2022
2021-10-24 18:00,Górnik Trans.eu Wałbrzych(w),73 : 54P,54,21,42,50.0,3,20,15.0,24,62,38.7,3,7,42.9,6,36,42,16,20,12,17,1,3,3,57,Decka Pelplin,Sezon 2021/2022
2021-10-30 17:00,Sensation Kotwica Kołobrzeg(d),81 : 94P,81,18,35,51.4,10,25,40.0,28,60,46.7,15,20,75.0,5,26,31,23,24,18,14,6,1,3,91,Decka Pelplin,Sezon 2021/2022
2021-11-06 18:00,AZS AGH Kraków(w),75 : 58P,58,15,28,53.6,3,21,14.3,18,49,36.7,19,25,76.0,8,27,35,15,18,26,20,6,5,1,62,Decka Pelplin,Sezon 2021/2022
2021-11-13 17:00,MKKS Żak Koszalin(d),73 : 81P,73,17,33,51.5,11,31,35.5,28,64,43.8,6,15,40.0,15,18,33,14,25,17,20,7,1,4,63,Decka Pelplin,Sezon 2021/2022
2021-11-17 19:00,PGE Turów Zgorzelec(w),73 : 90W,90,24,47,51.1,10,23,43.5,34,70,48.6,12,12,100.0,17,30,47,20,25,14,21,6,3,1,109,Decka Pelplin,Sezon 2021/2022
2021-11-20 17:00,WKK Wrocław(d),78 : 53W,78,20,33,60.6,10,29,34.5,30,62,48.4,8,11,72.7,12,26,38,16,21,15,11,10,4,1,100,Decka Pelplin,Sezon 2021/2022
2021-11-27 17:00,Miasto Szkła Krosno(d),78 : 70W,78,14,41,34.1,9,25,36.0,23,66,34.8,23,28,82.1,13,25,38,18,17,23,12,7,4,4,85,Decka Pelplin,Sezon 2021/2022
2021-12-01 19:00,AZS UMCS Start II Lublin(w),92 : 70P,70,19,39,48.7,9,35,25.7,28,74,37.8,5,11,45.5,11,27,38,18,22,16,15,4,3,0,66,Decka Pelplin,Sezon 2021/2022
2021-12-11 17:00,Weegree AZS Politechnika Opolska(d),67 : 70P,67,12,30,40.0,11,34,32.4,23,64,35.9,10,13,76.9,11,27,38,17,19,16,12,7,5,3,78,Decka Pelplin,Sezon 2021/2022
2021-12-15 19:00,Dziki Warszawa(w),71 : 65P,65,13,30,43.3,11,32,34.4,24,62,38.7,6,10,60.0,8,25,33,16,16,12,19,9,5,4,67,Decka Pelplin,Sezon 2021/2022
2021-12-18 17:00,KS Księżak Łowicz(d),80 : 63W,80,23,47,48.9,8,27,29.6,31,74,41.9,10,11,90.9,21,32,53,23,20,14,17,10,3,1,108,Decka Pelplin,Sezon 2021/2022
2022-01-02 18:00,SKS Starogard Gdański(w),77 : 52P,52,10,34,29.4,7,23,30.4,17,57,29.8,11,17,64.7,10,20,30,13,21,20,20,10,6,4,45,Decka Pelplin,Sezon 2021/2022
2022-01-09 17:00,Znicz Basket Pruszków(w),71 : 77W,77,17,35,48.6,12,26,46.2,29,61,47.5,7,8,87.5,9,24,33,22,25,17,16,6,2,4,91,Decka Pelplin,Sezon 2021/2022
2022-01-16 17:00,TBS Śląsk II Wrocław(d),73 : 87P,73,14,29,48.3,11,39,28.2,25,68,36.8,12,18,66.7,15,19,34,15,22,19,17,9,3,0,68,Decka Pelplin,Sezon 2021/2022
2022-01-22 17:30,Rawlplug Sokół Łańcut(w),86 : 80P,80,17,32,53.1,9,29,31.0,26,61,42.6,19,27,70.4,13,25,38,16,22,22,15,6,2,2,84,Decka Pelplin,Sezon 2021/2022
2022-01-29 17:00,GKS Tychy(d),71 : 76P,71,15,28,53.6,8,26,30.8,23,54,42.6,17,25,68.0,7,26,33,18,21,20,18,4,3,0,72,Decka Pelplin,Sezon 2021/2022
2022-02-05 17:00,Górnik Trans.eu Wałbrzych(d),67 : 75P,67,18,40,45.0,6,25,24.0,24,65,36.9,13,19,68.4,12,24,36,22,25,20,12,7,1,2,74,Decka Pelplin,Sezon 2021/2022
2022-02-12 18:00,Sensation Kotwica Kołobrzeg(w),75 : 60P,60,18,46,39.1,7,20,35.0,25,66,37.9,3,10,30.0,13,25,38,17,18,12,12,5,1,4,61,Decka Pelplin,Sezon 2021/2022
2022-02-19 17:00,AZS AGH Kraków(d),76 : 74W,76,20,38,52.6,8,21,38.1,28,59,47.5,12,19,63.2,8,27,35,21,25,16,18,8,7,1,91,Decka Pelplin,Sezon 2021/2022
2022-02-26 17:00,MKKS Żak Koszalin(w),62 : 76W,76,20,34,58.8,9,31,29.0,29,65,44.6,9,11,81.8,9,27,36,14,17,15,12,10,5,4,91,Decka Pelplin,Sezon 2021/2022
2022-03-02 18:00,PGE Turów Zgorzelec(d),65 : 71P,65,15,41,36.6,9,30,30.0,24,71,33.8,8,12,66.7,16,25,41,17,25,13,14,8,4,4,70,Decka Pelplin,Sezon 2021/2022
2022-03-05 18:00,WKK Wrocław(w),90 : 82P,82,20,38,52.6,11,25,44.0,31,63,49.2,9,12,75.0,6,21,27,18,21,16,14,6,2,1,86,Decka Pelplin,Sezon 2021/2022
2022-03-12 17:00,Miasto Szkła Krosno(w),81 : 87W,87,14,30,46.7,13,29,44.8,27,59,45.8,20,25,80.0,12,25,37,19,21,22,18,9,2,4,99,Decka Pelplin,Sezon 2021/2022
2022-03-19 17:00,AZS UMCS Start II Lublin(d),72 : 76P,72,20,40,50.0,7,39,17.9,27,79,34.2,11,20,55.0,18,30,48,19,21,18,13,7,1,0,73,Decka Pelplin,Sezon 2021/2022
2022-03-26 18:00,Weegree AZS Politechnika Opolska(w),90 : 79P,79,23,41,56.1,7,26,26.9,30,67,44.8,12,16,75.0,12,23,35,15,23,18,15,3,1,2,77,Decka Pelplin,Sezon 2021/2022
2022-03-30 18:00,Dziki Warszawa(d),52 : 72P,52,17,35,48.6,3,24,12.5,20,59,33.9,9,11,81.8,9,26,35,10,17,16,18,9,4,1,51,Decka Pelplin,Sezon 2021/2022
2022-04-03 16:00,KS Księżak Łowicz(w),105 : 101P,101,25,49,51.0,15,26,57.7,40,75,53.3,6,8,75.0,9,21,30,19,26,17,15,4,1,2,103,Decka Pelplin,Sezon 2021/2022
2022-04-10 18:00,SKS Starogard Gdański(d),65 : 78P,65,17,42,40.5,7,33,21.2,24,75,32.0,10,12,83.3,15,22,37,15,23,16,15,9,1,2,59,Decka Pelplin,Sezon 2021/2022
2021-09-25 17:30,Weegree AZS Politechnika Opolska(w),71 : 64P,64,18,34,52.9,5,20,25.0,23,54,42.6,13,19,68.4,9,17,26,11,19,21,17,8,2,4,57,Dziki Warszawa,Sezon 2021/2022
2021-10-02 18:00,WKK Wrocław(w),88 : 56P,56,11,37,29.7,8,28,28.6,19,65,29.2,10,18,55.6,11,26,37,12,23,18,13,8,2,4,48,Dziki Warszawa,Sezon 2021/2022
2021-10-09 18:00,KS Księżak Łowicz(d),101 : 60W,101,30,42,71.4,10,32,31.3,40,74,54.1,11,19,57.9,12,27,39,28,18,15,11,12,1,1,128,Dziki Warszawa,Sezon 2021/2022
2021-10-16 18:00,SKS Starogard Gdański(w),76 : 82W,82,18,37,48.6,11,31,35.5,29,68,42.6,13,21,61.9,8,21,29,20,17,19,10,15,6,3,95,Dziki Warszawa,Sezon 2021/2022
2021-10-20 18:00,Znicz Basket Pruszków(d),67 : 48W,67,17,35,48.6,8,20,40.0,25,55,45.5,9,16,56.3,4,29,33,18,24,15,16,10,2,2,77,Dziki Warszawa,Sezon 2021/2022
2021-10-24 19:00,TBS Śląsk II Wrocław(w),64 : 59P,59,9,30,30.0,7,28,25.0,16,58,27.6,20,34,58.8,9,30,39,13,22,25,13,6,5,2,53,Dziki Warszawa,Sezon 2021/2022
2021-10-30 18:00,Rawlplug Sokół Łańcut(d),58 : 71P,58,12,35,34.3,7,26,26.9,19,61,31.1,13,21,61.9,9,25,34,16,17,20,13,7,1,1,53,Dziki Warszawa,Sezon 2021/2022
2021-11-06 19:00,GKS Tychy(w),79 : 78P,78,22,32,68.8,8,29,27.6,30,61,49.2,10,16,62.5,5,29,34,12,21,17,16,7,4,2,82,Dziki Warszawa,Sezon 2021/2022
2021-11-17 18:00,Górnik Trans.eu Wałbrzych(d),71 : 78P,71,17,35,48.6,10,32,31.3,27,67,40.3,7,12,58.3,10,24,34,20,21,14,11,4,4,3,77,Dziki Warszawa,Sezon 2021/2022
2021-11-20 18:00,Sensation Kotwica Kołobrzeg(d),66 : 83P,66,13,38,34.2,9,30,30.0,22,68,32.4,13,15,86.7,7,21,28,17,20,11,11,10,4,3,66,Dziki Warszawa,Sezon 2021/2022
2021-11-27 20:00,AZS AGH Kraków(w),75 : 58P,58,15,27,55.6,5,20,25.0,20,47,42.6,13,21,61.9,6,19,25,10,20,21,20,8,3,0,49,Dziki Warszawa,Sezon 2021/2022
2021-12-04 18:00,MKKS Żak Koszalin(d),74 : 87P,74,14,27,51.9,11,35,31.4,25,62,40.3,13,20,65.0,7,25,32,20,16,19,13,7,2,4,78,Dziki Warszawa,Sezon 2021/2022
2021-12-11 18:00,PGE Turów Zgorzelec(d),79 : 50W,79,23,43,53.5,8,31,25.8,31,74,41.9,9,14,64.3,18,29,47,25,21,16,11,15,2,1,109,Dziki Warszawa,Sezon 2021/2022
2021-12-15 19:00,Decka Pelplin(d),71 : 65W,71,19,40,47.5,8,17,47.1,27,57,47.4,9,17,52.9,4,24,28,13,12,16,14,13,4,5,77,Dziki Warszawa,Sezon 2021/2022
2021-12-19 17:00,Miasto Szkła Krosno(w),80 : 79P,79,20,38,52.6,9,23,39.1,29,61,47.5,12,20,60.0,7,23,30,13,23,23,14,5,1,5,74,Dziki Warszawa,Sezon 2021/2022
2022-01-02 18:00,AZS UMCS Start II Lublin(d),71 : 66W,71,19,43,44.2,7,22,31.8,26,65,40.0,12,21,57.1,8,34,42,15,18,20,12,6,4,4,78,Dziki Warszawa,Sezon 2021/2022
2022-01-08 18:00,Weegree AZS Politechnika Opolska(d),69 : 76P,69,19,36,52.8,9,30,30.0,28,66,42.4,4,12,33.3,9,25,34,15,23,15,8,6,2,1,72,Dziki Warszawa,Sezon 2021/2022
2022-01-15 18:00,WKK Wrocław(d),67 : 74P,67,14,35,40.0,11,32,34.4,25,67,37.3,6,13,46.2,13,21,34,16,20,11,11,10,2,6,69,Dziki Warszawa,Sezon 2021/2022
2022-01-22 18:00,KS Księżak Łowicz(w),73 : 77W,77,21,40,52.5,7,27,25.9,28,67,41.8,14,24,58.3,11,19,30,9,24,23,7,8,1,2,69,Dziki Warszawa,Sezon 2021/2022
2022-01-29 18:00,SKS Starogard Gdański(d),70 : 57W,70,19,36,52.8,4,21,19.0,23,57,40.4,20,26,76.9,10,27,37,16,21,22,16,14,3,2,84,Dziki Warszawa,Sezon 2021/2022
2022-02-02 19:00,Znicz Basket Pruszków(w),82 : 77P,77,18,26,69.2,8,28,28.6,26,54,48.1,17,28,60.7,7,20,27,14,21,20,15,6,1,2,71,Dziki Warszawa,Sezon 2021/2022
2022-02-12 17:30,Rawlplug Sokół Łańcut(w),68 : 93W,93,24,44,54.5,14,25,56.0,38,69,55.1,3,4,75.0,13,22,35,23,21,11,13,10,0,3,116,Dziki Warszawa,Sezon 2021/2022
2022-02-16 16:00,TBS Śląsk II Wrocław(d),81 : 73W,81,16,40,40.0,11,35,31.4,27,75,36.0,16,23,69.6,13,30,43,20,22,20,11,11,2,1,91,Dziki Warszawa,Sezon 2021/2022
2022-02-19 18:00,GKS Tychy(d),83 : 57W,83,19,30,63.3,12,32,37.5,31,62,50.0,9,18,50.0,8,27,35,23,22,21,13,15,3,0,106,Dziki Warszawa,Sezon 2021/2022
2022-03-02 18:00,Górnik Trans.eu Wałbrzych(w),84 : 69P,69,17,38,44.7,10,32,31.3,27,70,38.6,5,11,45.5,13,19,32,18,19,12,14,8,1,5,65,Dziki Warszawa,Sezon 2021/2022
2022-03-05 18:00,Sensation Kotwica Kołobrzeg(w),58 : 67W,67,16,37,43.2,8,28,28.6,24,65,36.9,11,22,50.0,12,26,38,18,18,21,11,9,0,3,69,Dziki Warszawa,Sezon 2021/2022
2022-03-12 18:00,AZS AGH Kraków(d),76 : 79P,76,18,32,56.3,9,27,33.3,27,59,45.8,13,22,59.1,6,36,42,18,30,23,19,4,0,1,80,Dziki Warszawa,Sezon 2021/2022
2022-03-20 17:00,MKKS Żak Koszalin(w),73 : 88W,88,19,36,52.8,11,25,44.0,30,61,49.2,17,22,77.3,9,24,33,24,21,20,12,10,1,5,108,Dziki Warszawa,Sezon 2021/2022
2022-03-26 18:00,PGE Turów Zgorzelec(w),80 : 92W,92,25,36,69.4,11,30,36.7,36,66,54.5,9,14,64.3,9,21,30,26,22,13,12,6,3,1,110,Dziki Warszawa,Sezon 2021/2022
2022-03-30 18:00,Decka Pelplin(w),52 : 72W,72,14,29,48.3,11,28,39.3,25,57,43.9,11,23,47.8,9,27,36,16,16,17,14,11,1,4,78,Dziki Warszawa,Sezon 2021/2022
2022-04-02 18:00,Miasto Szkła Krosno(d),66 : 52W,66,16,39,41.0,9,30,30.0,25,69,36.2,7,13,53.8,14,28,42,16,22,16,10,4,8,1,76,Dziki Warszawa,Sezon 2021/2022
2022-04-10 18:00,AZS UMCS Start II Lublin(w),72 : 84W,84,20,40,50.0,11,31,35.5,31,71,43.7,11,13,84.6,13,20,33,18,18,19,16,12,2,2,91,Dziki Warszawa,Sezon 2021/2022
2022-04-19 18:00,Rawlplug Sokół Łańcut(w),83 : 80P,80,21,38,55.3,8,25,32.0,29,63,46.0,14,20,70.0,5,23,28,17,24,19,10,10,4,2,89,Dziki Warszawa,Sezon 2021/2022
2022-04-20 18:00,Rawlplug Sokół Łańcut(w),64 : 76W,76,18,40,45.0,7,24,29.2,25,64,39.1,19,24,79.2,6,31,37,13,22,23,16,9,2,7,77,Dziki Warszawa,Sezon 2021/2022
2022-04-23 15:00,Rawlplug Sokół Łańcut(d),85 : 58W,85,22,37,59.5,11,30,36.7,33,67,49.3,8,12,66.7,6,30,36,22,16,18,15,9,3,5,102,Dziki Warszawa,Sezon 2021/2022
2022-04-24 20:00,Rawlplug Sokół Łańcut(d),62 : 66P,62,15,35,42.9,5,31,16.1,20,66,30.3,17,26,65.4,12,27,39,12,21,21,14,10,0,2,54,Dziki Warszawa,Sezon 2021/2022
2022-04-27 18:00,Rawlplug Sokół Łańcut(w),92 : 54P,54,17,45,37.8,5,22,22.7,22,67,32.8,5,11,45.5,10,18,28,7,21,17,13,6,0,5,31,Dziki Warszawa,Sezon 2021/2022
2021-09-25 18:00,AZS AGH Kraków(w),59 : 84W,84,23,40,57.5,9,23,39.1,32,63,50.8,11,18,61.1,8,28,36,14,21,22,12,8,2,3,94,GKS Tychy,Sezon 2021/2022
2021-10-02 18:00,MKKS Żak Koszalin(d),85 : 84W,85,19,39,48.7,9,24,37.5,28,63,44.4,20,26,76.9,10,25,35,18,29,23,12,8,2,3,95,GKS Tychy,Sezon 2021/2022
2021-10-09 19:00,PGE Turów Zgorzelec(d),114 : 77W,114,31,53,58.5,13,33,39.4,44,86,51.2,13,17,76.5,20,29,49,29,27,16,13,14,2,2,149,GKS Tychy,Sezon 2021/2022
2021-10-16 18:00,Decka Pelplin(d),84 : 85P,84,23,46,50.0,8,28,28.6,31,74,41.9,14,18,77.8,14,19,33,17,22,20,10,13,2,5,92,GKS Tychy,Sezon 2021/2022
2021-10-20 18:00,Miasto Szkła Krosno(w),70 : 74W,74,19,42,45.2,6,20,30.0,25,62,40.3,18,22,81.8,8,24,32,11,22,22,12,7,1,3,72,GKS Tychy,Sezon 2021/2022
2021-10-23 19:00,AZS UMCS Start II Lublin(d),93 : 62W,93,19,38,50.0,14,33,42.4,33,71,46.5,13,13,100.0,12,30,42,24,21,14,13,10,2,3,120,GKS Tychy,Sezon 2021/2022
2021-10-30 17:30,Weegree AZS Politechnika Opolska(w),87 : 90W,90,22,37,59.5,11,22,50.0,33,59,55.9,13,16,81.3,4,23,27,19,25,20,13,8,0,1,102,GKS Tychy,Sezon 2021/2022
2021-11-06 19:00,Dziki Warszawa(d),79 : 78W,79,21,38,55.3,8,28,28.6,29,66,43.9,13,18,72.2,10,26,36,18,18,20,13,6,2,4,86,GKS Tychy,Sezon 2021/2022
2021-11-13 18:00,KS Księżak Łowicz(w),78 : 81W,81,17,39,43.6,8,24,33.3,25,63,39.7,23,30,76.7,16,25,41,19,20,22,14,7,0,1,89,GKS Tychy,Sezon 2021/2022
2021-11-17 18:00,SKS Starogard Gdański(d),101 : 83W,101,26,50,52.0,13,25,52.0,39,75,52.0,10,10,100.0,8,21,29,22,21,13,7,13,2,3,124,GKS Tychy,Sezon 2021/2022
2021-11-21 17:00,Znicz Basket Pruszków(w),53 : 72W,72,16,38,42.1,9,29,31.0,25,67,37.3,13,16,81.3,13,25,38,16,19,16,13,9,2,4,79,GKS Tychy,Sezon 2021/2022
2021-11-30 18:00,TBS Śląsk II Wrocław(d),88 : 77W,88,27,49,55.1,7,23,30.4,34,72,47.2,13,18,72.2,14,24,38,24,22,18,12,12,3,2,110,GKS Tychy,Sezon 2021/2022
2021-12-04 17:30,Rawlplug Sokół Łańcut(w),97 : 85P,85,19,40,47.5,10,30,33.3,29,70,41.4,17,22,77.3,14,16,30,12,21,15,13,12,1,7,81,GKS Tychy,Sezon 2021/2022
2021-12-11 18:00,WKK Wrocław(w),86 : 69P,69,11,29,37.9,8,27,29.6,19,56,33.9,23,28,82.1,9,23,32,16,23,25,16,5,0,3,64,GKS Tychy,Sezon 2021/2022
2021-12-18 17:00,Górnik Trans.eu Wałbrzych(w),92 : 85P,85,20,59,33.9,8,24,33.3,28,83,33.7,21,29,72.4,13,33,46,17,27,25,10,8,0,3,83,GKS Tychy,Sezon 2021/2022
2022-01-02 18:00,Sensation Kotwica Kołobrzeg(d),97 : 88W,97,19,38,50.0,11,32,34.4,30,70,42.9,26,30,86.7,11,22,33,24,23,26,11,9,0,1,108,GKS Tychy,Sezon 2021/2022
2022-01-12 18:00,AZS AGH Kraków(d),84 : 99P,84,25,41,61.0,4,18,22.2,29,59,49.2,22,24,91.7,11,22,33,18,29,26,18,7,1,0,93,GKS Tychy,Sezon 2021/2022
2022-01-15 17:00,MKKS Żak Koszalin(w),94 : 93P,93,21,39,53.8,11,33,33.3,32,72,44.4,18,23,78.3,10,20,30,15,25,23,14,6,1,4,86,GKS Tychy,Sezon 2021/2022
2022-01-23 17:00,PGE Turów Zgorzelec(w),98 : 100W,100,26,47,55.3,10,29,34.5,36,76,47.4,18,23,78.3,11,26,37,11,24,23,12,9,1,0,101,GKS Tychy,Sezon 2021/2022
2022-01-29 17:00,Decka Pelplin(w),71 : 76W,76,18,34,52.9,9,26,34.6,27,60,45.0,13,18,72.2,5,21,26,19,20,21,10,9,0,3,82,GKS Tychy,Sezon 2021/2022
2022-02-02 18:00,Miasto Szkła Krosno(d),89 : 71W,89,21,35,60.0,7,21,33.3,28,56,50.0,26,35,74.3,10,26,36,20,20,25,13,5,4,3,104,GKS Tychy,Sezon 2021/2022
2022-02-05 17:00,AZS UMCS Start II Lublin(w),74 : 69P,69,15,36,41.7,11,32,34.4,26,68,38.2,6,12,50.0,11,25,36,17,21,17,8,5,0,3,71,GKS Tychy,Sezon 2021/2022
2022-02-12 19:00,Weegree AZS Politechnika Opolska(d),101 : 106P,101,24,44,54.5,11,24,45.8,35,68,51.5,20,30,66.7,8,19,27,25,25,24,12,11,1,3,110,GKS Tychy,Sezon 2021/2022
2022-02-19 18:00,Dziki Warszawa(w),83 : 57P,57,14,34,41.2,7,22,31.8,21,56,37.5,8,15,53.3,10,24,34,12,21,22,22,7,0,3,46,GKS Tychy,Sezon 2021/2022
2022-02-26 18:00,KS Księżak Łowicz(d),87 : 99P,87,31,44,70.5,2,23,8.7,33,67,49.3,19,27,70.4,7,20,27,21,29,24,15,9,1,1,88,GKS Tychy,Sezon 2021/2022
2022-03-02 19:00,SKS Starogard Gdański(w),75 : 68P,68,13,41,31.7,10,35,28.6,23,76,30.3,12,17,70.6,12,24,36,12,21,20,13,12,1,4,58,GKS Tychy,Sezon 2021/2022
2022-03-05 18:00,Znicz Basket Pruszków(d),89 : 64W,89,16,33,48.5,14,31,45.2,30,64,46.9,15,23,65.2,12,28,40,23,24,23,11,9,2,0,110,GKS Tychy,Sezon 2021/2022
2022-03-13 13:30,TBS Śląsk II Wrocław(w),94 : 77P,77,17,31,54.8,8,25,32.0,25,56,44.6,19,26,73.1,9,22,31,9,29,23,22,8,0,4,65,GKS Tychy,Sezon 2021/2022
2022-03-20 18:00,Rawlplug Sokół Łańcut(d),88 : 78W,88,22,40,55.0,7,22,31.8,29,62,46.8,23,28,82.1,11,23,34,16,23,23,13,12,2,3,101,GKS Tychy,Sezon 2021/2022
2022-03-27 18:00,WKK Wrocław(d),102 : 96W,102,25,45,55.6,12,25,48.0,37,70,52.9,16,23,69.6,10,30,40,25,25,21,10,4,2,1,123,GKS Tychy,Sezon 2021/2022
2022-04-03 18:00,Górnik Trans.eu Wałbrzych(d),87 : 72W,87,23,41,56.1,9,29,31.0,32,70,45.7,14,19,73.7,10,27,37,20,24,20,16,6,4,2,95,GKS Tychy,Sezon 2021/2022
2022-04-10 18:00,Sensation Kotwica Kołobrzeg(w),77 : 47P,47,14,45,31.1,5,25,20.0,19,70,27.1,4,8,50.0,14,26,40,8,19,14,13,6,1,1,34,GKS Tychy,Sezon 2021/2022
2022-04-19 18:30,Weegree AZS Politechnika Opolska(w),73 : 80W,80,16,40,40.0,12,27,44.4,28,67,41.8,12,20,60.0,9,29,38,16,28,21,12,5,0,2,80,GKS Tychy,Sezon 2021/2022
2022-04-20 18:30,Weegree AZS Politechnika Opolska(w),64 : 67W,67,12,32,37.5,9,25,36.0,21,57,36.8,16,24,66.7,6,25,31,11,22,22,17,10,3,3,61,GKS Tychy,Sezon 2021/2022
2022-04-23 18:00,Weegree AZS Politechnika Opolska(d),86 : 96P,86,14,31,45.2,16,33,48.5,30,64,46.9,10,16,62.5,7,16,23,18,26,19,16,9,0,2,80,GKS Tychy,Sezon 2021/2022
2022-04-24 18:00,Weegree AZS Politechnika Opolska(d),74 : 85P,74,22,37,59.5,4,26,15.4,26,63,41.3,18,23,78.3,8,25,33,12,24,23,13,7,3,1,74,GKS Tychy,Sezon 2021/2022
2022-04-27 18:00,Weegree AZS Politechnika Opolska(w),86 : 78P,78,20,41,48.8,6,30,20.0,26,71,36.6,20,25,80.0,14,20,34,15,30,25,12,6,1,4,72,GKS Tychy,Sezon 2021/2022
2021-09-25 18:00,WKK Wrocław(d),71 : 74P,71,20,44,45.5,8,22,36.4,28,66,42.4,7,11,63.6,12,26,38,12,20,15,22,10,2,1,69,Górnik Trans.eu Wałbrzych,Sezon 2021/2022
2021-10-02 17:00,Sensation Kotwica Kołobrzeg(d),88 : 77W,88,19,33,57.6,11,38,28.9,30,71,42.3,17,24,70.8,10,29,39,18,21,24,8,6,4,2,99,Górnik Trans.eu Wałbrzych,Sezon 2021/2022
2021-10-08 19:00,AZS AGH Kraków(w),61 : 94W,94,32,47,68.1,3,22,13.6,35,69,50.7,21,32,65.6,11,23,34,23,23,27,13,16,0,2,109,Górnik Trans.eu Wałbrzych,Sezon 2021/2022
2021-10-16 13:00,MKKS Żak Koszalin(w),71 : 90W,90,19,38,50.0,12,31,38.7,31,69,44.9,16,23,69.6,11,21,32,18,22,15,6,11,2,1,102,Górnik Trans.eu Wałbrzych,Sezon 2021/2022
2021-10-20 19:00,PGE Turów Zgorzelec(w),60 : 97W,97,30,51,58.8,9,23,39.1,39,74,52.7,10,13,76.9,10,35,45,29,25,12,15,11,6,1,135,Górnik Trans.eu Wałbrzych,Sezon 2021/2022
2021-10-24 18:00,Decka Pelplin(d),73 : 54W,73,16,46,34.8,12,31,38.7,28,77,36.4,5,16,31.3,15,28,43,18,12,20,6,13,3,3,84,Górnik Trans.eu Wałbrzych,Sezon 2021/2022
2021-10-30 17:00,Miasto Szkła Krosno(w),77 : 78W,78,18,41,43.9,9,26,34.6,27,67,40.3,15,21,71.4,6,23,29,11,23,21,6,8,0,3,74,Górnik Trans.eu Wałbrzych,Sezon 2021/2022
2021-11-06 18:00,AZS UMCS Start II Lublin(d),81 : 66W,81,20,34,58.8,13,38,34.2,33,72,45.8,2,7,28.6,14,39,53,22,21,10,16,4,2,3,102,Górnik Trans.eu Wałbrzych,Sezon 2021/2022
2021-11-13 17:30,Weegree AZS Politechnika Opolska(w),83 : 75P,75,18,47,38.3,7,28,25.0,25,75,33.3,18,21,85.7,14,22,36,12,22,23,7,8,5,4,76,Górnik Trans.eu Wałbrzych,Sezon 2021/2022
2021-11-17 18:00,Dziki Warszawa(w),71 : 78W,78,19,41,46.3,8,24,33.3,27,65,41.5,16,26,61.5,12,29,41,12,14,21,7,9,3,4,88,Górnik Trans.eu Wałbrzych,Sezon 2021/2022
2021-11-20 16:00,KS Księżak Łowicz(w),95 : 87P,87,20,41,48.8,9,26,34.6,29,67,43.3,20,24,83.3,6,17,23,10,30,21,14,12,1,1,77,Górnik Trans.eu Wałbrzych,Sezon 2021/2022
2021-11-27 17:00,SKS Starogard Gdański(d),87 : 65W,87,22,41,53.7,10,27,37.0,32,68,47.1,13,18,72.2,9,31,40,23,24,18,15,13,1,4,108,Górnik Trans.eu Wałbrzych,Sezon 2021/2022
2021-12-04 18:00,Znicz Basket Pruszków(w),82 : 94W,94,23,48,47.9,7,22,31.8,30,70,42.9,27,34,79.4,7,23,30,14,21,29,4,10,2,2,99,Górnik Trans.eu Wałbrzych,Sezon 2021/2022
2021-12-10 19:45,TBS Śląsk II Wrocław(d),85 : 71W,85,21,49,42.9,9,20,45.0,30,69,43.5,16,26,61.5,16,31,47,19,20,19,12,5,2,3,97,Górnik Trans.eu Wałbrzych,Sezon 2021/2022
2021-12-15 18:00,Rawlplug Sokół Łańcut(w),101 : 76P,76,20,40,50.0,10,24,41.7,30,64,46.9,6,6,100.0,7,21,28,18,17,15,18,7,2,2,79,Górnik Trans.eu Wałbrzych,Sezon 2021/2022
2021-12-18 17:00,GKS Tychy(d),92 : 85W,92,22,49,44.9,8,25,32.0,30,74,40.5,24,33,72.7,14,39,53,16,26,27,14,5,3,0,102,Górnik Trans.eu Wałbrzych,Sezon 2021/2022
2022-01-06 16:00,WKK Wrocław(w),74 : 84W,84,26,52,50.0,6,20,30.0,32,72,44.4,14,20,70.0,7,28,35,23,18,19,11,11,6,1,102,Górnik Trans.eu Wałbrzych,Sezon 2021/2022
2022-01-15 18:00,Sensation Kotwica Kołobrzeg(w),72 : 71P,71,14,34,41.2,6,20,30.0,20,54,37.0,25,32,78.1,6,31,37,14,16,24,19,6,3,3,71,Górnik Trans.eu Wałbrzych,Sezon 2021/2022
2022-01-22 17:00,AZS AGH Kraków(d),90 : 75W,90,24,47,51.1,9,20,45.0,33,67,49.3,15,19,78.9,12,32,44,28,25,22,22,7,3,1,112,Górnik Trans.eu Wałbrzych,Sezon 2021/2022
2022-01-29 17:30,MKKS Żak Koszalin(d),82 : 74W,82,22,44,50.0,10,19,52.6,32,63,50.8,8,11,72.7,9,28,37,19,22,17,13,4,4,2,99,Górnik Trans.eu Wałbrzych,Sezon 2021/2022
2022-02-02 18:00,PGE Turów Zgorzelec(d),70 : 68W,70,11,35,31.4,8,29,27.6,19,64,29.7,24,34,70.6,12,28,40,16,22,28,15,6,6,0,68,Górnik Trans.eu Wałbrzych,Sezon 2021/2022
2022-02-05 17:00,Decka Pelplin(w),67 : 75W,75,17,36,47.2,10,25,40.0,27,61,44.3,11,27,40.7,13,28,41,15,20,25,14,8,2,1,77,Górnik Trans.eu Wałbrzych,Sezon 2021/2022
2022-02-12 17:00,Miasto Szkła Krosno(d),78 : 79P,78,22,50,44.0,6,26,23.1,28,76,36.8,16,24,66.7,12,25,37,13,18,24,9,12,4,3,79,Górnik Trans.eu Wałbrzych,Sezon 2021/2022
2022-02-20 15:00,AZS UMCS Start II Lublin(w),81 : 91W,91,25,45,55.6,11,30,36.7,36,75,48.0,8,13,61.5,14,36,50,26,22,13,16,7,5,0,119,Górnik Trans.eu Wałbrzych,Sezon 2021/2022
2022-02-26 17:00,Weegree AZS Politechnika Opolska(d),76 : 75W,76,28,58,48.3,5,17,29.4,33,75,44.0,5,14,35.7,14,33,47,17,25,18,9,8,4,2,92,Górnik Trans.eu Wałbrzych,Sezon 2021/2022
2022-03-02 18:00,Dziki Warszawa(d),84 : 69W,84,23,38,60.5,8,25,32.0,31,63,49.2,14,19,73.7,13,29,42,22,12,18,14,8,5,1,110,Górnik Trans.eu Wałbrzych,Sezon 2021/2022
2022-03-05 17:00,KS Księżak Łowicz(d),85 : 78W,85,25,50,50.0,6,18,33.3,31,68,45.6,17,31,54.8,12,28,40,24,17,24,10,9,3,2,100,Górnik Trans.eu Wałbrzych,Sezon 2021/2022
2022-03-13 18:00,SKS Starogard Gdański(w),85 : 73P,73,22,49,44.9,3,16,18.8,25,65,38.5,20,29,69.0,10,33,43,11,24,19,19,10,5,4,74,Górnik Trans.eu Wałbrzych,Sezon 2021/2022
2022-03-19 17:00,Znicz Basket Pruszków(d),86 : 76W,86,20,41,48.8,12,29,41.4,32,70,45.7,10,16,62.5,12,34,46,20,22,17,16,7,5,1,104,Górnik Trans.eu Wałbrzych,Sezon 2021/2022
2022-03-23 19:00,TBS Śląsk II Wrocław(w),95 : 100W,100,27,68,39.7,11,30,36.7,38,98,38.8,13,23,56.5,19,41,60,21,23,21,15,10,5,5,111,Górnik Trans.eu Wałbrzych,Sezon 2021/2022
2022-03-30 19:00,Rawlplug Sokół Łańcut(d),85 : 91P,85,29,48,60.4,5,23,21.7,34,71,47.9,12,21,57.1,13,23,36,16,16,21,10,5,2,3,88,Górnik Trans.eu Wałbrzych,Sezon 2021/2022
2022-04-03 18:00,GKS Tychy(w),87 : 72P,72,18,38,47.4,6,23,26.1,24,61,39.3,18,24,75.0,8,18,26,15,20,23,15,11,2,4,68,Górnik Trans.eu Wałbrzych,Sezon 2021/2022
2022-04-19 19:00,AZS AGH Kraków(d),85 : 92P,85,26,54,48.1,6,19,31.6,32,73,43.8,15,21,71.4,14,30,44,13,25,24,17,8,1,0,87,Górnik Trans.eu Wałbrzych,Sezon 2021/2022
2022-04-20 19:00,AZS AGH Kraków(d),77 : 67W,77,24,43,55.8,6,21,28.6,30,64,46.9,11,21,52.4,6,40,46,23,20,18,16,7,3,2,96,Górnik Trans.eu Wałbrzych,Sezon 2021/2022
2022-04-23 18:00,AZS AGH Kraków(w),75 : 91W,91,28,49,57.1,6,16,37.5,34,65,52.3,17,24,70.8,9,37,46,25,22,23,20,6,2,3,112,Górnik Trans.eu Wałbrzych,Sezon 2021/2022
2022-04-24 18:00,AZS AGH Kraków(w),66 : 94W,94,25,38,65.8,8,19,42.1,33,57,57.9,20,30,66.7,3,36,39,26,22,23,11,8,3,1,125,Górnik Trans.eu Wałbrzych,Sezon 2021/2022
2022-04-30 17:30,Sensation Kotwica Kołobrzeg(d),80 : 69W,80,23,43,53.5,7,25,28.0,30,68,44.1,13,18,72.2,16,30,46,17,18,20,11,7,1,2,97,Górnik Trans.eu Wałbrzych,Sezon 2021/2022
2022-05-01 17:30,Sensation Kotwica Kołobrzeg(d),101 : 98W,101,27,51,52.9,7,28,25.0,34,79,43.0,26,34,76.5,10,41,51,23,24,27,18,7,7,3,118,Górnik Trans.eu Wałbrzych,Sezon 2021/2022
2022-05-07 18:00,Sensation Kotwica Kołobrzeg(w),102 : 99P,99,20,45,44.4,11,33,33.3,31,78,39.7,26,36,72.2,10,35,45,15,27,30,21,7,4,5,92,Górnik Trans.eu Wałbrzych,Sezon 2021/2022
2022-05-08 18:00,Sensation Kotwica Kołobrzeg(w),79 : 71P,71,18,39,46.2,6,25,24.0,24,64,37.5,17,33,51.5,8,25,33,13,26,29,10,3,3,3,57,Górnik Trans.eu Wałbrzych,Sezon 2021/2022
2022-05-11 18:00,Sensation Kotwica Kołobrzeg(d),95 : 92W,95,22,40,55.0,8,28,28.6,30,68,44.1,27,34,79.4,16,32,48,25,18,22,14,7,2,1,118,Górnik Trans.eu Wałbrzych,Sezon 2021/2022
2022-05-14 17:30,Rawlplug Sokół Łańcut(w),114 : 77P,77,23,51,45.1,6,21,28.6,29,72,40.3,13,22,59.1,15,19,34,15,25,21,12,3,2,5,67,Górnik Trans.eu Wałbrzych,Sezon 2021/2022
2022-05-15 17:30,Rawlplug Sokół Łańcut(w),78 : 88W,88,21,40,52.5,10,19,52.6,31,59,52.5,16,29,55.2,6,29,35,18,29,26,18,5,6,3,93,Górnik Trans.eu Wałbrzych,Sezon 2021/2022
2022-05-21 18:00,Rawlplug Sokół Łańcut(d),73 : 75P,73,24,50,48.0,4,14,28.6,28,64,43.8,13,24,54.2,8,28,36,11,22,17,10,7,0,1,70,Górnik Trans.eu Wałbrzych,Sezon 2021/2022
2022-05-22 18:00,Rawlplug Sokół Łańcut(d),86 : 94P,86,21,39,53.8,11,33,33.3,32,72,44.4,11,14,78.6,15,21,36,15,19,16,13,8,4,1,93,Górnik Trans.eu Wałbrzych,Sezon 2021/2022
2021-09-24 17:00,AZS UMCS Start II Lublin(w),88 : 80P,80,23,38,60.5,6,27,22.2,29,65,44.6,16,19,84.2,6,24,30,16,17,19,14,4,2,3,79,KS Księżak Łowicz,Sezon 2021/2022
2021-10-02 18:00,Weegree AZS Politechnika Opolska(d),77 : 95P,77,27,45,60.0,3,14,21.4,30,59,50.8,14,19,73.7,3,17,20,14,22,21,9,8,1,1,77,KS Księżak Łowicz,Sezon 2021/2022
2021-10-09 18:00,Dziki Warszawa(w),101 : 60P,60,12,30,40.0,8,25,32.0,20,55,36.4,12,24,50.0,5,21,26,14,15,18,19,7,1,1,42,KS Księżak Łowicz,Sezon 2021/2022
2021-10-16 18:00,WKK Wrocław(w),103 : 95P,95,22,43,51.2,12,28,42.9,34,71,47.9,15,17,88.2,8,19,27,21,19,19,15,7,3,6,99,KS Księżak Łowicz,Sezon 2021/2022
2021-10-20 19:00,SKS Starogard Gdański(d),95 : 104P,95,23,36,63.9,8,22,36.4,31,58,53.4,25,26,96.2,3,19,22,17,20,21,15,9,0,1,100,KS Księżak Łowicz,Sezon 2021/2022
2021-10-24 17:00,Znicz Basket Pruszków(w),56 : 70W,70,17,33,51.5,8,29,27.6,25,62,40.3,12,18,66.7,9,33,42,11,18,21,14,7,1,2,74,KS Księżak Łowicz,Sezon 2021/2022
2021-10-31 17:00,TBS Śląsk II Wrocław(d),95 : 81W,95,22,34,64.7,9,23,39.1,31,57,54.4,24,29,82.8,5,26,31,17,21,25,15,8,0,1,105,KS Księżak Łowicz,Sezon 2021/2022
2021-11-06 17:30,Rawlplug Sokół Łańcut(w),77 : 69P,69,15,32,46.9,10,28,35.7,25,60,41.7,9,16,56.3,8,20,28,17,9,20,18,7,0,7,61,KS Księżak Łowicz,Sezon 2021/2022
2021-11-13 18:00,GKS Tychy(d),78 : 81P,78,28,37,75.7,5,22,22.7,33,59,55.9,7,12,58.3,4,23,27,20,22,20,12,5,1,0,88,KS Księżak Łowicz,Sezon 2021/2022
2021-11-20 16:00,Górnik Trans.eu Wałbrzych(d),95 : 87W,95,22,38,57.9,9,22,40.9,31,60,51.7,24,28,85.7,12,31,43,22,22,30,24,3,1,1,107,KS Księżak Łowicz,Sezon 2021/2022
2021-11-27 18:00,Sensation Kotwica Kołobrzeg(w),104 : 73P,73,17,38,44.7,7,25,28.0,24,63,38.1,18,27,66.7,9,21,30,13,19,24,15,4,1,4,58,KS Księżak Łowicz,Sezon 2021/2022
2021-12-04 16:00,AZS AGH Kraków(d),90 : 99P,90,27,37,73.0,6,18,33.3,33,55,60.0,18,23,78.3,4,21,25,18,24,25,19,3,2,1,92,KS Księżak Łowicz,Sezon 2021/2022
2021-12-11 17:00,MKKS Żak Koszalin(d),84 : 85P,84,19,40,47.5,10,25,40.0,29,65,44.6,16,19,84.2,8,27,35,18,21,18,17,6,1,2,88,KS Księżak Łowicz,Sezon 2021/2022
2021-12-15 18:00,PGE Turów Zgorzelec(d),97 : 76W,97,24,40,60.0,10,31,32.3,34,71,47.9,19,21,90.5,10,29,39,16,29,21,16,10,1,1,108,KS Księżak Łowicz,Sezon 2021/2022
2021-12-18 17:00,Decka Pelplin(w),80 : 63P,63,15,34,44.1,8,28,28.6,23,62,37.1,9,11,81.8,5,19,24,12,14,20,14,8,1,3,53,KS Księżak Łowicz,Sezon 2021/2022
2021-12-30 18:00,Miasto Szkła Krosno(d),84 : 79W,84,18,40,45.0,11,26,42.3,29,66,43.9,15,17,88.2,12,18,30,19,24,25,19,9,1,2,85,KS Księżak Łowicz,Sezon 2021/2022
2022-01-08 16:00,AZS UMCS Start II Lublin(d),82 : 87P,82,18,29,62.1,10,29,34.5,28,58,48.3,16,19,84.2,6,29,35,19,22,17,17,6,1,2,93,KS Księżak Łowicz,Sezon 2021/2022
2022-01-15 17:00,Weegree AZS Politechnika Opolska(w),96 : 77P,77,19,35,54.3,7,26,26.9,26,61,42.6,18,26,69.2,9,28,37,19,32,26,15,4,1,3,80,KS Księżak Łowicz,Sezon 2021/2022
2022-01-22 18:00,Dziki Warszawa(d),73 : 77P,73,8,26,30.8,13,26,50.0,21,52,40.4,18,26,69.2,6,28,34,14,24,24,15,6,2,1,75,KS Księżak Łowicz,Sezon 2021/2022
2022-02-14 18:00,TBS Śląsk II Wrocław(w),96 : 86P,86,18,33,54.5,11,26,42.3,29,59,49.2,17,25,68.0,6,26,32,23,24,24,14,3,2,1,94,KS Księżak Łowicz,Sezon 2021/2022
2022-02-19 17:00,Rawlplug Sokół Łańcut(d),69 : 94P,69,21,33,63.6,2,20,10.0,23,53,43.4,21,29,72.4,8,23,31,11,17,23,20,6,1,3,60,KS Księżak Łowicz,Sezon 2021/2022
2022-02-26 18:00,GKS Tychy(w),87 : 99W,99,26,37,70.3,8,23,34.8,34,60,56.7,23,29,79.3,5,25,30,21,24,29,19,5,1,1,105,KS Księżak Łowicz,Sezon 2021/2022
2022-03-05 17:00,Górnik Trans.eu Wałbrzych(w),85 : 78P,78,23,46,50.0,5,25,20.0,28,71,39.4,17,22,77.3,13,24,37,14,24,16,13,4,2,3,74,KS Księżak Łowicz,Sezon 2021/2022
2022-03-09 18:00,WKK Wrocław(d),88 : 94P,88,27,42,64.3,6,21,28.6,33,63,52.4,16,28,57.1,9,17,26,13,25,25,7,4,1,0,83,KS Księżak Łowicz,Sezon 2021/2022
2022-03-12 17:00,Sensation Kotwica Kołobrzeg(d),104 : 82W,104,23,37,62.2,14,31,45.2,37,68,54.4,16,21,76.2,3,28,31,25,22,21,9,8,0,2,123,KS Księżak Łowicz,Sezon 2021/2022
2022-03-16 19:00,Znicz Basket Pruszków(d),86 : 91P,86,18,29,62.1,9,29,31.0,27,58,46.6,23,28,82.1,7,23,30,16,25,22,20,5,1,1,82,KS Księżak Łowicz,Sezon 2021/2022
2022-03-19 18:00,AZS AGH Kraków(w),122 : 91P,91,23,42,54.8,8,18,44.4,31,60,51.7,21,28,75.0,9,19,28,16,21,25,21,8,1,2,87,KS Księżak Łowicz,Sezon 2021/2022
2022-03-23 19:00,SKS Starogard Gdański(w),79 : 67P,67,19,37,51.4,5,24,20.8,24,61,39.3,14,21,66.7,5,30,35,16,18,16,10,4,0,2,68,KS Księżak Łowicz,Sezon 2021/2022
2022-03-27 17:00,MKKS Żak Koszalin(w),75 : 70P,70,20,34,58.8,8,31,25.8,28,65,43.1,6,12,50.0,8,29,37,18,19,20,20,2,2,2,66,KS Księżak Łowicz,Sezon 2021/2022
2022-03-30 19:00,PGE Turów Zgorzelec(w),97 : 90P,90,23,36,63.9,8,28,28.6,31,64,48.4,20,23,87.0,6,24,30,18,19,19,15,6,1,0,94,KS Księżak Łowicz,Sezon 2021/2022
2022-04-03 16:00,Decka Pelplin(d),105 : 101W,105,26,41,63.4,10,24,41.7,36,65,55.4,23,28,82.1,7,24,31,18,17,26,13,10,2,1,119,KS Księżak Łowicz,Sezon 2021/2022
2022-04-10 18:00,Miasto Szkła Krosno(w),101 : 77P,77,19,37,51.4,10,24,41.7,29,61,47.5,9,13,69.2,3,27,30,20,20,11,17,6,3,3,83,KS Księżak Łowicz,Sezon 2021/2022
2021-09-25 17:00,SKS Starogard Gdański(d),74 : 85P,74,19,40,47.5,7,26,26.9,26,66,39.4,15,20,75.0,11,22,33,11,26,19,18,14,4,3,73,Miasto Szkła Krosno,Sezon 2021/2022
2021-10-02 20:00,Znicz Basket Pruszków(d),79 : 70W,79,18,37,48.6,12,29,41.4,30,66,45.5,7,13,53.8,9,28,37,21,20,16,12,11,1,4,95,Miasto Szkła Krosno,Sezon 2021/2022
2021-10-09 16:00,TBS Śląsk II Wrocław(d),101 : 87W,101,25,41,61.0,9,27,33.3,34,68,50.0,24,28,85.7,8,28,36,20,24,25,14,8,3,1,116,Miasto Szkła Krosno,Sezon 2021/2022
2021-10-16 17:30,Rawlplug Sokół Łańcut(w),70 : 65P,65,7,31,22.6,11,32,34.4,18,63,28.6,18,21,85.7,12,27,39,8,20,20,11,8,2,4,63,Miasto Szkła Krosno,Sezon 2021/2022
2021-10-20 18:00,GKS Tychy(d),70 : 74P,70,13,28,46.4,10,37,27.0,23,65,35.4,14,24,58.3,11,23,34,16,22,22,12,6,3,1,65,Miasto Szkła Krosno,Sezon 2021/2022
2021-10-30 17:00,Górnik Trans.eu Wałbrzych(d),77 : 78P,77,26,42,61.9,3,15,20.0,29,57,50.9,16,26,61.5,11,34,45,16,21,23,15,3,3,0,91,Miasto Szkła Krosno,Sezon 2021/2022
2021-11-06 18:00,Sensation Kotwica Kołobrzeg(w),89 : 62P,62,15,37,40.5,8,24,33.3,23,61,37.7,8,12,66.7,9,22,31,9,20,18,22,8,3,2,49,Miasto Szkła Krosno,Sezon 2021/2022
2021-11-13 17:00,AZS AGH Kraków(d),74 : 78P,74,25,44,56.8,2,13,15.4,27,57,47.4,18,24,75.0,7,21,28,17,28,24,14,8,2,0,79,Miasto Szkła Krosno,Sezon 2021/2022
2021-11-17 18:00,MKKS Żak Koszalin(w),58 : 79W,79,20,30,66.7,8,26,30.8,28,56,50.0,15,21,71.4,8,28,36,17,19,21,18,8,2,2,90,Miasto Szkła Krosno,Sezon 2021/2022
2021-11-21 17:00,PGE Turów Zgorzelec(d),87 : 68W,87,28,44,63.6,7,21,33.3,35,65,53.8,10,15,66.7,14,27,41,26,17,16,19,10,5,0,115,Miasto Szkła Krosno,Sezon 2021/2022
2021-11-27 17:00,Decka Pelplin(w),78 : 70P,70,23,40,57.5,4,25,16.0,27,65,41.5,12,20,60.0,8,25,33,18,23,17,15,7,4,4,71,Miasto Szkła Krosno,Sezon 2021/2022
2021-12-04 17:00,WKK Wrocław(d),91 : 68W,91,25,40,62.5,9,25,36.0,34,65,52.3,14,21,66.7,12,24,36,21,19,17,12,10,1,1,109,Miasto Szkła Krosno,Sezon 2021/2022
2021-12-11 17:00,AZS UMCS Start II Lublin(d),92 : 81W,92,24,41,58.5,11,28,39.3,35,69,50.7,11,20,55.0,13,20,33,22,18,20,13,7,4,0,102,Miasto Szkła Krosno,Sezon 2021/2022
2021-12-15 18:00,Weegree AZS Politechnika Opolska(w),72 : 61P,61,22,44,50.0,3,16,18.8,25,60,41.7,8,11,72.7,6,22,28,20,23,14,13,3,5,2,66,Miasto Szkła Krosno,Sezon 2021/2022
2021-12-19 17:00,Dziki Warszawa(d),80 : 79W,80,21,34,61.8,10,30,33.3,31,64,48.4,8,15,53.3,10,23,33,17,23,23,11,6,5,1,90,Miasto Szkła Krosno,Sezon 2021/2022
2021-12-30 18:00,KS Księżak Łowicz(w),84 : 79P,79,21,40,52.5,5,18,27.8,26,58,44.8,22,32,68.8,9,23,32,10,25,23,15,6,2,1,72,Miasto Szkła Krosno,Sezon 2021/2022
2022-01-08 18:00,SKS Starogard Gdański(w),72 : 76W,76,15,36,41.7,11,19,57.9,26,55,47.3,13,24,54.2,8,28,36,16,22,19,24,8,4,6,76,Miasto Szkła Krosno,Sezon 2021/2022
2022-01-15 18:00,Znicz Basket Pruszków(w),86 : 79P,79,19,35,54.3,7,21,33.3,26,56,46.4,20,32,62.5,11,20,31,15,26,24,12,7,1,1,79,Miasto Szkła Krosno,Sezon 2021/2022
2022-02-02 18:00,GKS Tychy(w),89 : 71P,71,20,42,47.6,8,18,44.4,28,60,46.7,7,19,36.8,7,19,26,20,25,20,15,6,3,4,67,Miasto Szkła Krosno,Sezon 2021/2022
2022-02-12 17:00,Górnik Trans.eu Wałbrzych(w),78 : 79W,79,25,48,52.1,6,20,30.0,31,68,45.6,11,20,55.0,15,34,49,22,24,18,17,5,3,4,95,Miasto Szkła Krosno,Sezon 2021/2022
2022-02-16 18:00,Rawlplug Sokół Łańcut(d),90 : 100P,90,22,45,48.9,9,24,37.5,31,69,44.9,19,27,70.4,16,22,38,15,26,22,20,8,1,1,86,Miasto Szkła Krosno,Sezon 2021/2022
2022-02-19 17:00,Sensation Kotwica Kołobrzeg(d),73 : 84P,73,17,41,41.5,11,29,37.9,28,70,40.0,6,15,40.0,9,26,35,16,25,23,12,4,4,3,69,Miasto Szkła Krosno,Sezon 2021/2022
2022-02-22 19:00,TBS Śląsk II Wrocław(w),82 : 83W,83,24,40,60.0,7,15,46.7,31,55,56.4,14,21,66.7,7,25,32,15,23,23,19,3,2,2,85,Miasto Szkła Krosno,Sezon 2021/2022
2022-02-26 18:30,AZS AGH Kraków(w),76 : 64P,64,17,36,47.2,5,16,31.3,22,52,42.3,15,28,53.6,7,29,36,10,20,26,21,5,5,3,56,Miasto Szkła Krosno,Sezon 2021/2022
2022-03-02 18:00,MKKS Żak Koszalin(d),64 : 82P,64,19,33,57.6,6,20,30.0,25,53,47.2,8,11,72.7,5,17,22,10,13,16,19,4,2,3,52,Miasto Szkła Krosno,Sezon 2021/2022
2022-03-06 18:00,PGE Turów Zgorzelec(w),104 : 94P,94,22,44,50.0,12,23,52.2,34,67,50.7,14,18,77.8,9,24,33,17,23,18,13,6,1,0,101,Miasto Szkła Krosno,Sezon 2021/2022
2022-03-12 17:00,Decka Pelplin(d),81 : 87P,81,24,44,54.5,7,20,35.0,31,64,48.4,12,19,63.2,12,18,30,16,22,21,14,8,4,2,85,Miasto Szkła Krosno,Sezon 2021/2022
2022-03-19 18:00,WKK Wrocław(w),83 : 87W,87,22,42,52.4,7,21,33.3,29,63,46.0,22,28,78.6,5,25,30,21,24,23,8,11,3,6,104,Miasto Szkła Krosno,Sezon 2021/2022
2022-03-26 14:00,AZS UMCS Start II Lublin(w),72 : 110W,110,25,36,69.4,16,28,57.1,41,64,64.1,12,17,70.6,8,34,42,32,21,19,13,4,7,0,154,Miasto Szkła Krosno,Sezon 2021/2022
2022-03-30 18:00,Weegree AZS Politechnika Opolska(d),73 : 68W,73,20,36,55.6,8,23,34.8,28,59,47.5,9,15,60.0,6,33,39,17,21,14,13,4,5,0,88,Miasto Szkła Krosno,Sezon 2021/2022
2022-04-02 18:00,Dziki Warszawa(w),66 : 52P,52,9,37,24.3,7,23,30.4,16,60,26.7,13,19,68.4,8,27,35,17,16,22,13,8,1,8,50,Miasto Szkła Krosno,Sezon 2021/2022
2022-04-10 18:00,KS Księżak Łowicz(d),101 : 77W,101,26,43,60.5,11,30,36.7,37,73,50.7,16,24,66.7,12,29,41,26,11,20,9,9,3,3,127,Miasto Szkła Krosno,Sezon 2021/2022
2021-09-25 13:00,Rawlplug Sokół Łańcut(d),69 : 79P,69,20,41,48.8,6,19,31.6,26,60,43.3,11,14,78.6,7,26,33,17,19,16,12,3,1,2,74,MKKS Żak Koszalin,Sezon 2021/2022
2021-10-02 18:00,GKS Tychy(w),85 : 84P,84,19,40,47.5,7,16,43.8,26,56,46.4,25,32,78.1,8,26,34,16,23,28,12,8,3,2,96,MKKS Żak Koszalin,Sezon 2021/2022
2021-10-16 13:00,Górnik Trans.eu Wałbrzych(d),71 : 90P,71,19,38,50.0,6,22,27.3,25,60,41.7,15,24,62.5,14,24,38,13,16,21,17,3,1,2,65,MKKS Żak Koszalin,Sezon 2021/2022
2021-10-20 18:00,Sensation Kotwica Kołobrzeg(d),64 : 80P,64,15,34,44.1,6,30,20.0,21,64,32.8,16,20,80.0,14,23,37,12,12,19,17,6,1,1,56,MKKS Żak Koszalin,Sezon 2021/2022
2021-10-23 18:00,AZS AGH Kraków(w),66 : 50P,50,12,30,40.0,4,17,23.5,16,47,34.0,14,23,60.9,6,20,26,13,14,20,23,8,0,0,34,MKKS Żak Koszalin,Sezon 2021/2022
2021-10-30 17:00,WKK Wrocław(d),77 : 65W,77,26,42,61.9,5,23,21.7,31,65,47.7,10,19,52.6,12,30,42,17,18,18,18,6,4,2,85,MKKS Żak Koszalin,Sezon 2021/2022
2021-11-06 17:00,PGE Turów Zgorzelec(d),72 : 64W,72,29,52,55.8,3,25,12.0,32,77,41.6,5,8,62.5,16,31,47,25,23,14,10,8,2,1,96,MKKS Żak Koszalin,Sezon 2021/2022
2021-11-13 17:00,Decka Pelplin(w),73 : 81W,81,22,41,53.7,7,18,38.9,29,59,49.2,16,27,59.3,9,23,32,15,17,25,14,10,4,1,87,MKKS Żak Koszalin,Sezon 2021/2022
2021-11-17 18:00,Miasto Szkła Krosno(d),58 : 79P,58,17,45,37.8,4,19,21.1,21,64,32.8,12,14,85.7,9,18,27,8,21,19,17,10,2,2,43,MKKS Żak Koszalin,Sezon 2021/2022
2021-11-20 15:00,AZS UMCS Start II Lublin(w),95 : 84P,84,31,55,56.4,2,22,9.1,33,77,42.9,16,23,69.6,22,22,44,16,25,20,11,6,5,2,93,MKKS Żak Koszalin,Sezon 2021/2022
2021-11-27 17:30,Weegree AZS Politechnika Opolska(w),88 : 76P,76,24,46,52.2,8,31,25.8,32,77,41.6,4,8,50.0,10,21,31,16,22,12,12,9,5,4,76,MKKS Żak Koszalin,Sezon 2021/2022
2021-12-04 18:00,Dziki Warszawa(w),74 : 87W,87,19,38,50.0,12,25,48.0,31,63,49.2,13,24,54.2,10,27,37,22,19,16,14,9,4,2,102,MKKS Żak Koszalin,Sezon 2021/2022
2021-12-11 17:00,KS Księżak Łowicz(w),84 : 85W,85,23,44,52.3,7,21,33.3,30,65,46.2,18,24,75.0,7,24,31,12,18,21,11,9,2,1,87,MKKS Żak Koszalin,Sezon 2021/2022
2021-12-15 19:00,SKS Starogard Gdański(w),75 : 82W,82,22,34,64.7,9,22,40.9,31,56,55.4,11,14,78.6,5,27,32,18,15,16,17,10,2,3,99,MKKS Żak Koszalin,Sezon 2021/2022
2021-12-19 17:00,Znicz Basket Pruszków(d),80 : 71W,80,28,46,60.9,4,19,21.1,32,65,49.2,12,19,63.2,6,29,35,21,20,20,10,5,3,2,94,MKKS Żak Koszalin,Sezon 2021/2022
2022-01-08 17:30,Rawlplug Sokół Łańcut(w),96 : 79P,79,21,46,45.7,9,20,45.0,30,66,45.5,10,15,66.7,8,21,29,18,16,14,12,7,0,1,80,MKKS Żak Koszalin,Sezon 2021/2022
2022-01-15 17:00,GKS Tychy(d),94 : 93W,94,26,43,60.5,9,27,33.3,35,70,50.0,15,25,60.0,10,24,34,26,23,25,16,8,4,1,105,MKKS Żak Koszalin,Sezon 2021/2022
2022-01-29 17:30,Górnik Trans.eu Wałbrzych(w),82 : 74P,74,22,41,53.7,5,18,27.8,27,59,45.8,15,26,57.7,8,20,28,17,17,22,9,9,2,4,78,MKKS Żak Koszalin,Sezon 2021/2022
2022-02-02 19:00,Sensation Kotwica Kołobrzeg(w),92 : 77P,77,12,32,37.5,10,23,43.5,22,55,40.0,23,33,69.7,9,22,31,13,21,21,11,6,3,2,76,MKKS Żak Koszalin,Sezon 2021/2022
2022-02-05 13:00,AZS AGH Kraków(d),98 : 100P,98,24,49,49.0,10,25,40.0,34,74,45.9,20,28,71.4,16,29,45,18,24,22,22,11,1,1,103,MKKS Żak Koszalin,Sezon 2021/2022
2022-02-10 18:00,TBS Śląsk II Wrocław(w),61 : 69W,69,21,43,48.8,6,22,27.3,27,65,41.5,9,15,60.0,10,31,41,18,17,18,16,11,3,3,82,MKKS Żak Koszalin,Sezon 2021/2022
2022-02-12 18:00,WKK Wrocław(w),79 : 70P,70,23,48,47.9,4,17,23.5,27,65,41.5,12,19,63.2,9,25,34,15,17,18,10,9,5,2,78,MKKS Żak Koszalin,Sezon 2021/2022
2022-02-19 18:00,PGE Turów Zgorzelec(w),86 : 73P,73,21,43,48.8,6,23,26.1,27,66,40.9,13,19,68.4,11,26,37,15,22,21,13,8,5,0,80,MKKS Żak Koszalin,Sezon 2021/2022
2022-02-26 17:00,Decka Pelplin(d),62 : 76P,62,16,34,47.1,6,23,26.1,22,57,38.6,12,14,85.7,4,18,22,18,15,17,13,7,4,5,63,MKKS Żak Koszalin,Sezon 2021/2022
2022-03-02 18:00,Miasto Szkła Krosno(w),64 : 82W,82,29,50,58.0,6,18,33.3,35,68,51.5,6,7,85.7,13,23,36,20,16,13,12,10,3,2,105,MKKS Żak Koszalin,Sezon 2021/2022
2022-03-05 17:00,AZS UMCS Start II Lublin(d),68 : 81P,68,21,51,41.2,4,17,23.5,25,68,36.8,14,18,77.8,13,22,35,18,22,21,16,7,4,1,69,MKKS Żak Koszalin,Sezon 2021/2022
2022-03-12 17:00,Weegree AZS Politechnika Opolska(d),58 : 72P,58,17,45,37.8,5,20,25.0,22,65,33.8,9,14,64.3,11,29,40,14,16,19,15,6,2,2,57,MKKS Żak Koszalin,Sezon 2021/2022
2022-03-20 17:00,Dziki Warszawa(d),73 : 88P,73,18,40,45.0,7,18,38.9,25,58,43.1,16,21,76.2,10,21,31,14,20,21,16,9,5,1,78,MKKS Żak Koszalin,Sezon 2021/2022
2022-03-27 17:00,KS Księżak Łowicz(d),75 : 70W,75,25,55,45.5,7,23,30.4,32,78,41.0,4,15,26.7,15,30,45,17,20,19,13,8,2,2,77,MKKS Żak Koszalin,Sezon 2021/2022
2022-03-30 18:00,SKS Starogard Gdański(d),71 : 49W,71,23,45,51.1,5,17,29.4,28,62,45.2,10,15,66.7,12,32,44,17,21,17,18,10,8,3,93,MKKS Żak Koszalin,Sezon 2021/2022
2022-04-03 17:00,Znicz Basket Pruszków(w),70 : 101W,101,31,45,68.9,9,21,42.9,40,66,60.6,12,16,75.0,9,26,35,19,18,14,16,9,3,2,121,MKKS Żak Koszalin,Sezon 2021/2022
2022-04-10 18:00,TBS Śląsk II Wrocław(d),84 : 80W,84,23,46,50.0,7,21,33.3,30,67,44.8,17,30,56.7,13,36,49,19,21,22,14,6,0,1,94,MKKS Żak Koszalin,Sezon 2021/2022
2021-09-27 19:00,TBS Śląsk II Wrocław(w),142 : 54P,54,10,40,25.0,8,18,44.4,18,58,31.0,10,20,50.0,5,14,19,11,13,19,29,8,2,3,15,PGE Turów Zgorzelec,Sezon 2021/2022
2021-10-02 18:00,Rawlplug Sokół Łańcut(d),77 : 101P,77,17,34,50.0,11,31,35.5,28,65,43.1,10,18,55.6,6,15,21,16,15,21,10,6,2,3,67,PGE Turów Zgorzelec,Sezon 2021/2022
2021-10-09 19:00,GKS Tychy(w),114 : 77P,77,16,39,41.0,7,21,33.3,23,60,38.3,24,30,80.0,9,18,27,8,17,27,22,5,2,2,54,PGE Turów Zgorzelec,Sezon 2021/2022
2021-10-20 19:00,Górnik Trans.eu Wałbrzych(d),60 : 97P,60,21,45,46.7,3,25,12.0,24,70,34.3,9,17,52.9,11,22,33,13,13,24,16,7,1,6,44,PGE Turów Zgorzelec,Sezon 2021/2022
2021-10-23 18:00,Sensation Kotwica Kołobrzeg(w),124 : 54P,54,10,29,34.5,8,27,29.6,18,56,32.1,10,23,43.5,3,23,26,10,18,18,30,5,2,2,16,PGE Turów Zgorzelec,Sezon 2021/2022
2021-10-30 18:00,AZS AGH Kraków(d),67 : 85P,67,12,30,40.0,9,20,45.0,21,50,42.0,16,31,51.6,4,19,23,12,20,29,18,12,1,2,53,PGE Turów Zgorzelec,Sezon 2021/2022
2021-11-06 17:00,MKKS Żak Koszalin(w),72 : 64P,64,12,22,54.5,8,31,25.8,20,53,37.7,16,28,57.1,4,26,30,17,14,22,13,4,1,2,58,PGE Turów Zgorzelec,Sezon 2021/2022
2021-11-14 16:00,WKK Wrocław(d),66 : 77P,66,12,28,42.9,10,34,29.4,22,62,35.5,12,18,66.7,8,26,34,17,20,20,17,8,0,2,62,PGE Turów Zgorzelec,Sezon 2021/2022
2021-11-17 19:00,Decka Pelplin(d),73 : 90P,73,15,33,45.5,9,28,32.1,24,61,39.3,16,25,64.0,4,16,20,21,14,24,12,11,1,3,68,PGE Turów Zgorzelec,Sezon 2021/2022
2021-11-21 17:00,Miasto Szkła Krosno(w),87 : 68P,68,20,41,48.8,7,24,29.2,27,65,41.5,7,12,58.3,10,12,22,15,16,17,19,9,0,5,52,PGE Turów Zgorzelec,Sezon 2021/2022
2021-11-27 18:00,AZS UMCS Start II Lublin(d),80 : 75W,80,18,37,48.6,6,27,22.2,24,64,37.5,26,29,89.7,8,30,38,16,21,28,13,4,4,2,86,PGE Turów Zgorzelec,Sezon 2021/2022
2021-12-04 17:30,Weegree AZS Politechnika Opolska(w),99 : 68P,68,19,48,39.6,5,21,23.8,24,69,34.8,15,19,78.9,11,22,33,16,20,18,13,8,0,4,63,PGE Turów Zgorzelec,Sezon 2021/2022
2021-12-11 18:00,Dziki Warszawa(w),79 : 50P,50,16,33,48.5,3,23,13.0,19,56,33.9,9,19,47.4,8,26,34,17,16,21,22,6,1,2,39,PGE Turów Zgorzelec,Sezon 2021/2022
2021-12-15 18:00,KS Księżak Łowicz(w),97 : 76P,76,20,38,52.6,4,22,18.2,24,60,40.0,24,32,75.0,8,24,32,9,21,28,19,8,1,1,63,PGE Turów Zgorzelec,Sezon 2021/2022
2021-12-18 18:00,SKS Starogard Gdański(d),75 : 80P,75,22,48,45.8,6,20,30.0,28,68,41.2,13,23,56.5,15,21,36,18,19,20,14,6,0,6,71,PGE Turów Zgorzelec,Sezon 2021/2022
2022-01-09 15:00,TBS Śląsk II Wrocław(d),84 : 70W,84,20,35,57.1,11,26,42.3,31,61,50.8,11,18,61.1,7,23,30,22,23,20,15,6,3,0,93,PGE Turów Zgorzelec,Sezon 2021/2022
2022-01-15 17:30,Rawlplug Sokół Łańcut(w),83 : 75P,75,18,47,38.3,11,27,40.7,29,74,39.2,6,9,66.7,15,24,39,14,16,16,11,4,1,2,74,PGE Turów Zgorzelec,Sezon 2021/2022
2022-01-23 17:00,GKS Tychy(d),98 : 100P,98,22,35,62.9,13,32,40.6,35,67,52.2,15,22,68.2,6,26,32,26,23,24,13,8,0,1,112,PGE Turów Zgorzelec,Sezon 2021/2022
2022-02-02 18:00,Górnik Trans.eu Wałbrzych(w),70 : 68P,68,17,46,37.0,8,25,32.0,25,71,35.2,10,18,55.6,12,32,44,16,29,22,21,7,0,6,60,PGE Turów Zgorzelec,Sezon 2021/2022
2022-02-06 17:00,Sensation Kotwica Kołobrzeg(d),54 : 92P,54,19,46,41.3,2,23,8.7,21,69,30.4,10,13,76.9,13,22,35,10,24,18,19,7,1,4,37,PGE Turów Zgorzelec,Sezon 2021/2022
2022-02-12 18:00,AZS AGH Kraków(w),83 : 78P,78,25,47,53.2,5,15,33.3,30,62,48.4,13,24,54.2,15,30,45,20,18,28,18,10,2,3,94,PGE Turów Zgorzelec,Sezon 2021/2022
2022-02-19 18:00,MKKS Żak Koszalin(d),86 : 73W,86,17,34,50.0,12,30,40.0,29,64,45.3,16,22,72.7,11,26,37,23,23,21,13,5,0,5,97,PGE Turów Zgorzelec,Sezon 2021/2022
2022-02-26 18:00,WKK Wrocław(w),85 : 79P,79,18,36,50.0,11,27,40.7,29,63,46.0,10,16,62.5,4,30,34,19,26,19,15,2,4,1,83,PGE Turów Zgorzelec,Sezon 2021/2022
2022-03-02 18:00,Decka Pelplin(w),65 : 71W,71,15,31,48.4,10,23,43.5,25,54,46.3,11,23,47.8,8,29,37,16,13,25,15,8,4,4,80,PGE Turów Zgorzelec,Sezon 2021/2022
2022-03-06 18:00,Miasto Szkła Krosno(d),104 : 94W,104,19,33,57.6,14,33,42.4,33,66,50.0,24,36,66.7,12,21,33,22,18,23,10,10,0,1,114,PGE Turów Zgorzelec,Sezon 2021/2022
2022-03-11 19:00,Znicz Basket Pruszków(w),94 : 95W,95,29,45,64.4,9,24,37.5,38,69,55.1,10,17,58.8,9,31,40,20,23,16,17,7,2,2,109,PGE Turów Zgorzelec,Sezon 2021/2022
2022-03-13 14:00,AZS UMCS Start II Lublin(w),99 : 82P,82,22,40,55.0,10,30,33.3,32,70,45.7,8,15,53.3,14,24,38,20,21,17,18,6,0,2,83,PGE Turów Zgorzelec,Sezon 2021/2022
2022-03-19 18:00,Weegree AZS Politechnika Opolska(d),91 : 77W,91,20,40,50.0,12,26,46.2,32,66,48.5,15,19,78.9,10,37,47,23,20,21,11,2,2,0,116,PGE Turów Zgorzelec,Sezon 2021/2022
2022-03-26 18:00,Dziki Warszawa(d),80 : 92P,80,17,32,53.1,10,22,45.5,27,54,50.0,16,24,66.7,5,16,21,18,14,22,13,7,1,3,79,PGE Turów Zgorzelec,Sezon 2021/2022
2022-03-30 19:00,KS Księżak Łowicz(d),97 : 90W,97,23,40,57.5,12,31,38.7,35,71,49.3,15,17,88.2,11,25,36,26,20,19,14,7,0,1,114,PGE Turów Zgorzelec,Sezon 2021/2022
2022-04-06 19:00,SKS Starogard Gdański(w),102 : 78P,78,25,53,47.2,7,22,31.8,32,75,42.7,7,17,41.2,12,22,34,11,16,15,12,8,2,3,68,PGE Turów Zgorzelec,Sezon 2021/2022
2022-04-10 18:00,Znicz Basket Pruszków(d),92 : 72W,92,23,38,60.5,10,24,41.7,33,62,53.2,16,26,61.5,6,38,44,27,19,26,12,8,3,2,123,PGE Turów Zgorzelec,Sezon 2021/2022
2021-09-25 13:00,MKKS Żak Koszalin(w),69 : 79W,79,18,34,52.9,8,28,28.6,26,62,41.9,19,25,76.0,9,24,33,13,16,19,10,7,2,1,82,Rawlplug Sokół Łańcut,Sezon 2021/2022
2021-10-02 18:00,PGE Turów Zgorzelec(w),77 : 101W,101,24,37,64.9,14,26,53.8,38,63,60.3,11,16,68.8,10,32,42,28,21,15,16,7,3,2,135,Rawlplug Sokół Łańcut,Sezon 2021/2022
2021-10-09 17:00,Decka Pelplin(w),79 : 91W,91,20,30,66.7,13,32,40.6,33,62,53.2,12,22,54.5,10,20,30,24,14,21,12,13,2,2,109,Rawlplug Sokół Łańcut,Sezon 2021/2022
2021-10-16 17:30,Miasto Szkła Krosno(d),70 : 65W,70,16,35,45.7,10,23,43.5,26,58,44.8,8,18,44.4,6,30,36,17,20,20,12,8,4,2,81,Rawlplug Sokół Łańcut,Sezon 2021/2022
2021-10-20 18:00,AZS UMCS Start II Lublin(d),83 : 69W,83,15,32,46.9,15,35,42.9,30,67,44.8,8,13,61.5,8,32,40,19,18,19,14,11,3,1,100,Rawlplug Sokół Łańcut,Sezon 2021/2022
2021-10-23 17:30,Weegree AZS Politechnika Opolska(d),78 : 73W,78,15,28,53.6,10,26,38.5,25,54,46.3,18,23,78.3,8,24,32,20,22,21,13,6,2,1,91,Rawlplug Sokół Łańcut,Sezon 2021/2022
2021-10-30 18:00,Dziki Warszawa(w),58 : 71W,71,23,33,69.7,6,29,20.7,29,62,46.8,7,9,77.8,6,29,35,23,20,17,14,7,1,1,88,Rawlplug Sokół Łańcut,Sezon 2021/2022
2021-11-06 17:30,KS Księżak Łowicz(d),77 : 69W,77,25,44,56.8,8,31,25.8,33,75,44.0,3,4,75.0,16,27,43,23,20,9,17,13,7,0,103,Rawlplug Sokół Łańcut,Sezon 2021/2022
2021-11-13 18:00,SKS Starogard Gdański(w),98 : 112W,112,26,41,63.4,13,28,46.4,39,69,56.5,21,25,84.0,7,23,30,20,18,21,14,8,5,6,127,Rawlplug Sokół Łańcut,Sezon 2021/2022
2021-11-17 18:00,Znicz Basket Pruszków(d),86 : 96P,86,19,31,61.3,12,35,34.3,31,66,47.0,12,17,70.6,10,25,35,21,25,18,16,9,3,0,98,Rawlplug Sokół Łańcut,Sezon 2021/2022
2021-11-24 18:00,TBS Śląsk II Wrocław(w),84 : 74P,74,17,46,37.0,5,26,19.2,22,72,30.6,25,27,92.6,15,20,35,15,28,27,19,6,5,4,64,Rawlplug Sokół Łańcut,Sezon 2021/2022
2021-11-26 18:00,WKK Wrocław(w),91 : 94W,94,21,36,58.3,11,34,32.4,32,70,45.7,19,23,82.6,10,28,38,20,22,24,15,6,4,0,105,Rawlplug Sokół Łańcut,Sezon 2021/2022
2021-12-04 17:30,GKS Tychy(d),97 : 85W,97,15,28,53.6,18,27,66.7,33,55,60.0,13,19,68.4,6,23,29,28,15,21,17,9,7,1,125,Rawlplug Sokół Łańcut,Sezon 2021/2022
2021-12-15 18:00,Górnik Trans.eu Wałbrzych(d),101 : 76W,101,21,30,70.0,15,38,39.5,36,68,52.9,14,15,93.3,10,26,36,28,15,17,10,10,2,2,134,Rawlplug Sokół Łańcut,Sezon 2021/2022
2021-12-18 18:00,Sensation Kotwica Kołobrzeg(w),84 : 98W,98,19,35,54.3,16,31,51.6,35,66,53.0,12,15,80.0,4,28,32,17,13,18,13,5,2,0,107,Rawlplug Sokół Łańcut,Sezon 2021/2022
2021-12-30 18:00,AZS AGH Kraków(d),99 : 89W,99,19,34,55.9,12,25,48.0,31,59,52.5,25,29,86.2,5,36,41,24,20,24,15,9,2,1,128,Rawlplug Sokół Łańcut,Sezon 2021/2022
2022-01-08 17:30,MKKS Żak Koszalin(d),96 : 79W,96,18,25,72.0,15,35,42.9,33,60,55.0,15,18,83.3,5,29,34,31,15,16,13,6,1,0,125,Rawlplug Sokół Łańcut,Sezon 2021/2022
2022-01-15 17:30,PGE Turów Zgorzelec(d),83 : 75W,83,24,40,60.0,9,26,34.6,33,66,50.0,8,11,72.7,9,28,37,23,16,16,10,10,2,1,109,Rawlplug Sokół Łańcut,Sezon 2021/2022
2022-01-22 17:30,Decka Pelplin(d),86 : 80W,86,22,32,68.8,10,35,28.6,32,67,47.8,12,15,80.0,10,23,33,22,22,21,14,10,2,2,101,Rawlplug Sokół Łańcut,Sezon 2021/2022
2022-02-02 19:00,AZS UMCS Start II Lublin(w),90 : 75P,75,16,33,48.5,12,40,30.0,28,73,38.4,7,13,53.8,10,26,36,20,19,16,11,8,3,3,80,Rawlplug Sokół Łańcut,Sezon 2021/2022
2022-02-05 17:30,Weegree AZS Politechnika Opolska(w),83 : 81P,81,27,47,57.4,7,25,28.0,34,72,47.2,6,9,66.7,4,27,31,18,22,14,13,8,2,5,86,Rawlplug Sokół Łańcut,Sezon 2021/2022
2022-02-12 17:30,Dziki Warszawa(d),68 : 93P,68,17,24,70.8,7,26,26.9,24,50,48.0,13,23,56.5,6,16,22,17,11,21,17,8,3,0,65,Rawlplug Sokół Łańcut,Sezon 2021/2022
2022-02-16 18:00,Miasto Szkła Krosno(w),90 : 100W,100,19,31,61.3,13,31,41.9,32,62,51.6,23,28,82.1,5,22,27,19,22,26,16,7,1,1,103,Rawlplug Sokół Łańcut,Sezon 2021/2022
2022-02-19 17:00,KS Księżak Łowicz(w),69 : 94W,94,22,41,53.7,14,25,56.0,36,66,54.5,8,14,57.1,4,19,23,23,23,17,10,13,3,1,110,Rawlplug Sokół Łańcut,Sezon 2021/2022
2022-03-02 19:00,Znicz Basket Pruszków(w),67 : 84W,84,20,31,64.5,11,28,39.3,31,59,52.5,11,15,73.3,5,29,34,21,12,19,16,8,4,1,103,Rawlplug Sokół Łańcut,Sezon 2021/2022
2022-03-05 17:30,TBS Śląsk II Wrocław(d),109 : 102W,109,18,36,50.0,14,29,48.3,32,65,49.2,31,43,72.1,8,29,37,21,17,33,12,8,4,1,122,Rawlplug Sokół Łańcut,Sezon 2021/2022
2022-03-09 18:00,SKS Starogard Gdański(d),93 : 62W,93,25,43,58.1,13,27,48.1,38,70,54.3,4,5,80.0,8,34,42,23,21,14,16,13,1,1,123,Rawlplug Sokół Łańcut,Sezon 2021/2022
2022-03-12 17:30,WKK Wrocław(d),91 : 87W,91,19,35,54.3,16,36,44.4,35,71,49.3,5,8,62.5,8,20,28,30,17,16,13,10,4,2,111,Rawlplug Sokół Łańcut,Sezon 2021/2022
2022-03-20 18:00,GKS Tychy(w),88 : 78P,78,18,30,60.0,9,29,31.0,27,59,45.8,15,17,88.2,8,22,30,21,23,23,20,6,3,2,84,Rawlplug Sokół Łańcut,Sezon 2021/2022
2022-03-30 19:00,Górnik Trans.eu Wałbrzych(w),85 : 91W,91,22,32,68.8,14,40,35.0,36,72,50.0,5,8,62.5,9,25,34,26,21,15,12,7,3,2,110,Rawlplug Sokół Łańcut,Sezon 2021/2022
2022-04-02 17:30,Sensation Kotwica Kołobrzeg(d),88 : 69W,88,19,34,55.9,10,24,41.7,29,58,50.0,20,24,83.3,6,28,34,27,10,18,11,9,5,1,119,Rawlplug Sokół Łańcut,Sezon 2021/2022
2022-04-10 18:00,AZS AGH Kraków(w),74 : 80W,80,15,27,55.6,11,27,40.7,26,54,48.1,17,26,65.4,5,32,37,22,20,24,23,5,3,1,87,Rawlplug Sokół Łańcut,Sezon 2021/2022
2022-04-19 18:00,Dziki Warszawa(d),83 : 80W,83,17,28,60.7,8,27,29.6,25,55,45.5,25,35,71.4,6,25,31,15,19,24,14,4,2,4,81,Rawlplug Sokół Łańcut,Sezon 2021/2022
2022-04-20 18:00,Dziki Warszawa(d),64 : 76P,64,13,26,50.0,7,34,20.6,20,60,33.3,17,19,89.5,6,25,31,13,23,22,21,10,7,2,62,Rawlplug Sokół Łańcut,Sezon 2021/2022
2022-04-23 15:00,Dziki Warszawa(w),85 : 58P,58,13,36,36.1,7,27,25.9,20,63,31.7,11,12,91.7,10,22,32,14,18,16,17,8,5,3,56,Rawlplug Sokół Łańcut,Sezon 2021/2022
2022-04-24 20:00,Dziki Warszawa(w),62 : 66W,66,15,35,42.9,8,20,40.0,23,55,41.8,12,18,66.7,2,32,34,18,21,21,16,8,2,0,74,Rawlplug Sokół Łańcut,Sezon 2021/2022
2022-04-27 18:00,Dziki Warszawa(d),92 : 54W,92,22,26,84.6,13,33,39.4,35,59,59.3,9,15,60.0,6,32,38,22,17,21,11,7,5,0,123,Rawlplug Sokół Łańcut,Sezon 2021/2022
2022-04-30 17:30,Weegree AZS Politechnika Opolska(d),67 : 63W,67,16,40,40.0,7,20,35.0,23,60,38.3,14,18,77.8,7,38,45,20,21,17,15,5,9,0,90,Rawlplug Sokół Łańcut,Sezon 2021/2022
2022-05-01 17:30,Weegree AZS Politechnika Opolska(d),86 : 76W,86,18,32,56.3,15,29,51.7,33,61,54.1,5,8,62.5,7,28,35,20,20,14,20,4,3,2,97,Rawlplug Sokół Łańcut,Sezon 2021/2022
2022-05-07 18:00,Weegree AZS Politechnika Opolska(w),87 : 93W,93,24,45,53.3,8,25,32.0,32,70,45.7,21,23,91.3,8,22,30,21,17,21,7,9,3,0,109,Rawlplug Sokół Łańcut,Sezon 2021/2022
2022-05-14 17:30,Górnik Trans.eu Wałbrzych(d),114 : 77W,114,21,34,61.8,16,30,53.3,37,64,57.8,24,30,80.0,8,31,39,28,21,24,11,5,5,2,147,Rawlplug Sokół Łańcut,Sezon 2021/2022
2022-05-15 17:30,Górnik Trans.eu Wałbrzych(d),78 : 88P,78,21,40,52.5,5,25,20.0,26,65,40.0,21,31,67.7,12,27,39,23,26,29,16,10,3,6,88,Rawlplug Sokół Łańcut,Sezon 2021/2022
2022-05-21 18:00,Górnik Trans.eu Wałbrzych(w),73 : 75W,75,18,31,58.1,9,34,26.5,27,65,41.5,12,14,85.7,8,24,32,16,19,22,16,6,1,0,74,Rawlplug Sokół Łańcut,Sezon 2021/2022
2022-05-22 18:00,Górnik Trans.eu Wałbrzych(w),86 : 94W,94,23,39,59.0,12,35,34.3,35,74,47.3,12,17,70.6,13,25,38,23,16,19,12,10,1,4,110,Rawlplug Sokół Łańcut,Sezon 2021/2022
2021-10-02 17:00,Górnik Trans.eu Wałbrzych(w),88 : 77P,77,15,29,51.7,11,31,35.5,26,60,43.3,14,18,77.8,3,27,30,12,24,21,8,5,2,4,80,Sensation Kotwica Kołobrzeg ,Sezon 2021/2022
2021-10-09 18:00,WKK Wrocław(d),76 : 66W,76,26,49,53.1,6,25,24.0,32,74,43.2,6,10,60.0,13,21,34,15,15,15,3,10,0,3,86,Sensation Kotwica Kołobrzeg ,Sezon 2021/2022
2021-10-16 18:00,AZS AGH Kraków(d),92 : 73W,92,21,34,61.8,12,26,46.2,33,60,55.0,14,23,60.9,9,26,35,20,28,24,24,11,2,0,100,Sensation Kotwica Kołobrzeg ,Sezon 2021/2022
2021-10-20 18:00,MKKS Żak Koszalin(w),64 : 80W,80,20,34,58.8,11,28,39.3,31,62,50.0,7,8,87.5,4,24,28,15,19,12,10,7,1,1,89,Sensation Kotwica Kołobrzeg ,Sezon 2021/2022
2021-10-23 18:00,PGE Turów Zgorzelec(d),124 : 54W,124,40,57,70.2,11,34,32.4,51,91,56.0,11,19,57.9,17,36,53,26,18,18,13,16,2,2,160,Sensation Kotwica Kołobrzeg ,Sezon 2021/2022
2021-10-30 17:00,Decka Pelplin(w),81 : 94W,94,16,30,53.3,15,38,39.5,31,68,45.6,17,26,65.4,10,28,38,18,18,24,7,6,3,1,106,Sensation Kotwica Kołobrzeg ,Sezon 2021/2022
2021-11-06 18:00,Miasto Szkła Krosno(d),89 : 62W,89,23,40,57.5,11,27,40.7,34,67,50.7,10,12,83.3,3,24,27,21,18,19,11,13,2,3,106,Sensation Kotwica Kołobrzeg ,Sezon 2021/2022
2021-11-14 18:00,AZS UMCS Start II Lublin(w),74 : 70P,70,21,42,50.0,5,27,18.5,26,69,37.7,13,16,81.3,10,25,35,16,24,18,6,5,1,5,75,Sensation Kotwica Kołobrzeg ,Sezon 2021/2022
2021-11-17 19:00,Weegree AZS Politechnika Opolska(d),87 : 68W,87,18,32,56.3,14,32,43.8,32,64,50.0,9,12,75.0,11,29,40,16,20,18,14,11,3,1,108,Sensation Kotwica Kołobrzeg ,Sezon 2021/2022
2021-11-20 18:00,Dziki Warszawa(w),66 : 83W,83,16,31,51.6,12,24,50.0,28,55,50.9,15,23,65.2,4,35,39,22,11,20,14,9,3,4,107,Sensation Kotwica Kołobrzeg ,Sezon 2021/2022
2021-11-27 18:00,KS Księżak Łowicz(d),104 : 73W,104,28,41,68.3,12,32,37.5,40,73,54.8,12,20,60.0,13,29,42,21,25,18,10,7,4,1,127,Sensation Kotwica Kołobrzeg ,Sezon 2021/2022
2021-12-03 19:00,SKS Starogard Gdański(w),68 : 89W,89,25,46,54.3,9,22,40.9,34,68,50.0,12,16,75.0,6,30,36,10,20,18,10,9,3,5,99,Sensation Kotwica Kołobrzeg ,Sezon 2021/2022
2021-12-11 18:00,Znicz Basket Pruszków(d),91 : 74W,91,23,36,63.9,9,28,32.1,32,64,50.0,18,25,72.0,8,30,38,22,15,21,10,6,3,0,111,Sensation Kotwica Kołobrzeg ,Sezon 2021/2022
2021-12-15 18:00,TBS Śląsk II Wrocław(w),87 : 88W,88,18,30,60.0,11,29,37.9,29,59,49.2,19,23,82.6,6,27,33,15,19,17,13,6,2,0,97,Sensation Kotwica Kołobrzeg ,Sezon 2021/2022
2021-12-18 18:00,Rawlplug Sokół Łańcut(d),84 : 98P,84,28,50,56.0,6,28,21.4,34,78,43.6,10,14,71.4,13,25,38,17,18,13,12,6,0,2,85,Sensation Kotwica Kołobrzeg ,Sezon 2021/2022
2022-01-02 18:00,GKS Tychy(w),97 : 88P,88,24,37,64.9,8,27,29.6,32,64,50.0,16,24,66.7,6,30,36,15,27,23,15,4,1,0,89,Sensation Kotwica Kołobrzeg ,Sezon 2021/2022
2022-01-15 18:00,Górnik Trans.eu Wałbrzych(d),72 : 71W,72,16,35,45.7,11,37,29.7,27,72,37.5,7,16,43.8,10,27,37,18,24,16,17,9,3,3,68,Sensation Kotwica Kołobrzeg ,Sezon 2021/2022
2022-01-22 18:00,WKK Wrocław(w),83 : 89W,89,15,30,50.0,17,34,50.0,32,64,50.0,8,10,80.0,7,25,32,22,18,15,13,5,2,5,103,Sensation Kotwica Kołobrzeg ,Sezon 2021/2022
2022-01-29 18:00,AZS AGH Kraków(w),87 : 80P,80,23,42,54.8,8,25,32.0,31,67,46.3,10,14,71.4,7,29,36,21,16,18,9,2,5,1,95,Sensation Kotwica Kołobrzeg ,Sezon 2021/2022
2022-02-02 19:00,MKKS Żak Koszalin(d),92 : 77W,92,20,38,52.6,12,31,38.7,32,69,46.4,16,19,84.2,10,28,38,22,23,20,8,3,2,3,109,Sensation Kotwica Kołobrzeg ,Sezon 2021/2022
2022-02-06 17:00,PGE Turów Zgorzelec(w),54 : 92W,92,17,33,51.5,13,31,41.9,30,64,46.9,19,25,76.0,10,30,40,19,19,24,14,9,4,1,110,Sensation Kotwica Kołobrzeg ,Sezon 2021/2022
2022-02-12 18:00,Decka Pelplin(d),75 : 60W,75,14,30,46.7,13,25,52.0,27,55,49.1,8,15,53.3,3,28,31,15,12,18,11,6,4,1,85,Sensation Kotwica Kołobrzeg ,Sezon 2021/2022
2022-02-19 17:00,Miasto Szkła Krosno(w),73 : 84W,84,23,42,54.8,7,24,29.2,30,66,45.5,17,28,60.7,11,32,43,13,24,25,13,5,3,4,88,Sensation Kotwica Kołobrzeg ,Sezon 2021/2022
2022-02-26 18:00,AZS UMCS Start II Lublin(d),81 : 65W,81,16,34,47.1,12,32,37.5,28,66,42.4,13,19,68.4,9,36,45,18,21,19,15,6,6,1,97,Sensation Kotwica Kołobrzeg ,Sezon 2021/2022
2022-03-02 19:00,Weegree AZS Politechnika Opolska(w),80 : 63P,63,8,30,26.7,12,40,30.0,20,70,28.6,11,16,68.8,10,28,38,11,26,18,12,7,2,7,54,Sensation Kotwica Kołobrzeg ,Sezon 2021/2022
2022-03-05 18:00,Dziki Warszawa(d),58 : 67P,58,6,23,26.1,10,30,33.3,16,53,30.2,16,22,72.7,11,29,40,13,21,18,20,7,3,0,58,Sensation Kotwica Kołobrzeg ,Sezon 2021/2022
2022-03-12 17:00,KS Księżak Łowicz(w),104 : 82P,82,12,26,46.2,13,34,38.2,25,60,41.7,19,19,100.0,6,30,36,12,22,22,14,4,2,0,87,Sensation Kotwica Kołobrzeg ,Sezon 2021/2022
2022-03-19 18:00,SKS Starogard Gdański(d),68 : 60W,68,21,48,43.8,7,25,28.0,28,73,38.4,5,8,62.5,13,42,55,17,22,12,13,5,4,3,88,Sensation Kotwica Kołobrzeg ,Sezon 2021/2022
2022-03-24 19:00,Znicz Basket Pruszków(w),83 : 106W,106,16,29,55.2,21,40,52.5,37,69,53.6,11,12,91.7,8,27,35,32,21,13,13,5,2,0,134,Sensation Kotwica Kołobrzeg ,Sezon 2021/2022
2022-03-30 19:00,TBS Śląsk II Wrocław(d),86 : 73W,86,19,31,61.3,13,35,37.1,32,66,48.5,9,13,69.2,10,35,45,25,16,17,14,5,2,0,111,Sensation Kotwica Kołobrzeg ,Sezon 2021/2022
2022-04-02 17:30,Rawlplug Sokół Łańcut(w),88 : 69P,69,15,34,44.1,12,33,36.4,27,67,40.3,3,3,100.0,8,21,29,19,18,10,11,3,1,5,70,Sensation Kotwica Kołobrzeg ,Sezon 2021/2022
2022-04-10 18:00,GKS Tychy(d),77 : 47W,77,14,34,41.2,11,26,42.3,25,60,41.7,16,21,76.2,7,35,42,23,14,19,11,5,1,1,97,Sensation Kotwica Kołobrzeg ,Sezon 2021/2022
2022-04-19 19:00,WKK Wrocław(d),65 : 66P,65,16,41,39.0,8,25,32.0,24,66,36.4,9,16,56.3,9,35,44,17,17,17,6,5,4,2,80,Sensation Kotwica Kołobrzeg ,Sezon 2021/2022
2022-04-20 19:00,WKK Wrocław(d),82 : 49W,82,20,42,47.6,12,34,35.3,32,76,42.1,6,7,85.7,13,34,47,19,19,13,15,10,3,3,101,Sensation Kotwica Kołobrzeg ,Sezon 2021/2022
2022-04-23 18:00,WKK Wrocław(w),60 : 82W,82,17,36,47.2,14,35,40.0,31,71,43.7,6,7,85.7,12,30,42,20,22,14,14,6,6,6,101,Sensation Kotwica Kołobrzeg ,Sezon 2021/2022
2022-04-24 18:00,WKK Wrocław(w),79 : 67P,67,12,24,50.0,13,43,30.2,25,67,37.3,4,8,50.0,8,22,30,18,23,11,12,8,5,1,70,Sensation Kotwica Kołobrzeg ,Sezon 2021/2022
2022-04-27 19:00,WKK Wrocław(d),84 : 67W,84,15,28,53.6,13,46,28.3,28,74,37.8,15,22,68.2,11,29,40,20,21,16,2,9,2,0,100,Sensation Kotwica Kołobrzeg ,Sezon 2021/2022
2022-04-30 17:30,Górnik Trans.eu Wałbrzych(w),80 : 69P,69,19,33,57.6,8,32,25.0,27,65,41.5,7,12,58.3,10,25,35,18,20,18,13,7,2,1,75,Sensation Kotwica Kołobrzeg ,Sezon 2021/2022
2022-05-01 17:30,Górnik Trans.eu Wałbrzych(w),101 : 98P,98,20,42,47.6,14,51,27.5,34,93,36.6,16,25,64.0,18,35,53,26,27,24,14,6,3,7,104,Sensation Kotwica Kołobrzeg ,Sezon 2021/2022
2022-05-07 18:00,Górnik Trans.eu Wałbrzych(d),102 : 99W,102,22,50,44.0,11,38,28.9,33,88,37.5,25,34,73.5,19,38,57,17,30,27,16,13,5,4,114,Sensation Kotwica Kołobrzeg ,Sezon 2021/2022
2022-05-08 18:00,Górnik Trans.eu Wałbrzych(d),79 : 71W,79,9,21,42.9,12,33,36.4,21,54,38.9,25,38,65.8,9,34,43,12,29,25,11,7,3,3,87,Sensation Kotwica Kołobrzeg ,Sezon 2021/2022
2022-05-11 18:00,Górnik Trans.eu Wałbrzych(w),95 : 92P,92,18,34,52.9,14,36,38.9,32,70,45.7,14,19,73.7,6,20,26,21,22,18,11,5,1,2,91,Sensation Kotwica Kołobrzeg ,Sezon 2021/2022
2022-05-14 18:00,Weegree AZS Politechnika Opolska(w),66 : 65P,65,14,33,42.4,8,26,30.8,22,59,37.3,13,16,81.3,5,29,34,16,22,15,14,10,1,4,72,Sensation Kotwica Kołobrzeg ,Sezon 2021/2022
2022-05-18 19:00,Weegree AZS Politechnika Opolska(d),69 : 63W,69,16,31,51.6,8,29,27.6,24,60,40.0,13,17,76.5,6,33,39,12,18,18,9,8,1,0,80,Sensation Kotwica Kołobrzeg ,Sezon 2021/2022
2021-09-25 17:00,Miasto Szkła Krosno(w),74 : 85W,85,22,39,56.4,5,16,31.3,27,55,49.1,26,41,63.4,11,30,41,14,19,26,22,10,3,4,88,SKS Starogard Gdański,Sezon 2021/2022
2021-10-01 19:00,AZS UMCS Start II Lublin(d),98 : 94W,98,22,38,57.9,14,34,41.2,36,72,50.0,12,20,60.0,18,21,39,16,19,18,17,8,3,1,103,SKS Starogard Gdański,Sezon 2021/2022
2021-10-09 17:30,Weegree AZS Politechnika Opolska(w),89 : 82P,82,18,35,51.4,10,29,34.5,28,64,43.8,16,28,57.1,8,22,30,20,24,23,17,7,5,3,79,SKS Starogard Gdański,Sezon 2021/2022
2021-10-16 18:00,Dziki Warszawa(d),76 : 82P,76,22,38,57.9,6,21,28.6,28,59,47.5,14,16,87.5,5,31,36,21,19,17,20,6,3,6,89,SKS Starogard Gdański,Sezon 2021/2022
2021-10-20 19:00,KS Księżak Łowicz(w),95 : 104W,104,33,40,82.5,11,31,35.5,44,71,62.0,5,13,38.5,6,21,27,18,21,20,13,10,1,0,112,SKS Starogard Gdański,Sezon 2021/2022
2021-10-23 18:00,WKK Wrocław(w),91 : 85P,85,14,38,36.8,11,32,34.4,25,70,35.7,24,33,72.7,15,29,44,22,23,24,23,7,8,5,89,SKS Starogard Gdański,Sezon 2021/2022
2021-10-30 18:00,Znicz Basket Pruszków(d),91 : 76W,91,25,38,65.8,9,34,26.5,34,72,47.2,14,17,82.4,8,32,40,20,21,21,16,6,6,4,106,SKS Starogard Gdański,Sezon 2021/2022
2021-11-07 19:00,TBS Śląsk II Wrocław(w),79 : 81W,81,18,41,43.9,9,31,29.0,27,72,37.5,18,24,75.0,13,28,41,18,15,23,13,9,4,4,89,SKS Starogard Gdański,Sezon 2021/2022
2021-11-13 18:00,Rawlplug Sokół Łańcut(d),98 : 112P,98,22,44,50.0,15,34,44.1,37,78,47.4,9,18,50.0,11,17,28,25,21,18,12,6,6,5,101,SKS Starogard Gdański,Sezon 2021/2022
2021-11-17 18:00,GKS Tychy(w),101 : 83P,83,22,39,56.4,7,31,22.6,29,70,41.4,18,22,81.8,17,25,42,19,13,21,17,4,3,2,89,SKS Starogard Gdański,Sezon 2021/2022
2021-11-27 17:00,Górnik Trans.eu Wałbrzych(w),87 : 65P,65,11,25,44.0,9,33,27.3,20,58,34.5,16,27,59.3,5,23,28,16,18,23,17,8,4,1,55,SKS Starogard Gdański,Sezon 2021/2022
2021-12-03 19:00,Sensation Kotwica Kołobrzeg(d),68 : 89P,68,17,33,51.5,6,26,23.1,23,59,39.0,16,27,59.3,9,27,36,16,19,19,16,7,5,3,69,SKS Starogard Gdański,Sezon 2021/2022
2021-12-11 20:00,AZS AGH Kraków(w),76 : 86W,86,21,39,53.8,9,16,56.3,30,55,54.5,17,37,45.9,9,31,40,19,15,27,14,8,7,2,101,SKS Starogard Gdański,Sezon 2021/2022
2021-12-15 19:00,MKKS Żak Koszalin(d),75 : 82P,75,16,38,42.1,12,32,37.5,28,70,40.0,7,12,58.3,12,17,29,22,16,15,13,11,3,2,80,SKS Starogard Gdański,Sezon 2021/2022
2021-12-18 18:00,PGE Turów Zgorzelec(w),75 : 80W,80,21,40,52.5,7,21,33.3,28,61,45.9,17,26,65.4,8,22,30,13,20,19,11,8,6,0,84,SKS Starogard Gdański,Sezon 2021/2022
2022-01-02 18:00,Decka Pelplin(d),77 : 52W,77,18,34,52.9,9,30,30.0,27,64,42.2,14,21,66.7,13,26,39,13,20,21,14,13,4,6,88,SKS Starogard Gdański,Sezon 2021/2022
2022-01-08 18:00,Miasto Szkła Krosno(d),72 : 76P,72,17,31,54.8,9,34,26.5,26,65,40.0,11,15,73.3,6,21,27,12,19,22,16,12,6,4,70,SKS Starogard Gdański,Sezon 2021/2022
2022-01-15 19:00,AZS UMCS Start II Lublin(w),95 : 88P,88,10,25,40.0,18,39,46.2,28,64,43.8,14,20,70.0,8,19,27,24,18,19,11,5,2,2,93,SKS Starogard Gdański,Sezon 2021/2022
2022-01-22 18:00,Weegree AZS Politechnika Opolska(d),83 : 78W,83,18,33,54.5,10,34,29.4,28,67,41.8,17,23,73.9,8,28,36,13,29,20,17,9,9,1,88,SKS Starogard Gdański,Sezon 2021/2022
2022-01-29 18:00,Dziki Warszawa(w),70 : 57P,57,12,31,38.7,7,28,25.0,19,59,32.2,12,18,66.7,8,21,29,14,23,21,17,10,2,3,49,SKS Starogard Gdański,Sezon 2021/2022
2022-02-06 18:00,WKK Wrocław(d),78 : 79P,78,16,33,48.5,10,28,35.7,26,61,42.6,16,26,61.5,10,33,43,19,17,21,12,1,4,1,88,SKS Starogard Gdański,Sezon 2021/2022
2022-02-12 18:00,Znicz Basket Pruszków(w),80 : 82W,82,21,45,46.7,9,32,28.1,30,77,39.0,13,24,54.2,12,34,46,16,19,24,15,11,2,0,84,SKS Starogard Gdański,Sezon 2021/2022
2022-03-02 19:00,GKS Tychy(d),75 : 68W,75,15,35,42.9,10,28,35.7,25,63,39.7,15,21,71.4,13,37,50,14,20,21,15,8,4,1,92,SKS Starogard Gdański,Sezon 2021/2022
2022-03-09 18:00,Rawlplug Sokół Łańcut(w),93 : 62P,62,18,38,47.4,5,28,17.9,23,66,34.8,11,16,68.8,8,20,28,17,14,21,17,8,1,1,51,SKS Starogard Gdański,Sezon 2021/2022
2022-03-13 18:00,Górnik Trans.eu Wałbrzych(d),85 : 73W,85,13,41,31.7,12,31,38.7,25,72,34.7,23,31,74.2,10,32,42,15,20,23,15,8,4,5,84,SKS Starogard Gdański,Sezon 2021/2022
2022-03-16 19:00,TBS Śląsk II Wrocław(d),98 : 81W,98,29,52,55.8,10,30,33.3,39,82,47.6,10,14,71.4,14,30,44,22,17,15,7,6,7,4,123,SKS Starogard Gdański,Sezon 2021/2022
2022-03-19 18:00,Sensation Kotwica Kołobrzeg(w),68 : 60P,60,11,33,33.3,8,25,32.0,19,58,32.8,14,28,50.0,3,27,30,10,12,22,8,4,3,4,46,SKS Starogard Gdański,Sezon 2021/2022
2022-03-23 19:00,KS Księżak Łowicz(d),79 : 67W,79,18,36,50.0,11,33,33.3,29,69,42.0,10,17,58.8,9,31,40,20,17,18,11,5,2,0,88,SKS Starogard Gdański,Sezon 2021/2022
2022-03-26 18:00,AZS AGH Kraków(d),75 : 65W,75,24,39,61.5,5,20,25.0,29,59,49.2,12,24,50.0,2,32,34,20,15,25,14,4,1,3,78,SKS Starogard Gdański,Sezon 2021/2022
2022-03-30 18:00,MKKS Żak Koszalin(w),71 : 49P,49,16,36,44.4,2,33,6.1,18,69,26.1,11,17,64.7,11,20,31,10,18,21,16,10,3,8,30,SKS Starogard Gdański,Sezon 2021/2022
2022-04-06 19:00,PGE Turów Zgorzelec(d),102 : 78W,102,26,42,61.9,12,31,38.7,38,73,52.1,14,23,60.9,11,33,44,31,15,16,12,8,3,2,132,SKS Starogard Gdański,Sezon 2021/2022
2022-04-10 18:00,Decka Pelplin(w),65 : 78W,78,17,29,58.6,9,27,33.3,26,56,46.4,17,28,60.7,8,29,37,15,16,22,17,9,2,1,83,SKS Starogard Gdański,Sezon 2021/2022
2021-09-27 19:00,PGE Turów Zgorzelec(d),142 : 54W,142,39,59,66.1,19,44,43.2,58,103,56.3,7,10,70.0,27,38,65,39,19,13,15,20,3,2,206,TBS Śląsk II Wrocław,Sezon 2021/2022
2021-10-02 12:00,Decka Pelplin(d),87 : 62W,87,24,42,57.1,9,22,40.9,33,64,51.6,12,18,66.7,6,26,32,20,18,16,12,14,4,4,108,TBS Śląsk II Wrocław,Sezon 2021/2022
2021-10-09 16:00,Miasto Szkła Krosno(w),101 : 87P,87,24,44,54.5,6,19,31.6,30,63,47.6,21,30,70.0,6,23,29,22,25,24,17,7,1,3,87,TBS Śląsk II Wrocław,Sezon 2021/2022
2021-10-17 19:00,AZS UMCS Start II Lublin(d),88 : 92P,88,25,48,52.1,9,31,29.0,34,79,43.0,11,18,61.1,12,30,42,18,24,23,14,11,1,3,94,TBS Śląsk II Wrocław,Sezon 2021/2022
2021-10-24 19:00,Dziki Warszawa(d),64 : 59W,64,22,57,38.6,3,17,17.6,25,74,33.8,11,21,52.4,21,32,53,15,25,22,14,6,2,5,67,TBS Śląsk II Wrocław,Sezon 2021/2022
2021-10-31 17:00,KS Księżak Łowicz(w),95 : 81P,81,21,40,52.5,9,30,30.0,30,70,42.9,12,18,66.7,14,17,31,13,25,21,16,8,1,0,72,TBS Śląsk II Wrocław,Sezon 2021/2022
2021-11-04 18:30,Weegree AZS Politechnika Opolska(w),83 : 71P,71,26,43,60.5,3,24,12.5,29,67,43.3,10,15,66.7,10,25,35,13,27,18,13,8,1,2,72,TBS Śląsk II Wrocław,Sezon 2021/2022
2021-11-07 19:00,SKS Starogard Gdański(d),79 : 81P,79,20,45,44.4,9,21,42.9,29,66,43.9,12,16,75.0,7,27,34,18,23,15,15,9,4,4,88,TBS Śląsk II Wrocław,Sezon 2021/2022
2021-11-14 17:00,Znicz Basket Pruszków(w),76 : 81W,81,25,45,55.6,5,23,21.7,30,68,44.1,16,28,57.1,13,26,39,15,26,24,14,4,5,1,80,TBS Śląsk II Wrocław,Sezon 2021/2022
2021-11-17 17:00,WKK Wrocław(w),70 : 82W,82,22,38,57.9,8,33,24.2,30,71,42.3,14,23,60.9,11,27,38,20,19,20,9,10,4,3,95,TBS Śląsk II Wrocław,Sezon 2021/2022
2021-11-24 18:00,Rawlplug Sokół Łańcut(d),84 : 74W,84,22,48,45.8,5,14,35.7,27,62,43.5,25,34,73.5,11,27,38,21,28,26,19,10,4,5,94,TBS Śląsk II Wrocław,Sezon 2021/2022
2021-11-30 18:00,GKS Tychy(w),88 : 77P,77,17,35,48.6,8,25,32.0,25,60,41.7,19,24,79.2,10,24,34,18,18,22,16,8,2,3,83,TBS Śląsk II Wrocław,Sezon 2021/2022
2021-12-10 19:45,Górnik Trans.eu Wałbrzych(w),85 : 71P,71,18,42,42.9,7,26,26.9,25,68,36.8,14,22,63.6,13,22,35,16,19,20,9,6,3,2,71,TBS Śląsk II Wrocław,Sezon 2021/2022
2021-12-15 18:00,Sensation Kotwica Kołobrzeg(d),87 : 88P,87,27,51,52.9,9,26,34.6,36,77,46.8,6,11,54.5,10,25,35,19,18,18,9,4,0,2,90,TBS Śląsk II Wrocław,Sezon 2021/2022
2021-12-19 18:00,AZS AGH Kraków(w),69 : 72W,72,19,40,47.5,6,15,40.0,25,55,45.5,16,30,53.3,9,33,42,19,20,25,17,4,3,2,79,TBS Śląsk II Wrocław,Sezon 2021/2022
2022-01-09 15:00,PGE Turów Zgorzelec(w),84 : 70P,70,21,44,47.7,6,22,27.3,27,66,40.9,10,17,58.8,12,24,36,13,20,23,17,8,0,3,64,TBS Śląsk II Wrocław,Sezon 2021/2022
2022-01-16 17:00,Decka Pelplin(w),73 : 87W,87,19,34,55.9,12,29,41.4,31,63,49.2,13,23,56.5,13,28,41,17,19,22,16,8,0,3,95,TBS Śląsk II Wrocław,Sezon 2021/2022
2022-01-29 18:00,AZS UMCS Start II Lublin(w),71 : 91W,91,23,44,52.3,11,30,36.7,34,74,45.9,12,20,60.0,11,32,43,22,20,19,8,2,2,2,104,TBS Śląsk II Wrocław,Sezon 2021/2022
2022-02-02 15:00,Weegree AZS Politechnika Opolska(d),99 : 95W,99,19,36,52.8,14,30,46.7,33,66,50.0,19,23,82.6,10,34,44,14,29,25,19,5,2,0,108,TBS Śląsk II Wrocław,Sezon 2021/2022
2022-02-10 18:00,MKKS Żak Koszalin(d),61 : 69P,61,20,45,44.4,4,18,22.2,24,63,38.1,9,15,60.0,9,23,32,13,18,17,15,8,3,3,57,TBS Śląsk II Wrocław,Sezon 2021/2022
2022-02-14 18:00,KS Księżak Łowicz(d),96 : 86W,96,18,34,52.9,12,31,38.7,30,65,46.2,24,33,72.7,7,26,33,20,24,23,7,8,1,2,107,TBS Śląsk II Wrocław,Sezon 2021/2022
2022-02-16 16:00,Dziki Warszawa(w),81 : 73P,73,17,39,43.6,8,24,33.3,25,63,39.7,15,18,83.3,7,33,40,11,21,22,16,3,1,2,71,TBS Śląsk II Wrocław,Sezon 2021/2022
2022-02-22 19:00,Miasto Szkła Krosno(d),82 : 83P,82,22,50,44.0,7,23,30.4,29,73,39.7,17,19,89.5,15,16,31,13,24,23,12,9,2,2,79,TBS Śląsk II Wrocław,Sezon 2021/2022
2022-02-25 19:30,Znicz Basket Pruszków(d),89 : 86W,89,20,40,50.0,14,33,42.4,34,73,46.6,7,14,50.0,11,29,40,19,23,20,11,3,2,3,96,TBS Śląsk II Wrocław,Sezon 2021/2022
2022-03-02 18:00,WKK Wrocław(d),77 : 90P,77,22,46,47.8,8,23,34.8,30,69,43.5,9,16,56.3,7,26,33,18,23,15,14,4,3,3,75,TBS Śląsk II Wrocław,Sezon 2021/2022
2022-03-05 17:30,Rawlplug Sokół Łańcut(w),109 : 102P,102,30,54,55.6,10,23,43.5,40,77,51.9,12,18,66.7,10,26,36,14,34,17,13,5,1,4,102,TBS Śląsk II Wrocław,Sezon 2021/2022
2022-03-13 13:30,GKS Tychy(d),94 : 77W,94,28,42,66.7,6,19,31.6,34,61,55.7,20,32,62.5,11,19,30,22,23,29,16,8,4,0,103,TBS Śląsk II Wrocław,Sezon 2021/2022
2022-03-16 19:00,SKS Starogard Gdański(w),98 : 81P,81,19,46,41.3,10,25,40.0,29,71,40.8,13,15,86.7,8,23,31,13,16,17,10,1,4,7,76,TBS Śląsk II Wrocław,Sezon 2021/2022
2022-03-23 19:00,Górnik Trans.eu Wałbrzych(d),95 : 100P,95,25,49,51.0,8,38,21.1,33,87,37.9,21,29,72.4,7,37,44,18,22,23,18,5,5,5,87,TBS Śląsk II Wrocław,Sezon 2021/2022
2022-03-30 19:00,Sensation Kotwica Kołobrzeg(w),86 : 73P,73,16,37,43.2,12,36,33.3,28,73,38.4,5,12,41.7,7,18,25,12,17,16,9,7,0,2,56,TBS Śląsk II Wrocław,Sezon 2021/2022
2022-04-03 13:00,AZS AGH Kraków(d),83 : 68W,83,17,38,44.7,8,22,36.4,25,60,41.7,25,31,80.6,8,37,45,12,17,23,22,8,2,0,87,TBS Śląsk II Wrocław,Sezon 2021/2022
2022-04-10 18:00,MKKS Żak Koszalin(w),84 : 80P,80,20,43,46.5,8,26,30.8,28,69,40.6,16,22,72.7,4,26,30,16,22,21,9,5,1,0,76,TBS Śląsk II Wrocław,Sezon 2021/2022
2021-09-25 17:30,Dziki Warszawa(d),71 : 64W,71,18,39,46.2,7,18,38.9,25,57,43.9,14,18,77.8,10,22,32,20,21,19,14,10,4,2,87,Weegree AZS Politechnika Opolska,Sezon 2021/2022
2021-10-02 18:00,KS Księżak Łowicz(w),77 : 95W,95,21,35,60.0,14,31,45.2,35,66,53.0,11,14,78.6,14,23,37,26,21,21,12,4,1,1,117,Weegree AZS Politechnika Opolska,Sezon 2021/2022
2021-10-09 17:30,SKS Starogard Gdański(d),89 : 82W,89,27,47,57.4,5,19,26.3,32,66,48.5,20,30,66.7,10,21,31,19,24,24,11,13,3,5,100,Weegree AZS Politechnika Opolska,Sezon 2021/2022
2021-10-16 18:00,Znicz Basket Pruszków(w),81 : 70P,70,19,37,51.4,5,19,26.3,24,56,42.9,17,21,81.0,9,18,27,11,18,23,10,5,0,3,67,Weegree AZS Politechnika Opolska,Sezon 2021/2022
2021-10-23 17:30,Rawlplug Sokół Łańcut(w),78 : 73P,73,19,43,44.2,6,15,40.0,25,58,43.1,17,22,77.3,9,22,31,16,21,22,13,7,1,2,77,Weegree AZS Politechnika Opolska,Sezon 2021/2022
2021-10-30 17:30,GKS Tychy(d),87 : 90P,87,23,31,74.2,6,26,23.1,29,57,50.9,23,28,82.1,3,20,23,22,20,25,10,8,1,0,98,Weegree AZS Politechnika Opolska,Sezon 2021/2022
2021-11-04 18:30,TBS Śląsk II Wrocław(d),83 : 71W,83,21,34,61.8,6,23,26.1,27,57,47.4,23,27,85.2,3,24,27,25,19,27,12,9,2,1,100,Weegree AZS Politechnika Opolska,Sezon 2021/2022
2021-11-13 17:30,Górnik Trans.eu Wałbrzych(d),83 : 75W,83,20,34,58.8,9,25,36.0,29,59,49.2,16,22,72.7,9,29,38,24,23,22,15,5,4,5,103,Weegree AZS Politechnika Opolska,Sezon 2021/2022
2021-11-17 19:00,Sensation Kotwica Kołobrzeg(w),87 : 68P,68,18,38,47.4,7,33,21.2,25,71,35.2,11,19,57.9,17,20,37,17,18,20,15,7,1,3,61,Weegree AZS Politechnika Opolska,Sezon 2021/2022
2021-11-21 17:30,AZS AGH Kraków(d),88 : 72W,88,23,36,63.9,6,13,46.2,29,49,59.2,24,28,85.7,4,29,33,29,18,25,16,7,6,1,123,Weegree AZS Politechnika Opolska,Sezon 2021/2022
2021-11-27 17:30,MKKS Żak Koszalin(d),88 : 76W,88,25,40,62.5,4,24,16.7,29,64,45.3,26,32,81.3,11,32,43,30,13,22,12,7,4,5,119,Weegree AZS Politechnika Opolska,Sezon 2021/2022
2021-12-04 17:30,PGE Turów Zgorzelec(d),99 : 68W,99,22,39,56.4,15,32,46.9,37,71,52.1,10,21,47.6,13,24,37,34,18,19,12,7,4,0,124,Weegree AZS Politechnika Opolska,Sezon 2021/2022
2021-12-11 17:00,Decka Pelplin(w),67 : 70W,70,18,35,51.4,8,29,27.6,26,64,40.6,10,18,55.6,10,30,40,19,16,19,11,9,3,5,84,Weegree AZS Politechnika Opolska,Sezon 2021/2022
2021-12-15 18:00,Miasto Szkła Krosno(d),72 : 61W,72,18,39,46.2,7,24,29.2,25,63,39.7,15,21,71.4,11,27,38,16,14,23,13,7,2,5,78,Weegree AZS Politechnika Opolska,Sezon 2021/2022
2021-12-19 16:00,AZS UMCS Start II Lublin(w),91 : 89P,89,17,34,50.0,12,35,34.3,29,69,42.0,19,25,76.0,14,25,39,23,25,23,13,9,1,4,102,Weegree AZS Politechnika Opolska,Sezon 2021/2022
2022-01-02 17:00,WKK Wrocław(d),78 : 68W,78,24,42,57.1,6,26,23.1,30,68,44.1,12,21,57.1,9,33,42,24,20,22,12,6,6,2,97,Weegree AZS Politechnika Opolska,Sezon 2021/2022
2022-01-08 18:00,Dziki Warszawa(w),69 : 76W,76,14,28,50.0,11,32,34.4,25,60,41.7,15,24,62.5,10,32,42,18,15,22,9,5,1,2,89,Weegree AZS Politechnika Opolska,Sezon 2021/2022
2022-01-15 17:00,KS Księżak Łowicz(d),96 : 77W,96,21,36,58.3,8,28,28.6,29,64,45.3,30,36,83.3,8,30,38,25,26,32,9,4,3,1,116,Weegree AZS Politechnika Opolska,Sezon 2021/2022
2022-01-22 18:00,SKS Starogard Gdański(w),83 : 78P,78,15,38,39.5,10,32,31.3,25,70,35.7,18,30,60.0,12,28,40,16,20,29,15,9,1,9,72,Weegree AZS Politechnika Opolska,Sezon 2021/2022
2022-01-29 17:30,Znicz Basket Pruszków(d),86 : 71W,86,18,35,51.4,12,32,37.5,30,67,44.8,14,20,70.0,6,26,32,27,21,18,12,13,3,2,106,Weegree AZS Politechnika Opolska,Sezon 2021/2022
2022-02-02 15:00,TBS Śląsk II Wrocław(w),99 : 95P,95,26,55,47.3,7,18,38.9,33,73,45.2,22,36,61.1,7,23,30,22,25,28,7,10,0,2,96,Weegree AZS Politechnika Opolska,Sezon 2021/2022
2022-02-05 17:30,Rawlplug Sokół Łańcut(d),83 : 81W,83,18,36,50.0,11,25,44.0,29,61,47.5,14,22,63.6,4,27,31,24,14,22,15,3,5,2,91,Weegree AZS Politechnika Opolska,Sezon 2021/2022
2022-02-12 19:00,GKS Tychy(w),101 : 106W,106,19,28,67.9,16,31,51.6,35,59,59.3,20,31,64.5,6,22,28,22,24,25,17,6,3,1,113,Weegree AZS Politechnika Opolska,Sezon 2021/2022
2022-02-26 17:00,Górnik Trans.eu Wałbrzych(w),76 : 75P,75,13,29,44.8,10,32,31.3,23,61,37.7,19,32,59.4,8,27,35,22,18,25,12,2,2,4,73,Weegree AZS Politechnika Opolska,Sezon 2021/2022
2022-03-02 19:00,Sensation Kotwica Kołobrzeg(d),80 : 63W,80,21,32,65.6,7,25,28.0,28,57,49.1,17,31,54.8,7,36,43,22,19,26,13,5,7,2,101,Weegree AZS Politechnika Opolska,Sezon 2021/2022
2022-03-05 18:00,AZS AGH Kraków(w),65 : 72W,72,19,35,54.3,7,21,33.3,26,56,46.4,13,19,68.4,5,30,35,19,21,24,18,4,1,1,77,Weegree AZS Politechnika Opolska,Sezon 2021/2022
2022-03-12 17:00,MKKS Żak Koszalin(w),58 : 72W,72,12,27,44.4,13,31,41.9,25,58,43.1,9,13,69.2,2,27,29,20,20,14,13,5,2,2,78,Weegree AZS Politechnika Opolska,Sezon 2021/2022
2022-03-19 18:00,PGE Turów Zgorzelec(w),91 : 77P,77,13,32,40.6,10,36,27.8,23,68,33.8,21,25,84.0,7,24,31,14,21,20,6,9,0,2,76,Weegree AZS Politechnika Opolska,Sezon 2021/2022
2022-03-26 18:00,Decka Pelplin(d),90 : 79W,90,19,28,67.9,12,30,40.0,31,58,53.4,16,21,76.2,5,23,28,26,18,23,8,11,2,1,117,Weegree AZS Politechnika Opolska,Sezon 2021/2022
2022-03-30 18:00,Miasto Szkła Krosno(w),73 : 68P,68,16,35,45.7,7,28,25.0,23,63,36.5,15,18,83.3,5,25,30,14,16,21,10,6,0,5,65,Weegree AZS Politechnika Opolska,Sezon 2021/2022
2022-04-02 18:00,AZS UMCS Start II Lublin(d),79 : 82P,79,14,26,53.8,13,39,33.3,27,65,41.5,12,16,75.0,7,27,34,27,18,20,12,7,1,3,94,Weegree AZS Politechnika Opolska,Sezon 2021/2022
2022-04-10 18:00,WKK Wrocław(w),86 : 82P,82,23,41,56.1,5,29,17.2,28,70,40.0,21,27,77.8,9,24,33,18,17,25,10,7,2,3,84,Weegree AZS Politechnika Opolska,Sezon 2021/2022
2022-04-19 18:30,GKS Tychy(d),73 : 80P,73,15,28,53.6,8,30,26.7,23,58,39.7,19,29,65.5,3,32,35,20,21,28,13,3,2,0,75,Weegree AZS Politechnika Opolska,Sezon 2021/2022
2022-04-20 18:30,GKS Tychy(d),64 : 67P,64,15,37,40.5,6,21,28.6,21,58,36.2,16,22,72.7,7,23,30,18,22,22,15,12,3,3,69,Weegree AZS Politechnika Opolska,Sezon 2021/2022
2022-04-23 18:00,GKS Tychy(w),86 : 96W,96,28,36,77.8,8,13,61.5,36,49,73.5,16,25,64.0,3,21,24,20,19,26,23,6,2,0,103,Weegree AZS Politechnika Opolska,Sezon 2021/2022
2022-04-24 18:00,GKS Tychy(w),74 : 85W,85,23,35,65.7,8,28,28.6,31,63,49.2,15,19,78.9,4,22,26,15,23,24,10,10,1,3,91,Weegree AZS Politechnika Opolska,Sezon 2021/2022
2022-04-27 18:00,GKS Tychy(d),86 : 78W,86,12,24,50.0,10,25,40.0,22,49,44.9,32,38,84.2,5,30,35,18,25,30,15,9,4,1,104,Weegree AZS Politechnika Opolska,Sezon 2021/2022
2022-04-30 17:30,Rawlplug Sokół Łańcut(w),67 : 63P,63,17,39,43.6,5,30,16.7,22,69,31.9,14,18,77.8,4,31,35,9,17,20,10,10,0,9,56,Weegree AZS Politechnika Opolska,Sezon 2021/2022
2022-05-01 17:30,Rawlplug Sokół Łańcut(w),86 : 76P,76,17,31,54.8,8,24,33.3,25,55,45.5,18,23,78.3,4,22,26,14,15,20,17,8,2,3,74,Weegree AZS Politechnika Opolska,Sezon 2021/2022
2022-05-07 18:00,Rawlplug Sokół Łańcut(d),87 : 93P,87,22,38,57.9,11,28,39.3,33,66,50.0,10,16,62.5,9,27,36,27,21,17,14,7,0,3,104,Weegree AZS Politechnika Opolska,Sezon 2021/2022
2022-05-14 18:00,Sensation Kotwica Kołobrzeg(d),66 : 65W,66,15,36,41.7,9,25,36.0,24,61,39.3,9,13,69.2,4,28,32,19,15,22,14,4,4,1,70,Weegree AZS Politechnika Opolska,Sezon 2021/2022
2022-05-18 19:00,Sensation Kotwica Kołobrzeg(w),69 : 63P,63,9,34,26.5,10,31,32.3,19,65,29.2,15,19,78.9,11,28,39,10,18,18,11,6,0,1,57,Weegree AZS Politechnika Opolska,Sezon 2021/2022
2021-09-25 18:00,Górnik Trans.eu Wałbrzych(w),71 : 74W,74,21,45,46.7,5,22,22.7,26,67,38.8,17,24,70.8,11,24,35,12,15,20,14,14,1,2,74,WKK Wrocław,Sezon 2021/2022
2021-10-02 18:00,Dziki Warszawa(d),88 : 56W,88,21,39,53.8,9,26,34.6,30,65,46.2,19,22,86.4,10,34,44,23,18,23,10,9,4,2,120,WKK Wrocław,Sezon 2021/2022
2021-10-09 18:00,Sensation Kotwica Kołobrzeg(w),76 : 66P,66,13,23,56.5,11,29,37.9,24,52,46.2,7,12,58.3,8,23,31,11,15,15,16,1,3,0,63,WKK Wrocław,Sezon 2021/2022
2021-10-16 18:00,KS Księżak Łowicz(d),103 : 95W,103,32,58,55.2,8,23,34.8,40,81,49.4,15,21,71.4,17,26,43,26,19,17,10,9,6,3,130,WKK Wrocław,Sezon 2021/2022
2021-10-20 18:30,AZS AGH Kraków(w),53 : 83W,83,20,32,62.5,5,18,27.8,25,50,50.0,28,38,73.7,3,34,37,21,19,28,17,8,3,0,100,WKK Wrocław,Sezon 2021/2022
2021-10-23 18:00,SKS Starogard Gdański(d),91 : 85W,91,19,46,41.3,10,27,37.0,29,73,39.7,23,30,76.7,7,26,33,20,24,23,16,15,5,8,97,WKK Wrocław,Sezon 2021/2022
2021-10-30 17:00,MKKS Żak Koszalin(w),77 : 65P,65,21,39,53.8,3,23,13.0,24,62,38.7,14,19,73.7,4,20,24,11,18,18,13,11,2,4,57,WKK Wrocław,Sezon 2021/2022
2021-11-06 18:00,Znicz Basket Pruszków(d),96 : 79W,96,23,31,74.2,9,33,27.3,32,64,50.0,23,27,85.2,7,27,34,28,26,22,13,12,2,0,123,WKK Wrocław,Sezon 2021/2022
2021-11-14 16:00,PGE Turów Zgorzelec(w),66 : 77W,77,22,39,56.4,8,31,25.8,30,70,42.9,9,18,50.0,14,30,44,24,20,20,14,10,2,0,94,WKK Wrocław,Sezon 2021/2022
2021-11-17 17:00,TBS Śląsk II Wrocław(d),70 : 82P,70,15,32,46.9,9,28,32.1,24,60,40.0,13,22,59.1,4,31,35,19,20,19,14,7,3,4,75,WKK Wrocław,Sezon 2021/2022
2021-11-20 17:00,Decka Pelplin(w),78 : 53P,53,18,46,39.1,1,21,4.8,19,67,28.4,14,21,66.7,18,19,37,7,15,21,17,6,1,4,32,WKK Wrocław,Sezon 2021/2022
2021-11-26 18:00,Rawlplug Sokół Łańcut(d),91 : 94P,91,26,55,47.3,9,20,45.0,35,75,46.7,12,18,66.7,12,27,39,19,27,21,14,7,0,4,96,WKK Wrocław,Sezon 2021/2022
2021-12-04 17:00,Miasto Szkła Krosno(w),91 : 68P,68,17,34,50.0,6,19,31.6,23,53,43.4,16,25,64.0,6,19,25,11,17,19,18,10,1,1,58,WKK Wrocław,Sezon 2021/2022
2021-12-11 18:00,GKS Tychy(d),86 : 69W,86,18,36,50.0,10,25,40.0,28,61,45.9,20,24,83.3,8,26,34,20,25,23,10,9,3,0,105,WKK Wrocław,Sezon 2021/2022
2021-12-15 14:00,AZS UMCS Start II Lublin(w),83 : 67P,67,20,43,46.5,5,17,29.4,25,60,41.7,12,21,57.1,4,25,29,13,14,20,13,9,3,2,64,WKK Wrocław,Sezon 2021/2022
2022-01-02 17:00,Weegree AZS Politechnika Opolska(w),78 : 68P,68,23,45,51.1,3,15,20.0,26,60,43.3,13,21,61.9,3,25,28,17,22,19,11,8,2,6,70,WKK Wrocław,Sezon 2021/2022
2022-01-06 16:00,Górnik Trans.eu Wałbrzych(d),74 : 84P,74,21,48,43.8,7,15,46.7,28,63,44.4,11,15,73.3,6,30,36,9,19,18,18,6,1,6,69,WKK Wrocław,Sezon 2021/2022
2022-01-15 18:00,Dziki Warszawa(w),67 : 74W,74,17,36,47.2,8,17,47.1,25,53,47.2,16,21,76.2,6,26,32,17,11,20,15,7,6,2,88,WKK Wrocław,Sezon 2021/2022
2022-01-22 18:00,Sensation Kotwica Kołobrzeg(d),83 : 89P,83,16,35,45.7,13,27,48.1,29,62,46.8,12,17,70.6,7,21,28,23,15,17,8,5,5,2,98,WKK Wrocław,Sezon 2021/2022
2022-02-03 18:00,AZS AGH Kraków(d),95 : 99P,95,23,43,53.5,8,22,36.4,31,65,47.7,25,33,75.8,10,23,33,19,21,27,13,9,1,4,102,WKK Wrocław,Sezon 2021/2022
2022-02-06 18:00,SKS Starogard Gdański(w),78 : 79W,79,20,49,40.8,8,28,28.6,28,77,36.4,15,21,71.4,13,22,35,10,21,17,3,10,1,4,77,WKK Wrocław,Sezon 2021/2022
2022-02-12 18:00,MKKS Żak Koszalin(d),79 : 70W,79,15,36,41.7,11,30,36.7,26,66,39.4,16,18,88.9,12,26,38,15,18,17,11,5,2,5,86,WKK Wrocław,Sezon 2021/2022
2022-02-19 18:00,Znicz Basket Pruszków(w),81 : 69P,69,19,45,42.2,5,18,27.8,24,63,38.1,16,23,69.6,13,20,33,17,23,22,15,3,3,2,64,WKK Wrocław,Sezon 2021/2022
2022-02-26 18:00,PGE Turów Zgorzelec(d),85 : 79W,85,18,42,42.9,8,30,26.7,26,72,36.1,25,31,80.6,11,26,37,19,19,25,8,6,1,4,88,WKK Wrocław,Sezon 2021/2022
2022-03-02 18:00,TBS Śląsk II Wrocław(w),77 : 90W,90,29,64,45.3,5,15,33.3,34,79,43.0,17,24,70.8,14,28,42,10,15,22,6,5,3,3,92,WKK Wrocław,Sezon 2021/2022
2022-03-05 18:00,Decka Pelplin(d),90 : 82W,90,23,43,53.5,9,16,56.3,32,59,54.2,17,25,68.0,9,21,30,23,16,21,13,10,1,2,106,WKK Wrocław,Sezon 2021/2022
2022-03-09 18:00,KS Księżak Łowicz(w),88 : 94W,94,30,52,57.7,5,15,33.3,35,67,52.2,19,29,65.5,12,23,35,8,25,24,8,4,0,1,91,WKK Wrocław,Sezon 2021/2022
2022-03-12 17:30,Rawlplug Sokół Łańcut(w),91 : 87P,87,25,43,58.1,7,16,43.8,32,59,54.2,16,21,76.2,4,23,27,15,16,16,16,7,2,4,90,WKK Wrocław,Sezon 2021/2022
2022-03-19 18:00,Miasto Szkła Krosno(d),83 : 87P,83,17,36,47.2,8,25,32.0,25,61,41.0,25,33,75.8,13,28,41,14,23,24,14,3,6,3,89,WKK Wrocław,Sezon 2021/2022
2022-03-27 18:00,GKS Tychy(w),102 : 96P,96,20,44,45.5,12,24,50.0,32,68,47.1,20,25,80.0,6,22,28,17,22,25,9,3,1,2,95,WKK Wrocław,Sezon 2021/2022
2022-03-30 18:00,AZS UMCS Start II Lublin(d),93 : 84W,93,18,36,50.0,14,29,48.3,32,65,49.2,15,22,68.2,7,28,35,20,20,22,20,7,1,0,96,WKK Wrocław,Sezon 2021/2022
2022-04-10 18:00,Weegree AZS Politechnika Opolska(d),86 : 82W,86,17,33,51.5,15,35,42.9,32,68,47.1,7,9,77.8,9,29,38,26,25,17,17,3,3,2,101,WKK Wrocław,Sezon 2021/2022
2022-04-19 19:00,Sensation Kotwica Kołobrzeg(w),65 : 66W,66,13,37,35.1,11,31,35.5,24,68,35.3,7,14,50.0,7,33,40,14,17,17,9,2,2,4,64,WKK Wrocław,Sezon 2021/2022
2022-04-20 19:00,Sensation Kotwica Kołobrzeg(w),82 : 49P,49,16,38,42.1,1,15,6.7,17,53,32.1,14,26,53.8,2,27,29,6,13,19,17,8,3,3,30,WKK Wrocław,Sezon 2021/2022
2022-04-23 18:00,Sensation Kotwica Kołobrzeg(d),60 : 82P,60,13,34,38.2,6,21,28.6,19,55,34.5,16,21,76.2,4,20,24,11,14,21,15,7,6,6,52,WKK Wrocław,Sezon 2021/2022
2022-04-24 18:00,Sensation Kotwica Kołobrzeg(d),79 : 67W,79,17,36,47.2,8,21,38.1,25,57,43.9,21,25,84.0,6,33,39,24,11,23,15,6,1,5,98,WKK Wrocław,Sezon 2021/2022
2022-04-27 19:00,Sensation Kotwica Kołobrzeg(w),84 : 67P,67,12,28,42.9,6,23,26.1,18,51,35.3,25,32,78.1,5,33,38,12,16,21,13,2,0,2,66,WKK Wrocław,Sezon 2021/2022
2021-09-25 17:00,Decka Pelplin(w),63 : 58P,58,16,38,42.1,4,26,15.4,20,64,31.3,14,25,56.0,6,26,32,11,19,22,7,11,1,1,51,Znicz Basket Pruszków,Sezon 2021/2022
2021-10-02 20:00,Miasto Szkła Krosno(w),79 : 70P,70,19,35,54.3,8,24,33.3,27,59,45.8,8,13,61.5,6,27,33,16,18,20,18,6,4,1,74,Znicz Basket Pruszków,Sezon 2021/2022
2021-10-10 18:30,AZS UMCS Start II Lublin(w),103 : 64P,64,13,31,41.9,7,30,23.3,20,61,32.8,17,24,70.8,6,14,20,14,22,25,12,9,2,5,49,Znicz Basket Pruszków,Sezon 2021/2022
2021-10-16 18:00,Weegree AZS Politechnika Opolska(d),81 : 70W,81,20,29,69.0,11,28,39.3,31,57,54.4,8,14,57.1,5,25,30,21,23,18,10,8,3,0,101,Znicz Basket Pruszków,Sezon 2021/2022
2021-10-20 18:00,Dziki Warszawa(w),67 : 48P,48,11,31,35.5,2,26,7.7,13,57,22.8,20,26,76.9,14,26,40,9,15,24,19,5,2,2,35,Znicz Basket Pruszków,Sezon 2021/2022
2021-10-24 17:00,KS Księżak Łowicz(d),56 : 70P,56,12,35,34.3,8,29,27.6,20,64,31.3,8,13,61.5,10,29,39,14,22,18,20,11,2,1,53,Znicz Basket Pruszków,Sezon 2021/2022
2021-10-30 18:00,SKS Starogard Gdański(w),91 : 76P,76,24,52,46.2,6,19,31.6,30,71,42.3,10,20,50.0,10,26,36,15,21,21,16,7,4,6,71,Znicz Basket Pruszków,Sezon 2021/2022
2021-11-06 18:00,WKK Wrocław(w),96 : 79P,79,21,40,52.5,7,22,31.8,28,62,45.2,16,26,61.5,6,25,31,19,23,26,16,7,0,2,76,Znicz Basket Pruszków,Sezon 2021/2022
2021-11-14 17:00,TBS Śląsk II Wrocław(d),76 : 81P,76,18,36,50.0,6,28,21.4,24,64,37.5,22,31,71.0,8,28,36,12,24,26,14,7,1,5,69,Znicz Basket Pruszków,Sezon 2021/2022
2021-11-17 18:00,Rawlplug Sokół Łańcut(w),86 : 96W,96,21,39,53.8,12,28,42.9,33,67,49.3,18,24,75.0,9,26,35,21,18,25,13,9,0,3,108,Znicz Basket Pruszków,Sezon 2021/2022
2021-11-21 17:00,GKS Tychy(d),53 : 72P,53,17,33,51.5,5,26,19.2,22,59,37.3,4,12,33.3,7,23,30,14,17,19,18,6,4,2,44,Znicz Basket Pruszków,Sezon 2021/2022
2021-12-04 18:00,Górnik Trans.eu Wałbrzych(d),82 : 94P,82,21,33,63.6,8,32,25.0,29,65,44.6,16,19,84.2,12,31,43,17,29,21,16,1,2,2,90,Znicz Basket Pruszków,Sezon 2021/2022
2021-12-11 18:00,Sensation Kotwica Kołobrzeg(w),91 : 74P,74,19,42,45.2,10,33,30.3,29,75,38.7,6,9,66.7,13,23,36,11,21,15,15,6,0,3,63,Znicz Basket Pruszków,Sezon 2021/2022
2021-12-15 19:00,AZS AGH Kraków(d),68 : 86P,68,19,40,47.5,6,18,33.3,25,58,43.1,12,16,75.0,8,23,31,11,13,24,18,6,3,2,64,Znicz Basket Pruszków,Sezon 2021/2022
2021-12-19 17:00,MKKS Żak Koszalin(w),80 : 71P,71,17,34,50.0,7,28,25.0,24,62,38.7,16,23,69.6,6,24,30,12,20,20,11,4,2,3,63,Znicz Basket Pruszków,Sezon 2021/2022
2022-01-09 17:00,Decka Pelplin(d),71 : 77P,71,13,24,54.2,10,37,27.0,23,61,37.7,15,24,62.5,12,20,32,14,17,25,12,9,4,2,71,Znicz Basket Pruszków,Sezon 2021/2022
2022-01-15 18:00,Miasto Szkła Krosno(d),86 : 79W,86,19,31,61.3,10,22,45.5,29,53,54.7,18,26,69.2,5,23,28,15,24,25,16,5,1,1,87,Znicz Basket Pruszków,Sezon 2021/2022
2022-01-22 18:00,AZS UMCS Start II Lublin(d),74 : 61W,74,21,46,45.7,7,29,24.1,28,75,37.3,11,16,68.8,20,23,43,12,21,23,12,10,1,4,76,Znicz Basket Pruszków,Sezon 2021/2022
2022-01-29 17:30,Weegree AZS Politechnika Opolska(w),86 : 71P,71,17,38,44.7,7,19,36.8,24,57,42.1,16,22,72.7,6,28,34,19,18,20,17,8,2,3,78,Znicz Basket Pruszków,Sezon 2021/2022
2022-02-02 19:00,Dziki Warszawa(d),82 : 77W,82,19,29,65.5,9,27,33.3,28,56,50.0,17,24,70.8,8,23,31,14,21,21,16,10,2,1,88,Znicz Basket Pruszków,Sezon 2021/2022
2022-02-12 18:00,SKS Starogard Gdański(d),80 : 82P,80,20,44,45.5,9,36,25.0,29,80,36.3,13,19,68.4,14,37,51,18,25,19,17,10,0,2,85,Znicz Basket Pruszków,Sezon 2021/2022
2022-02-19 18:00,WKK Wrocław(d),81 : 69W,81,18,36,50.0,9,26,34.6,27,62,43.5,18,22,81.8,8,29,37,17,22,23,14,6,2,3,90,Znicz Basket Pruszków,Sezon 2021/2022
2022-02-25 19:30,TBS Śląsk II Wrocław(w),89 : 86P,86,20,42,47.6,7,33,21.2,27,75,36.0,25,32,78.1,15,29,44,13,20,23,11,4,3,2,84,Znicz Basket Pruszków,Sezon 2021/2022
2022-03-02 19:00,Rawlplug Sokół Łańcut(d),67 : 84P,67,22,51,43.1,6,20,30.0,28,71,39.4,5,7,71.4,10,18,28,14,20,12,12,10,1,4,63,Znicz Basket Pruszków,Sezon 2021/2022
2022-03-05 18:00,GKS Tychy(w),89 : 64P,64,17,35,48.6,5,18,27.8,22,53,41.5,15,20,75.0,3,25,28,13,24,24,18,5,0,2,56,Znicz Basket Pruszków,Sezon 2021/2022
2022-03-11 19:00,PGE Turów Zgorzelec(d),94 : 95P,94,21,47,44.7,13,31,41.9,34,78,43.6,13,16,81.3,7,21,28,23,17,23,12,11,2,2,99,Znicz Basket Pruszków,Sezon 2021/2022
2022-03-16 19:00,KS Księżak Łowicz(w),86 : 91W,91,23,45,51.1,11,28,39.3,34,73,46.6,12,22,54.5,16,19,35,16,23,24,16,6,1,1,84,Znicz Basket Pruszków,Sezon 2021/2022
2022-03-19 17:00,Górnik Trans.eu Wałbrzych(w),86 : 76P,76,15,36,41.7,8,30,26.7,23,66,34.8,22,28,78.6,5,25,30,14,17,22,9,7,1,5,70,Znicz Basket Pruszków,Sezon 2021/2022
2022-03-24 19:00,Sensation Kotwica Kołobrzeg(d),83 : 106P,83,20,42,47.6,10,22,45.5,30,64,46.9,13,21,61.9,8,19,27,19,13,21,14,7,0,2,80,Znicz Basket Pruszków,Sezon 2021/2022
2022-03-30 19:30,AZS AGH Kraków(w),79 : 83W,83,22,42,52.4,6,18,33.3,28,60,46.7,21,25,84.0,9,28,37,15,19,26,16,5,0,3,88,Znicz Basket Pruszków,Sezon 2021/2022
2022-04-03 17:00,MKKS Żak Koszalin(d),70 : 101P,70,19,36,52.8,7,29,24.1,26,65,40.0,11,12,91.7,9,16,25,14,16,18,19,8,2,3,60,Znicz Basket Pruszków,Sezon 2021/2022
2022-04-10 18:00,PGE Turów Zgorzelec(w),92 : 72P,72,15,41,36.6,10,37,27.0,25,78,32.1,12,14,85.7,13,24,37,14,26,17,12,6,2,3,64,Znicz Basket Pruszków,Sezon 2021/2022
2020-09-26 17:00,WKK Wrocław(d),77 : 93P,77,16,42,38.1,10,31,32.3,26,73,35.6,15,22,68.2,10,24,34,17,19,20,17,11,1,7,69,Decka Pelplin,Sezon 2020/2021
2020-10-03 18:00,Grupa Sierleccy-Czarni Słupsk(w),89 : 78P,78,17,42,40.5,10,35,28.6,27,77,35.1,14,19,73.7,12,25,37,15,15,18,11,7,4,3,75,Decka Pelplin,Sezon 2020/2021
2020-10-10 17:00,Elektrobud-Investment ZB Pruszków(d),83 : 85P,83,18,35,51.4,6,26,23.1,24,61,39.3,29,41,70.7,10,23,33,17,26,28,14,12,1,1,83,Decka Pelplin,Sezon 2020/2021
2020-10-14 19:00,KS Księżak Łowicz(w),97 : 83P,83,19,43,44.2,8,23,34.8,27,66,40.9,21,26,80.8,5,21,26,15,19,23,14,9,2,6,77,Decka Pelplin,Sezon 2020/2021
2020-10-17 16:00,Rawlplug Sokół Łańcut(d),94 : 92W,94,23,33,69.7,7,21,33.3,30,54,55.6,27,32,84.4,10,19,29,18,21,25,19,8,5,1,106,Decka Pelplin,Sezon 2020/2021
2020-10-25 18:00,GKS Tychy(w),99 : 92P,92,20,38,52.6,10,23,43.5,30,61,49.2,22,25,88.0,8,23,31,25,20,23,20,3,2,5,99,Decka Pelplin,Sezon 2020/2021
2020-10-31 17:00,Zetkama Doral Nysa Kłodzko(d),98 : 91W,98,21,42,50.0,9,21,42.9,30,63,47.6,29,36,80.6,7,21,28,25,20,24,11,5,0,3,105,Decka Pelplin,Sezon 2020/2021
2020-11-07 18:00,TBS Śląsk II Wrocław(w),82 : 83W,83,15,38,39.5,9,19,47.4,24,57,42.1,26,34,76.5,10,25,35,14,21,23,15,8,2,2,86,Decka Pelplin,Sezon 2020/2021
2020-11-11 18:00,Pogoń Prudnik(d),80 : 77W,80,20,36,55.6,8,23,34.8,28,59,47.5,16,22,72.7,8,21,29,17,12,19,14,7,6,3,88,Decka Pelplin,Sezon 2020/2021
2020-11-15 17:00,Miasto Szkła Krosno(w),99 : 83P,83,18,30,60.0,8,23,34.8,26,53,49.1,23,32,71.9,6,23,29,19,18,25,23,8,1,2,81,Decka Pelplin,Sezon 2020/2021
2020-11-21 17:00,Weegree AZS Politechnika Opolska(d),80 : 97P,80,20,34,58.8,7,19,36.8,27,53,50.9,19,25,76.0,3,27,30,15,24,23,19,6,3,4,83,Decka Pelplin,Sezon 2020/2021
2020-11-28 17:00,Dziki Warszawa(d),92 : 74W,92,24,49,49.0,10,21,47.6,34,70,48.6,14,18,77.8,10,30,40,23,11,17,12,8,3,1,114,Decka Pelplin,Sezon 2020/2021
2020-12-05 18:00,Energa Kotwica Kołobrzeg(w),80 : 72P,72,17,35,48.6,7,29,24.1,24,64,37.5,17,23,73.9,4,24,28,10,19,22,9,7,1,2,63,Decka Pelplin,Sezon 2020/2021
2020-12-12 17:00,Górnik Trans.eu Wałbrzych(d),72 : 95P,72,22,40,55.0,5,22,22.7,27,62,43.5,13,16,81.3,6,22,28,12,20,20,13,5,5,4,71,Decka Pelplin,Sezon 2020/2021
2020-12-19 18:00,TS Wisła Chemart Kraków(w),75 : 92W,92,24,36,66.7,11,30,36.7,35,66,53.0,11,12,91.7,7,23,30,23,25,16,21,14,4,0,110,Decka Pelplin,Sezon 2020/2021
2021-01-03 18:00,WKK Wrocław(w),95 : 92P,92,21,40,52.5,12,31,38.7,33,71,46.5,14,16,87.5,4,19,23,25,29,18,10,5,5,6,100,Decka Pelplin,Sezon 2020/2021
2021-01-09 17:00,Grupa Sierleccy-Czarni Słupsk(d),83 : 82W,83,21,38,55.3,9,24,37.5,30,62,48.4,14,18,77.8,8,21,29,17,16,19,13,2,2,0,84,Decka Pelplin,Sezon 2020/2021
2021-01-16 18:00,Elektrobud-Investment ZB Pruszków(w),92 : 75P,75,15,29,51.7,10,24,41.7,25,53,47.2,15,17,88.2,4,23,27,19,19,19,19,5,0,5,77,Decka Pelplin,Sezon 2020/2021
2021-01-20 18:00,KS Księżak Łowicz(d),87 : 95P,87,24,38,63.2,7,26,26.9,31,64,48.4,18,24,75.0,8,22,30,23,21,17,13,11,4,0,103,Decka Pelplin,Sezon 2020/2021
2021-01-23 17:30,Rawlplug Sokół Łańcut(w),98 : 91P,91,24,40,60.0,9,24,37.5,33,64,51.6,16,19,84.2,10,19,29,13,18,21,18,8,2,1,91,Decka Pelplin,Sezon 2020/2021
2021-01-30 17:00,GKS Tychy(d),65 : 73P,65,12,26,46.2,10,31,32.3,22,57,38.6,11,13,84.6,10,26,36,16,22,20,17,4,7,2,74,Decka Pelplin,Sezon 2020/2021
2021-02-06 17:00,Zetkama Doral Nysa Kłodzko(w),74 : 84W,84,20,39,51.3,13,26,50.0,33,65,50.8,5,9,55.6,9,30,39,15,16,12,16,9,3,0,98,Decka Pelplin,Sezon 2020/2021
2021-02-16 18:00,TBS Śląsk II Wrocław(d),69 : 82P,69,14,30,46.7,10,24,41.7,24,54,44.4,11,17,64.7,5,21,26,16,16,18,14,4,1,1,66,Decka Pelplin,Sezon 2020/2021
2021-02-20 17:30,Pogoń Prudnik(w),76 : 85W,85,27,49,55.1,6,17,35.3,33,66,50.0,13,15,86.7,7,29,36,22,19,18,16,10,3,4,105,Decka Pelplin,Sezon 2020/2021
2021-02-27 17:00,Miasto Szkła Krosno(d),83 : 91P,83,21,38,55.3,7,20,35.0,28,58,48.3,20,28,71.4,4,18,22,20,18,23,13,11,3,0,88,Decka Pelplin,Sezon 2020/2021
2021-03-06 17:30,Weegree AZS Politechnika Opolska(w),107 : 82P,82,25,40,62.5,5,25,20.0,30,65,46.2,17,21,81.0,3,23,26,18,22,19,15,10,1,5,83,Decka Pelplin,Sezon 2020/2021
2021-03-13 18:00,Dziki Warszawa(w),73 : 70P,70,18,45,40.0,5,18,27.8,23,63,36.5,19,24,79.2,7,32,39,19,18,23,14,6,6,4,81,Decka Pelplin,Sezon 2020/2021
2021-03-20 17:00,Energa Kotwica Kołobrzeg(d),66 : 74P,66,21,38,55.3,5,26,19.2,26,64,40.6,9,14,64.3,8,24,32,12,18,12,11,2,2,1,60,Decka Pelplin,Sezon 2020/2021
2021-03-27 17:00,Górnik Trans.eu Wałbrzych(w),93 : 87P,87,13,31,41.9,10,22,45.5,23,53,43.4,31,41,75.6,8,25,33,16,24,27,16,4,2,3,86,Decka Pelplin,Sezon 2020/2021
2021-03-31 18:00,TS Wisła Chemart Kraków(d),105 : 78W,105,31,46,67.4,9,26,34.6,40,72,55.6,16,23,69.6,7,25,32,24,15,22,9,12,5,2,130,Decka Pelplin,Sezon 2020/2021
2020-09-26 18:00,TS Wisła Chemart Kraków(d),84 : 62W,84,25,45,55.6,9,29,31.0,34,74,45.9,7,14,50.0,15,29,44,18,16,18,11,9,6,0,103,Dziki Warszawa,Sezon 2020/2021
2020-10-03 18:00,WKK Wrocław(w),98 : 105W,105,18,35,51.4,15,25,60.0,33,60,55.0,24,32,75.0,4,24,28,19,28,28,12,7,1,4,113,Dziki Warszawa,Sezon 2020/2021
2020-10-10 18:00,Grupa Sierleccy-Czarni Słupsk(d),66 : 73P,66,14,36,38.9,10,24,41.7,24,60,40.0,8,15,53.3,3,28,31,17,21,22,17,9,1,3,64,Dziki Warszawa,Sezon 2020/2021
2020-10-17 18:00,KS Księżak Łowicz(d),97 : 95W,97,21,36,58.3,12,36,33.3,33,72,45.8,19,27,70.4,9,20,29,27,25,20,10,7,2,0,105,Dziki Warszawa,Sezon 2020/2021
2020-10-24 17:30,Rawlplug Sokół Łańcut(w),93 : 86P,86,17,35,48.6,13,31,41.9,30,66,45.5,13,15,86.7,6,20,26,15,27,18,14,9,3,2,87,Dziki Warszawa,Sezon 2020/2021
2020-11-11 18:00,TBS Śląsk II Wrocław(d),84 : 63W,84,19,37,51.4,12,25,48.0,31,62,50.0,10,20,50.0,7,37,44,25,22,21,15,5,5,0,107,Dziki Warszawa,Sezon 2020/2021
2020-11-14 17:30,Pogoń Prudnik(w),78 : 76P,76,19,36,52.8,7,29,24.1,26,65,40.0,17,24,70.8,15,21,36,19,23,23,15,5,4,0,79,Dziki Warszawa,Sezon 2020/2021
2020-11-18 18:00,GKS Tychy(d),64 : 82P,64,17,34,50.0,7,33,21.2,24,67,35.8,9,19,47.4,10,19,29,18,15,17,14,13,5,3,62,Dziki Warszawa,Sezon 2020/2021
2020-11-21 18:00,Miasto Szkła Krosno(d),69 : 61W,69,16,32,50.0,6,23,26.1,22,55,40.0,19,25,76.0,8,23,31,16,19,26,13,6,3,2,73,Dziki Warszawa,Sezon 2020/2021
2020-11-28 17:00,Decka Pelplin(w),92 : 74P,74,19,40,47.5,9,32,28.1,28,72,38.9,9,11,81.8,9,25,34,16,17,11,14,8,1,3,73,Dziki Warszawa,Sezon 2020/2021
2020-12-02 18:00,Elektrobud-Investment ZB Pruszków(w),81 : 72P,72,20,36,55.6,7,22,31.8,27,58,46.6,11,17,64.7,11,18,29,15,20,22,15,5,1,2,70,Dziki Warszawa,Sezon 2020/2021
2020-12-05 18:00,Weegree AZS Politechnika Opolska(d),98 : 88W,98,24,39,61.5,12,33,36.4,36,72,50.0,14,24,58.3,11,23,34,24,20,21,10,8,2,3,110,Dziki Warszawa,Sezon 2020/2021
2020-12-09 18:00,Zetkama Doral Nysa Kłodzko(d),92 : 60W,92,28,53,52.8,11,33,33.3,39,86,45.3,3,10,30.0,18,19,37,26,20,17,9,14,4,2,110,Dziki Warszawa,Sezon 2020/2021
2020-12-12 18:00,Energa Kotwica Kołobrzeg(d),84 : 68W,84,26,48,54.2,6,18,33.3,32,66,48.5,14,24,58.3,14,24,38,18,27,24,18,8,5,3,91,Dziki Warszawa,Sezon 2020/2021
2020-12-20 16:00,Górnik Trans.eu Wałbrzych(w),77 : 63P,63,13,33,39.4,5,21,23.8,18,54,33.3,22,32,68.8,7,22,29,11,23,23,17,6,3,2,49,Dziki Warszawa,Sezon 2020/2021
2021-01-03 18:00,TS Wisła Chemart Kraków(w),75 : 91W,91,23,34,67.6,11,27,40.7,34,61,55.7,12,23,52.2,14,24,38,22,19,18,12,6,4,0,111,Dziki Warszawa,Sezon 2020/2021
2021-01-09 18:00,WKK Wrocław(d),86 : 73W,86,19,41,46.3,12,27,44.4,31,68,45.6,12,15,80.0,5,30,35,25,20,18,11,11,2,2,108,Dziki Warszawa,Sezon 2020/2021
2021-01-16 18:00,Grupa Sierleccy-Czarni Słupsk(w),65 : 62P,62,13,35,37.1,9,29,31.0,22,64,34.4,9,13,69.2,12,34,46,14,24,19,14,3,4,2,69,Dziki Warszawa,Sezon 2020/2021
2021-01-20 18:00,Elektrobud-Investment ZB Pruszków(d),72 : 78P,72,22,42,52.4,5,18,27.8,27,60,45.0,13,20,65.0,10,19,29,17,22,18,15,10,3,2,76,Dziki Warszawa,Sezon 2020/2021
2021-01-25 19:00,KS Księżak Łowicz(w),98 : 86P,86,27,44,61.4,7,28,25.0,34,72,47.2,11,13,84.6,5,28,33,15,23,21,20,8,2,1,84,Dziki Warszawa,Sezon 2020/2021
2021-01-30 18:00,Rawlplug Sokół Łańcut(d),74 : 96P,74,27,48,56.3,4,25,16.0,31,73,42.5,8,9,88.9,8,22,30,17,24,13,16,9,2,2,73,Dziki Warszawa,Sezon 2020/2021
2021-02-06 18:00,GKS Tychy(w),82 : 71P,71,20,31,64.5,6,23,26.1,26,54,48.1,13,16,81.3,5,17,22,11,18,20,22,16,0,2,67,Dziki Warszawa,Sezon 2020/2021
2021-02-21 15:00,TBS Śląsk II Wrocław(w),96 : 77P,77,20,41,48.8,9,27,33.3,29,68,42.6,10,18,55.6,5,20,25,14,19,22,11,10,3,3,71,Dziki Warszawa,Sezon 2020/2021
2021-02-27 18:00,Pogoń Prudnik(d),78 : 71W,78,20,42,47.6,8,24,33.3,28,66,42.4,14,19,73.7,12,25,37,20,20,21,14,6,4,1,88,Dziki Warszawa,Sezon 2020/2021
2021-03-06 17:00,Miasto Szkła Krosno(w),87 : 82P,82,16,29,55.2,9,28,32.1,25,57,43.9,23,25,92.0,6,19,25,11,24,21,19,10,2,0,77,Dziki Warszawa,Sezon 2020/2021
2021-03-10 19:00,Zetkama Doral Nysa Kłodzko(w),91 : 85P,85,21,41,51.2,7,23,30.4,28,64,43.8,22,25,88.0,10,19,29,15,30,24,16,10,1,1,85,Dziki Warszawa,Sezon 2020/2021
2021-03-13 18:00,Decka Pelplin(d),73 : 70W,73,19,44,43.2,8,30,26.7,27,74,36.5,11,16,68.8,13,28,41,20,23,18,13,12,4,6,85,Dziki Warszawa,Sezon 2020/2021
2021-03-20 17:30,Weegree AZS Politechnika Opolska(w),89 : 96W,96,18,28,64.3,11,26,42.3,29,54,53.7,27,33,81.8,5,24,29,15,29,27,20,6,4,1,99,Dziki Warszawa,Sezon 2020/2021
2021-03-27 17:00,Energa Kotwica Kołobrzeg(w),80 : 75P,75,19,40,47.5,7,25,28.0,26,65,40.0,16,20,80.0,16,26,42,15,18,16,19,10,2,1,82,Dziki Warszawa,Sezon 2020/2021
2021-03-31 18:00,Górnik Trans.eu Wałbrzych(d),67 : 96P,67,17,46,37.0,8,25,32.0,25,71,35.2,9,18,50.0,11,24,35,21,21,15,16,6,6,3,64,Dziki Warszawa,Sezon 2020/2021
2020-09-27 17:30,Pogoń Prudnik(w),58 : 56P,56,16,34,47.1,4,28,14.3,20,62,32.3,12,19,63.2,7,23,30,18,18,21,12,8,1,3,52,Elektrobud-Investment ZB Pruszków,Sezon 2020/2021
2020-10-03 18:00,Miasto Szkła Krosno(d),67 : 77P,67,10,26,38.5,8,26,30.8,18,52,34.6,23,35,65.7,8,25,33,15,22,29,19,6,5,4,61,Elektrobud-Investment ZB Pruszków,Sezon 2020/2021
2020-10-10 17:00,Decka Pelplin(w),83 : 85W,85,22,39,56.4,11,27,40.7,33,66,50.0,8,20,40.0,10,27,37,16,29,26,17,9,1,1,86,Elektrobud-Investment ZB Pruszków,Sezon 2020/2021
2020-10-31 18:00,TS Wisła Chemart Kraków(w),55 : 61W,61,17,42,40.5,4,18,22.2,21,60,35.0,15,20,75.0,9,27,36,14,18,18,17,10,4,4,64,Elektrobud-Investment ZB Pruszków,Sezon 2020/2021
2020-11-04 19:00,Energa Kotwica Kołobrzeg(w),72 : 56P,56,16,32,50.0,6,36,16.7,22,68,32.4,6,9,66.7,7,25,32,13,18,17,15,6,0,2,43,Elektrobud-Investment ZB Pruszków,Sezon 2020/2021
2020-11-08 17:00,WKK Wrocław(d),56 : 64P,56,16,43,37.2,6,25,24.0,22,68,32.4,6,7,85.7,13,24,37,12,22,13,23,6,2,5,43,Elektrobud-Investment ZB Pruszków,Sezon 2020/2021
2020-11-11 18:00,Grupa Sierleccy-Czarni Słupsk(w),73 : 60P,60,13,39,33.3,8,22,36.4,21,61,34.4,10,18,55.6,10,23,33,15,13,18,13,9,0,6,56,Elektrobud-Investment ZB Pruszków,Sezon 2020/2021
2020-11-14 17:30,Weegree AZS Politechnika Opolska(w),97 : 92P,92,22,38,57.9,10,27,37.0,32,65,49.2,18,25,72.0,11,18,29,24,23,20,20,10,0,7,95,Elektrobud-Investment ZB Pruszków,Sezon 2020/2021
2020-11-22 17:00,KS Księżak Łowicz(d),63 : 54W,63,10,27,37.0,9,28,32.1,19,55,34.5,16,26,61.5,7,24,31,12,22,21,11,13,3,2,65,Elektrobud-Investment ZB Pruszków,Sezon 2020/2021
2020-11-25 18:00,Górnik Trans.eu Wałbrzych(d),58 : 80P,58,11,28,39.3,8,28,28.6,19,56,33.9,12,20,60.0,6,23,29,15,23,23,15,3,2,2,47,Elektrobud-Investment ZB Pruszków,Sezon 2020/2021
2020-11-28 17:30,Rawlplug Sokół Łańcut(w),83 : 49P,49,18,37,48.6,4,25,16.0,22,62,35.5,1,1,100.0,4,22,26,13,19,11,12,7,0,1,43,Elektrobud-Investment ZB Pruszków,Sezon 2020/2021
2020-12-02 18:00,Dziki Warszawa(d),81 : 72W,81,18,36,50.0,10,23,43.5,28,59,47.5,15,21,71.4,11,21,32,21,23,20,14,6,2,1,91,Elektrobud-Investment ZB Pruszków,Sezon 2020/2021
2020-12-06 17:00,GKS Tychy(d),86 : 80W,86,24,46,52.2,11,24,45.8,35,70,50.0,5,5,100.0,7,18,25,22,25,14,21,19,1,1,97,Elektrobud-Investment ZB Pruszków,Sezon 2020/2021
2020-12-13 16:00,Zetkama Doral Nysa Kłodzko(w),60 : 95W,95,26,37,70.3,10,27,37.0,36,64,56.3,13,17,76.5,6,27,33,15,18,16,10,9,1,0,111,Elektrobud-Investment ZB Pruszków,Sezon 2020/2021
2020-12-19 18:00,TBS Śląsk II Wrocław(d),97 : 78W,97,20,27,74.1,14,30,46.7,34,57,59.6,15,19,78.9,5,22,27,23,31,18,15,10,5,1,120,Elektrobud-Investment ZB Pruszków,Sezon 2020/2021
2021-01-02 18:00,Pogoń Prudnik(d),71 : 61W,71,20,31,64.5,7,25,28.0,27,56,48.2,10,20,50.0,10,22,32,19,14,20,16,12,1,2,80,Elektrobud-Investment ZB Pruszków,Sezon 2020/2021
2021-01-10 17:00,Miasto Szkła Krosno(w),73 : 80W,80,18,33,54.5,8,17,47.1,26,50,52.0,20,30,66.7,6,29,35,16,19,24,21,10,0,3,86,Elektrobud-Investment ZB Pruszków,Sezon 2020/2021
2021-01-16 18:00,Decka Pelplin(d),92 : 75W,92,23,40,57.5,9,24,37.5,32,64,50.0,19,23,82.6,9,22,31,19,19,19,7,14,5,0,118,Elektrobud-Investment ZB Pruszków,Sezon 2020/2021
2021-01-20 18:00,Dziki Warszawa(w),72 : 78W,78,25,51,49.0,5,21,23.8,30,72,41.7,13,15,86.7,16,21,37,17,18,20,13,8,2,3,85,Elektrobud-Investment ZB Pruszków,Sezon 2020/2021
2021-01-24 17:00,Energa Kotwica Kołobrzeg(d),87 : 61W,87,26,45,57.8,7,26,26.9,33,71,46.5,14,17,82.4,11,25,36,19,19,21,11,12,2,5,104,Elektrobud-Investment ZB Pruszków,Sezon 2020/2021
2021-01-30 17:00,Górnik Trans.eu Wałbrzych(w),69 : 56P,56,12,32,37.5,4,24,16.7,16,56,28.6,20,28,71.4,12,23,35,11,18,22,12,9,1,2,52,Elektrobud-Investment ZB Pruszków,Sezon 2020/2021
2021-02-06 18:00,TS Wisła Chemart Kraków(d),73 : 59W,73,19,36,52.8,10,25,40.0,29,61,47.5,5,13,38.5,8,27,35,20,14,16,17,11,3,5,85,Elektrobud-Investment ZB Pruszków,Sezon 2020/2021
2021-02-13 18:00,WKK Wrocław(w),103 : 67P,67,17,43,39.5,7,20,35.0,24,63,38.1,12,20,60.0,7,20,27,20,27,21,17,10,1,2,61,Elektrobud-Investment ZB Pruszków,Sezon 2020/2021
2021-02-20 18:00,Grupa Sierleccy-Czarni Słupsk(d),56 : 87P,56,11,29,37.9,8,22,36.4,19,51,37.3,10,16,62.5,5,13,18,12,17,17,16,7,2,0,41,Elektrobud-Investment ZB Pruszków,Sezon 2020/2021
2021-02-28 17:00,Weegree AZS Politechnika Opolska(d),67 : 72P,67,11,32,34.4,10,36,27.8,21,68,30.9,15,19,78.9,15,23,38,16,27,19,17,10,3,6,66,Elektrobud-Investment ZB Pruszków,Sezon 2020/2021
2021-03-06 18:00,KS Księżak Łowicz(w),78 : 79W,79,15,29,51.7,12,28,42.9,27,57,47.4,13,19,68.4,3,24,27,15,23,22,13,11,1,2,84,Elektrobud-Investment ZB Pruszków,Sezon 2020/2021
2021-03-13 18:00,Rawlplug Sokół Łańcut(d),73 : 76P,73,24,44,54.5,7,24,29.2,31,68,45.6,4,7,57.1,8,24,32,18,25,11,13,11,2,2,83,Elektrobud-Investment ZB Pruszków,Sezon 2020/2021
2021-03-20 19:30,GKS Tychy(w),72 : 92W,92,29,41,70.7,7,26,26.9,36,67,53.7,13,15,86.7,7,24,31,18,22,21,16,13,2,3,107,Elektrobud-Investment ZB Pruszków,Sezon 2020/2021
2021-03-28 17:00,Zetkama Doral Nysa Kłodzko(d),84 : 69W,84,17,41,41.5,13,27,48.1,30,68,44.1,11,21,52.4,10,35,45,19,17,20,17,5,3,3,91,Elektrobud-Investment ZB Pruszków,Sezon 2020/2021
2021-03-31 18:00,TBS Śląsk II Wrocław(w),75 : 66P,66,12,30,40.0,8,25,32.0,20,55,36.4,18,25,72.0,8,22,30,17,21,22,16,5,0,3,60,Elektrobud-Investment ZB Pruszków,Sezon 2020/2021
2021-04-10 18:00,Grupa Sierleccy-Czarni Słupsk(w),90 : 82P,82,18,27,66.7,10,25,40.0,28,52,53.8,16,27,59.3,6,22,28,19,21,20,16,6,3,0,87,Elektrobud-Investment ZB Pruszków,Sezon 2020/2021
2021-04-11 18:00,Grupa Sierleccy-Czarni Słupsk(w),84 : 75P,75,15,34,44.1,13,34,38.2,28,68,41.2,6,14,42.9,9,21,30,16,17,18,9,6,2,7,72,Elektrobud-Investment ZB Pruszków,Sezon 2020/2021
2021-04-17 15:30,Grupa Sierleccy-Czarni Słupsk(d),65 : 85P,65,16,30,53.3,6,23,26.1,22,53,41.5,15,22,68.2,10,16,26,17,20,18,15,8,2,3,65,Elektrobud-Investment ZB Pruszków,Sezon 2020/2021
2020-09-26 18:30,Górnik Trans.eu Wałbrzych(d),85 : 91P,85,27,43,62.8,9,30,30.0,36,73,49.3,4,12,33.3,13,28,41,21,24,17,15,5,1,1,93,Energa Kotwica Kołobrzeg,Sezon 2020/2021
2020-10-03 18:00,TS Wisła Chemart Kraków(w),78 : 75P,75,19,47,40.4,7,21,33.3,26,68,38.2,16,22,72.7,8,31,39,15,22,20,9,7,1,6,80,Energa Kotwica Kołobrzeg,Sezon 2020/2021
2020-10-10 18:00,WKK Wrocław(d),73 : 80P,73,17,47,36.2,9,21,42.9,26,68,38.2,12,19,63.2,14,27,41,11,23,22,19,9,1,4,67,Energa Kotwica Kołobrzeg,Sezon 2020/2021
2020-10-14 18:00,Grupa Sierleccy-Czarni Słupsk(w),82 : 63P,63,19,38,50.0,5,20,25.0,24,58,41.4,10,17,58.8,5,21,26,13,18,24,18,8,1,1,52,Energa Kotwica Kołobrzeg,Sezon 2020/2021
2020-10-24 18:00,KS Księżak Łowicz(w),82 : 75P,75,17,38,44.7,8,32,25.0,25,70,35.7,17,19,89.5,6,21,27,14,21,20,16,9,2,2,64,Energa Kotwica Kołobrzeg,Sezon 2020/2021
2020-11-04 19:00,Elektrobud-Investment ZB Pruszków(d),72 : 56W,72,24,53,45.3,5,13,38.5,29,66,43.9,9,15,60.0,10,37,47,13,17,18,14,7,2,0,84,Energa Kotwica Kołobrzeg,Sezon 2020/2021
2020-11-07 18:00,GKS Tychy(w),92 : 87P,87,27,45,60.0,7,23,30.4,34,68,50.0,12,17,70.6,10,23,33,17,21,20,15,7,2,4,92,Energa Kotwica Kołobrzeg,Sezon 2020/2021
2020-11-11 18:00,Zetkama Doral Nysa Kłodzko(d),87 : 78W,87,25,47,53.2,8,21,38.1,33,68,48.5,13,18,72.2,11,30,41,27,21,20,14,6,3,0,110,Energa Kotwica Kołobrzeg,Sezon 2020/2021
2020-11-14 13:00,TBS Śląsk II Wrocław(w),77 : 74P,74,20,49,40.8,6,26,23.1,26,75,34.7,16,26,61.5,12,32,44,17,22,22,17,9,7,4,75,Energa Kotwica Kołobrzeg,Sezon 2020/2021
2020-11-18 18:00,Rawlplug Sokół Łańcut(d),82 : 69W,82,18,38,47.4,12,26,46.2,30,64,46.9,10,15,66.7,10,30,40,18,21,15,18,5,2,4,90,Energa Kotwica Kołobrzeg,Sezon 2020/2021
2020-11-21 18:00,Pogoń Prudnik(d),76 : 71W,76,21,39,53.8,7,27,25.9,28,66,42.4,13,22,59.1,12,25,37,19,26,22,8,6,3,0,86,Energa Kotwica Kołobrzeg,Sezon 2020/2021
2020-11-28 17:00,Miasto Szkła Krosno(w),80 : 66P,66,12,37,32.4,7,26,26.9,19,63,30.2,21,32,65.6,7,21,28,16,21,23,17,12,3,2,53,Energa Kotwica Kołobrzeg,Sezon 2020/2021
2020-12-05 18:00,Decka Pelplin(d),80 : 72W,80,15,32,46.9,13,30,43.3,28,62,45.2,11,16,68.8,8,32,40,17,22,19,16,5,2,1,89,Energa Kotwica Kołobrzeg,Sezon 2020/2021
2020-12-12 18:00,Dziki Warszawa(w),84 : 68P,68,18,40,45.0,4,16,25.0,22,56,39.3,20,30,66.7,8,21,29,13,24,27,19,9,3,5,59,Energa Kotwica Kołobrzeg,Sezon 2020/2021
2020-12-19 18:00,Weegree AZS Politechnika Opolska(d),89 : 95P,89,14,35,40.0,11,33,33.3,25,68,36.8,28,36,77.8,7,36,43,15,26,28,18,8,6,7,92,Energa Kotwica Kołobrzeg,Sezon 2020/2021
2021-01-02 17:00,Górnik Trans.eu Wałbrzych(w),88 : 79P,79,22,41,53.7,9,27,33.3,31,68,45.6,8,13,61.5,7,19,26,18,19,22,9,4,1,3,77,Energa Kotwica Kołobrzeg,Sezon 2020/2021
2021-01-09 18:00,TS Wisła Chemart Kraków(d),86 : 84W,86,22,38,57.9,10,29,34.5,32,67,47.8,12,15,80.0,10,23,33,11,24,22,14,4,1,2,83,Energa Kotwica Kołobrzeg,Sezon 2020/2021
2021-01-16 18:00,WKK Wrocław(w),89 : 83P,83,23,39,59.0,6,29,20.7,29,68,42.6,19,26,73.1,10,31,41,15,25,20,12,2,5,3,88,Energa Kotwica Kołobrzeg,Sezon 2020/2021
2021-01-20 18:00,Grupa Sierleccy-Czarni Słupsk(d),107 : 114P,107,22,45,48.9,17,41,41.5,39,86,45.3,12,15,80.0,13,31,44,22,24,19,13,2,4,1,116,Energa Kotwica Kołobrzeg,Sezon 2020/2021
2021-01-24 17:00,Elektrobud-Investment ZB Pruszków(w),87 : 61P,61,14,36,38.9,6,20,30.0,20,56,35.7,15,22,68.2,7,27,34,9,21,19,21,5,5,2,50,Energa Kotwica Kołobrzeg,Sezon 2020/2021
2021-01-30 17:00,KS Księżak Łowicz(d),66 : 57W,66,12,33,36.4,8,27,29.6,20,60,33.3,18,25,72.0,10,33,43,9,19,23,11,5,4,3,69,Energa Kotwica Kołobrzeg,Sezon 2020/2021
2021-02-06 16:30,Rawlplug Sokół Łańcut(w),92 : 76P,76,21,37,56.8,8,22,36.4,29,59,49.2,10,16,62.5,12,21,33,13,24,17,24,8,3,0,73,Energa Kotwica Kołobrzeg,Sezon 2020/2021
2021-02-13 18:00,GKS Tychy(d),92 : 97P,92,19,31,61.3,11,32,34.4,30,63,47.6,21,24,87.5,9,21,30,16,28,24,12,9,3,2,102,Energa Kotwica Kołobrzeg,Sezon 2020/2021
2021-02-20 17:00,Zetkama Doral Nysa Kłodzko(w),54 : 83W,83,21,39,53.8,10,21,47.6,31,60,51.7,11,14,78.6,8,24,32,12,19,16,20,14,2,1,91,Energa Kotwica Kołobrzeg,Sezon 2020/2021
2021-02-27 17:00,TBS Śląsk II Wrocław(d),84 : 77W,84,21,49,42.9,10,26,38.5,31,75,41.3,12,16,75.0,13,25,38,12,17,16,10,7,2,5,85,Energa Kotwica Kołobrzeg,Sezon 2020/2021
2021-03-06 17:30,Pogoń Prudnik(w),80 : 75P,75,22,38,57.9,7,24,29.2,29,62,46.8,10,11,90.9,10,19,29,17,20,16,11,8,2,1,86,Energa Kotwica Kołobrzeg,Sezon 2020/2021
2021-03-13 17:00,Miasto Szkła Krosno(d),75 : 80P,75,13,28,46.4,13,36,36.1,26,64,40.6,10,13,76.9,9,26,35,19,25,18,15,9,1,1,83,Energa Kotwica Kołobrzeg,Sezon 2020/2021
2021-03-20 17:00,Decka Pelplin(w),66 : 74W,74,20,36,55.6,6,32,18.8,26,68,38.2,16,24,66.7,15,29,44,12,14,18,7,5,1,2,79,Energa Kotwica Kołobrzeg,Sezon 2020/2021
2021-03-27 17:00,Dziki Warszawa(d),80 : 75W,80,25,43,58.1,7,26,26.9,32,69,46.4,9,13,69.2,11,25,36,17,17,17,16,8,1,2,85,Energa Kotwica Kołobrzeg,Sezon 2020/2021
2021-03-31 18:00,Weegree AZS Politechnika Opolska(w),89 : 87P,87,18,31,58.1,15,29,51.7,33,60,55.0,6,8,75.0,3,27,30,18,19,11,18,2,1,1,91,Energa Kotwica Kołobrzeg,Sezon 2020/2021
2020-09-26 18:00,Weegree AZS Politechnika Opolska(d),78 : 75W,78,17,41,41.5,9,30,30.0,26,71,36.6,17,23,73.9,9,39,48,17,24,24,18,11,8,5,93,GKS Tychy,Sezon 2020/2021
2020-10-03 18:00,Zetkama Doral Nysa Kłodzko(d),106 : 92W,106,29,40,72.5,8,17,47.1,37,57,64.9,24,32,75.0,6,23,29,27,21,25,20,6,2,2,122,GKS Tychy,Sezon 2020/2021
2020-10-21 19:00,Pogoń Prudnik(d),91 : 75W,91,31,48,64.6,6,16,37.5,37,64,57.8,11,15,73.3,9,28,37,20,18,18,18,6,4,3,109,GKS Tychy,Sezon 2020/2021
2020-10-25 18:00,Decka Pelplin(d),99 : 92W,99,36,50,72.0,5,28,17.9,41,78,52.6,12,17,70.6,12,20,32,23,23,20,9,9,5,2,117,GKS Tychy,Sezon 2020/2021
2020-10-28 19:00,TBS Śląsk II Wrocław(w),76 : 90W,90,26,37,70.3,8,25,32.0,34,62,54.8,14,24,58.3,6,28,34,18,16,18,12,8,2,4,102,GKS Tychy,Sezon 2020/2021
2020-11-07 18:00,Energa Kotwica Kołobrzeg(d),92 : 87W,92,25,48,52.1,9,26,34.6,34,74,45.9,15,21,71.4,16,21,37,18,20,21,11,8,4,2,102,GKS Tychy,Sezon 2020/2021
2020-11-11 16:00,Górnik Trans.eu Wałbrzych(w),84 : 68P,68,16,44,36.4,7,21,33.3,23,65,35.4,15,26,57.7,10,26,36,16,22,22,18,3,2,2,54,GKS Tychy,Sezon 2020/2021
2020-11-14 18:00,TS Wisła Chemart Kraków(d),74 : 87P,74,18,38,47.4,7,28,25.0,25,66,37.9,17,22,77.3,13,23,36,14,17,19,15,7,4,3,74,GKS Tychy,Sezon 2020/2021
2020-11-18 18:00,Dziki Warszawa(w),64 : 82W,82,18,40,45.0,11,25,44.0,29,65,44.6,13,15,86.7,11,29,40,21,17,15,20,9,3,5,97,GKS Tychy,Sezon 2020/2021
2020-11-22 18:00,WKK Wrocław(w),105 : 76P,76,22,50,44.0,6,26,23.1,28,76,36.8,14,18,77.8,15,15,30,21,20,15,11,9,1,7,74,GKS Tychy,Sezon 2020/2021
2020-11-25 17:30,Miasto Szkła Krosno(w),94 : 100W,100,22,36,61.1,10,29,34.5,32,65,49.2,26,32,81.3,4,36,40,14,20,24,21,4,1,2,99,GKS Tychy,Sezon 2020/2021
2020-11-29 18:00,Grupa Sierleccy-Czarni Słupsk(d),85 : 93P,85,22,35,62.9,10,25,40.0,32,60,53.3,11,13,84.6,6,22,28,20,17,18,12,6,4,3,101,GKS Tychy,Sezon 2020/2021
2020-12-06 17:00,Elektrobud-Investment ZB Pruszków(w),86 : 80P,80,23,44,52.3,5,13,38.5,28,57,49.1,19,30,63.3,9,24,33,19,14,25,31,9,1,1,71,GKS Tychy,Sezon 2020/2021
2020-12-12 19:00,KS Księżak Łowicz(d),80 : 99P,80,17,37,45.9,10,30,33.3,27,67,40.3,16,23,69.6,11,23,34,21,22,18,15,5,10,4,88,GKS Tychy,Sezon 2020/2021
2020-12-19 17:30,Rawlplug Sokół Łańcut(w),82 : 87W,87,18,42,42.9,12,27,44.4,30,69,43.5,15,20,75.0,16,24,40,19,23,20,15,6,0,5,93,GKS Tychy,Sezon 2020/2021
2021-01-03 17:30,Weegree AZS Politechnika Opolska(w),84 : 91W,91,25,44,56.8,6,17,35.3,31,61,50.8,23,28,82.1,11,24,35,13,25,24,17,9,3,3,99,GKS Tychy,Sezon 2020/2021
2021-01-09 17:00,Zetkama Doral Nysa Kłodzko(w),68 : 87W,87,27,45,60.0,8,22,36.4,35,67,52.2,9,15,60.0,10,36,46,14,28,17,20,7,4,2,100,GKS Tychy,Sezon 2020/2021
2021-01-15 18:00,TBS Śląsk II Wrocław(d),81 : 77W,81,19,39,48.7,9,20,45.0,28,59,47.5,16,18,88.9,8,29,37,16,17,19,22,8,2,5,89,GKS Tychy,Sezon 2020/2021
2021-01-20 17:30,Pogoń Prudnik(w),92 : 79P,79,20,30,66.7,10,29,34.5,30,59,50.8,9,16,56.3,5,19,24,22,21,17,14,7,1,0,83,GKS Tychy,Sezon 2020/2021
2021-01-23 18:00,Miasto Szkła Krosno(d),73 : 87P,73,20,37,54.1,8,26,30.8,28,63,44.4,9,14,64.3,9,17,26,15,18,17,9,8,5,0,78,GKS Tychy,Sezon 2020/2021
2021-01-30 17:00,Decka Pelplin(w),65 : 73W,73,27,54,50.0,1,17,5.9,28,71,39.4,16,21,76.2,13,22,35,15,20,22,8,9,2,7,78,GKS Tychy,Sezon 2020/2021
2021-02-06 18:00,Dziki Warszawa(d),82 : 71W,82,27,44,61.4,6,16,37.5,33,60,55.0,10,12,83.3,9,24,33,22,20,18,22,5,2,0,93,GKS Tychy,Sezon 2020/2021
2021-02-13 18:00,Energa Kotwica Kołobrzeg(w),92 : 97W,97,29,43,67.4,7,23,30.4,36,66,54.5,18,28,64.3,11,21,32,12,24,28,11,5,2,3,97,GKS Tychy,Sezon 2020/2021
2021-02-28 18:00,TS Wisła Chemart Kraków(w),58 : 67W,67,18,35,51.4,5,24,20.8,23,59,39.0,16,20,80.0,10,32,42,9,19,19,12,9,1,4,76,GKS Tychy,Sezon 2020/2021
2021-03-06 18:00,WKK Wrocław(d),83 : 82W,83,22,39,56.4,8,23,34.8,30,62,48.4,15,17,88.2,4,31,35,18,19,16,15,4,4,2,95,GKS Tychy,Sezon 2020/2021
2021-03-10 19:00,Górnik Trans.eu Wałbrzych(d),75 : 88P,75,21,41,51.2,7,29,24.1,28,70,40.0,12,16,75.0,10,25,35,15,27,20,10,4,4,3,77,GKS Tychy,Sezon 2020/2021
2021-03-13 18:00,Grupa Sierleccy-Czarni Słupsk(w),97 : 48P,48,14,30,46.7,5,28,17.9,19,58,32.8,5,12,41.7,7,16,23,11,21,17,18,3,4,3,25,GKS Tychy,Sezon 2020/2021
2021-03-20 19:30,Elektrobud-Investment ZB Pruszków(d),72 : 92P,72,22,49,44.9,2,18,11.1,24,67,35.8,22,26,84.6,15,24,39,9,21,22,19,10,3,2,67,GKS Tychy,Sezon 2020/2021
2021-03-27 18:00,KS Księżak Łowicz(w),108 : 97P,97,17,34,50.0,19,36,52.8,36,70,51.4,6,7,85.7,12,17,29,24,23,15,11,2,1,1,107,GKS Tychy,Sezon 2020/2021
2021-03-31 18:00,Rawlplug Sokół Łańcut(d),88 : 92P,88,26,44,59.1,8,24,33.3,34,68,50.0,12,17,70.6,16,18,34,22,24,22,18,10,4,1,101,GKS Tychy,Sezon 2020/2021
2021-04-10 17:30,Rawlplug Sokół Łańcut(w),93 : 68P,68,16,35,45.7,9,27,33.3,25,62,40.3,9,9,100.0,6,23,29,11,22,12,18,6,0,1,59,GKS Tychy,Sezon 2020/2021
2021-04-11 17:30,Rawlplug Sokół Łańcut(w),85 : 93W,93,21,50,42.0,14,26,53.8,35,76,46.1,9,11,81.8,17,24,41,18,23,15,7,5,2,7,109,GKS Tychy,Sezon 2020/2021
2021-04-17 18:00,Rawlplug Sokół Łańcut(d),82 : 94P,82,19,30,63.3,8,26,30.8,27,56,48.2,20,26,76.9,8,18,26,21,25,21,16,8,1,2,87,GKS Tychy,Sezon 2020/2021
2021-04-18 18:00,Rawlplug Sokół Łańcut(d),84 : 95P,84,25,41,61.0,6,19,31.6,31,60,51.7,16,20,80.0,11,23,34,18,26,22,19,7,3,1,94,GKS Tychy,Sezon 2020/2021
2020-09-26 18:30,Energa Kotwica Kołobrzeg(w),85 : 91W,91,27,43,62.8,7,28,25.0,34,71,47.9,16,27,59.3,7,26,33,17,17,24,7,8,1,1,95,Górnik Trans.eu Wałbrzych,Sezon 2020/2021
2020-10-03 17:30,Weegree AZS Politechnika Opolska(w),73 : 78W,78,19,46,41.3,9,27,33.3,28,73,38.4,13,21,61.9,12,21,33,19,17,19,10,9,1,7,77,Górnik Trans.eu Wałbrzych,Sezon 2020/2021
2020-10-10 17:00,TS Wisła Chemart Kraków(d),91 : 79W,91,25,56,44.6,8,19,42.1,33,75,44.0,17,29,58.6,19,26,45,17,20,23,12,14,3,4,104,Górnik Trans.eu Wałbrzych,Sezon 2020/2021
2020-10-14 18:00,WKK Wrocław(w),75 : 70P,70,20,48,41.7,5,24,20.8,25,72,34.7,15,26,57.7,12,28,40,9,24,22,15,12,5,8,63,Górnik Trans.eu Wałbrzych,Sezon 2020/2021
2020-10-17 17:00,Grupa Sierleccy-Czarni Słupsk(d),90 : 69W,90,24,43,55.8,7,23,30.4,31,66,47.0,21,31,67.7,9,30,39,17,23,21,9,5,5,3,102,Górnik Trans.eu Wałbrzych,Sezon 2020/2021
2020-10-31 18:00,KS Księżak Łowicz(w),93 : 81P,81,24,52,46.2,5,19,26.3,29,71,40.8,18,27,66.7,11,24,35,18,27,24,9,6,2,4,82,Górnik Trans.eu Wałbrzych,Sezon 2020/2021
2020-11-07 17:30,Rawlplug Sokół Łańcut(w),102 : 108W,108,36,62,58.1,2,19,10.5,38,81,46.9,30,36,83.3,16,35,51,15,30,32,13,11,3,3,126,Górnik Trans.eu Wałbrzych,Sezon 2020/2021
2020-11-11 16:00,GKS Tychy(d),84 : 68W,84,23,42,54.8,8,24,33.3,31,66,47.0,14,23,60.9,11,30,41,19,22,22,11,4,2,2,95,Górnik Trans.eu Wałbrzych,Sezon 2020/2021
2020-11-14 17:00,Zetkama Doral Nysa Kłodzko(w),70 : 82W,82,32,55,58.2,3,15,20.0,35,70,50.0,9,13,69.2,11,23,34,17,22,15,11,12,6,0,101,Górnik Trans.eu Wałbrzych,Sezon 2020/2021
2020-11-20 19:45,TBS Śląsk II Wrocław(d),77 : 70W,77,23,48,47.9,4,18,22.2,27,66,40.9,19,24,79.2,17,26,43,11,20,25,17,7,4,3,81,Górnik Trans.eu Wałbrzych,Sezon 2020/2021
2020-11-25 18:00,Elektrobud-Investment ZB Pruszków(w),58 : 80W,80,21,46,45.7,5,16,31.3,26,62,41.9,23,28,82.1,11,28,39,9,23,23,9,2,2,2,82,Górnik Trans.eu Wałbrzych,Sezon 2020/2021
2020-11-28 17:30,Pogoń Prudnik(w),90 : 95W,95,29,46,63.0,5,17,29.4,34,63,54.0,22,31,71.0,14,16,30,22,28,23,13,8,5,3,109,Górnik Trans.eu Wałbrzych,Sezon 2020/2021
2020-12-05 17:00,Miasto Szkła Krosno(d),97 : 68W,97,19,39,48.7,14,30,46.7,33,69,47.8,17,26,65.4,14,34,48,23,26,25,15,6,2,3,116,Górnik Trans.eu Wałbrzych,Sezon 2020/2021
2020-12-12 17:00,Decka Pelplin(w),72 : 95W,95,23,42,54.8,12,35,34.3,35,77,45.5,13,20,65.0,14,29,43,22,20,20,9,6,4,5,112,Górnik Trans.eu Wałbrzych,Sezon 2020/2021
2020-12-20 16:00,Dziki Warszawa(d),77 : 63W,77,25,47,53.2,4,15,26.7,29,62,46.8,15,25,60.0,12,24,36,20,24,23,12,11,2,3,91,Górnik Trans.eu Wałbrzych,Sezon 2020/2021
2021-01-02 17:00,Energa Kotwica Kołobrzeg(d),88 : 79W,88,21,36,58.3,12,26,46.2,33,62,53.2,10,12,83.3,9,31,40,25,22,19,15,6,3,1,116,Górnik Trans.eu Wałbrzych,Sezon 2020/2021
2021-01-09 17:00,Weegree AZS Politechnika Opolska(d),69 : 59W,69,22,38,57.9,3,28,10.7,25,66,37.9,16,25,64.0,9,25,34,16,29,22,14,8,4,5,67,Górnik Trans.eu Wałbrzych,Sezon 2020/2021
2021-01-16 18:00,TS Wisła Chemart Kraków(w),80 : 77P,77,23,41,56.1,4,20,20.0,27,61,44.3,19,26,73.1,6,24,30,14,27,24,11,5,1,2,75,Górnik Trans.eu Wałbrzych,Sezon 2020/2021
2021-01-20 17:00,WKK Wrocław(d),90 : 95P,90,25,62,40.3,9,25,36.0,34,87,39.1,13,20,65.0,13,38,51,18,21,18,9,3,4,5,97,Górnik Trans.eu Wałbrzych,Sezon 2020/2021
2021-01-23 18:00,Grupa Sierleccy-Czarni Słupsk(w),86 : 76P,76,20,59,33.9,8,18,44.4,28,77,36.4,12,12,100.0,9,37,46,16,21,20,15,3,1,4,78,Górnik Trans.eu Wałbrzych,Sezon 2020/2021
2021-01-30 17:00,Elektrobud-Investment ZB Pruszków(d),69 : 56W,69,17,42,40.5,8,21,38.1,25,63,39.7,11,14,78.6,9,26,35,13,22,18,11,4,2,1,71,Górnik Trans.eu Wałbrzych,Sezon 2020/2021
2021-02-06 18:00,KS Księżak Łowicz(d),98 : 74W,98,28,46,60.9,11,29,37.9,39,75,52.0,9,13,69.2,15,25,40,20,20,17,9,12,1,1,122,Górnik Trans.eu Wałbrzych,Sezon 2020/2021
2021-02-13 17:00,Rawlplug Sokół Łańcut(d),73 : 70W,73,23,46,50.0,7,17,41.2,30,63,47.6,6,13,46.2,3,30,33,11,22,17,12,9,1,4,75,Górnik Trans.eu Wałbrzych,Sezon 2020/2021
2021-02-27 18:00,Zetkama Doral Nysa Kłodzko(d),95 : 64W,95,25,43,58.1,9,20,45.0,34,63,54.0,18,28,64.3,16,23,39,20,17,21,18,14,3,2,114,Górnik Trans.eu Wałbrzych,Sezon 2020/2021
2021-03-05 20:00,TBS Śląsk II Wrocław(w),57 : 69W,69,18,44,40.9,5,14,35.7,23,58,39.7,18,26,69.2,10,35,45,13,21,20,18,8,6,6,80,Górnik Trans.eu Wałbrzych,Sezon 2020/2021
2021-03-10 19:00,GKS Tychy(w),75 : 88W,88,23,45,51.1,6,23,26.1,29,68,42.6,24,30,80.0,12,27,39,10,20,27,7,6,3,4,94,Górnik Trans.eu Wałbrzych,Sezon 2020/2021
2021-03-13 18:00,Pogoń Prudnik(d),84 : 70W,84,15,38,39.5,13,32,40.6,28,70,40.0,15,28,53.6,19,27,46,21,20,22,11,6,4,2,95,Górnik Trans.eu Wałbrzych,Sezon 2020/2021
2021-03-21 17:00,Miasto Szkła Krosno(w),67 : 87W,87,26,42,61.9,7,19,36.8,33,61,54.1,14,27,51.9,6,23,29,13,19,26,11,12,1,0,90,Górnik Trans.eu Wałbrzych,Sezon 2020/2021
2021-03-27 17:00,Decka Pelplin(d),93 : 87W,93,18,40,45.0,12,29,41.4,30,69,43.5,21,31,67.7,11,23,34,23,27,24,12,11,3,2,103,Górnik Trans.eu Wałbrzych,Sezon 2020/2021
2021-03-31 18:00,Dziki Warszawa(w),67 : 96W,96,27,45,60.0,10,25,40.0,37,70,52.9,12,20,60.0,8,34,42,23,15,21,12,9,3,6,120,Górnik Trans.eu Wałbrzych,Sezon 2020/2021
2021-04-10 17:00,Weegree AZS Politechnika Opolska(d),103 : 67W,103,27,40,67.5,13,31,41.9,40,71,56.3,10,15,66.7,8,26,34,26,24,19,9,11,4,2,133,Górnik Trans.eu Wałbrzych,Sezon 2020/2021
2021-04-11 17:00,Weegree AZS Politechnika Opolska(d),88 : 84W,88,21,34,61.8,8,32,25.0,29,66,43.9,22,32,68.8,11,24,35,19,24,26,12,7,3,2,93,Górnik Trans.eu Wałbrzych,Sezon 2020/2021
2021-04-18 11:00,Weegree AZS Politechnika Opolska(w),86 : 84P,84,27,44,61.4,4,25,16.0,31,69,44.9,18,28,64.3,9,26,35,24,27,24,10,9,2,4,96,Górnik Trans.eu Wałbrzych,Sezon 2020/2021
2021-04-19 19:00,Weegree AZS Politechnika Opolska(w),81 : 99W,99,24,38,63.2,10,26,38.5,34,64,53.1,21,33,63.6,11,24,35,22,25,30,7,5,2,1,114,Górnik Trans.eu Wałbrzych,Sezon 2020/2021
2021-04-24 17:00,WKK Wrocław(d),63 : 83P,63,23,51,45.1,1,21,4.8,24,72,33.3,14,19,73.7,10,29,39,14,21,18,11,11,4,3,67,Górnik Trans.eu Wałbrzych,Sezon 2020/2021
2021-04-25 17:00,WKK Wrocław(d),88 : 66W,88,28,51,54.9,4,16,25.0,32,67,47.8,20,23,87.0,12,31,43,26,20,18,15,7,2,0,113,Górnik Trans.eu Wałbrzych,Sezon 2020/2021
2021-05-01 18:00,WKK Wrocław(w),93 : 95W,95,19,40,47.5,6,13,46.2,25,53,47.2,39,48,81.3,6,27,33,18,28,35,9,6,6,1,112,Górnik Trans.eu Wałbrzych,Sezon 2020/2021
2021-05-02 18:00,WKK Wrocław(w),78 : 74P,74,22,48,45.8,6,22,27.3,28,70,40.0,12,15,80.0,14,22,36,17,25,19,10,8,3,6,83,Górnik Trans.eu Wałbrzych,Sezon 2020/2021
2021-05-05 18:30,WKK Wrocław(d),89 : 70W,89,24,44,54.5,10,25,40.0,34,69,49.3,11,20,55.0,8,29,37,15,20,19,12,8,4,1,97,Górnik Trans.eu Wałbrzych,Sezon 2020/2021
2021-05-08 18:00,Grupa Sierleccy-Czarni Słupsk(w),67 : 79W,79,28,54,51.9,6,16,37.5,34,70,48.6,5,12,41.7,10,26,36,14,21,18,10,7,3,5,86,Górnik Trans.eu Wałbrzych,Sezon 2020/2021
2021-05-09 18:00,Grupa Sierleccy-Czarni Słupsk(w),105 : 44P,44,11,41,26.8,3,21,14.3,14,62,22.6,13,20,65.0,7,18,25,9,19,22,19,6,2,5,12,Górnik Trans.eu Wałbrzych,Sezon 2020/2021
2021-05-15 19:00,Grupa Sierleccy-Czarni Słupsk(d),77 : 74W,77,17,39,43.6,8,18,44.4,25,57,43.9,19,32,59.4,13,25,38,14,20,25,14,9,1,4,80,Górnik Trans.eu Wałbrzych,Sezon 2020/2021
2021-05-16 17:00,Grupa Sierleccy-Czarni Słupsk(d),52 : 76P,52,13,43,30.2,5,21,23.8,18,64,28.1,11,18,61.1,13,17,30,10,24,19,13,5,2,2,33,Górnik Trans.eu Wałbrzych,Sezon 2020/2021
2021-05-22 17:00,Grupa Sierleccy-Czarni Słupsk(w),83 : 59P,59,14,40,35.0,6,25,24.0,20,65,30.8,13,18,72.2,13,22,35,7,21,17,12,6,2,2,47,Górnik Trans.eu Wałbrzych,Sezon 2020/2021
2020-09-26 18:00,Miasto Szkła Krosno(w),68 : 78W,78,19,41,46.3,9,23,39.1,28,64,43.8,13,17,76.5,8,25,33,19,22,20,13,4,0,2,81,Grupa Sierleccy-Czarni Słupsk,Sezon 2020/2021
2020-10-03 18:00,Decka Pelplin(d),89 : 78W,89,23,49,46.9,11,30,36.7,34,79,43.0,10,11,90.9,11,32,43,22,18,15,13,7,3,4,105,Grupa Sierleccy-Czarni Słupsk,Sezon 2020/2021
2020-10-10 18:00,Dziki Warszawa(w),66 : 73W,73,22,46,47.8,5,28,17.9,27,74,36.5,14,18,77.8,18,29,47,13,22,20,18,11,3,1,78,Grupa Sierleccy-Czarni Słupsk,Sezon 2020/2021
2020-10-14 18:00,Energa Kotwica Kołobrzeg(d),82 : 63W,82,24,42,57.1,7,23,30.4,31,65,47.7,13,19,68.4,10,27,37,17,24,18,18,7,1,1,86,Grupa Sierleccy-Czarni Słupsk,Sezon 2020/2021
2020-10-17 17:00,Górnik Trans.eu Wałbrzych(w),90 : 69P,69,15,44,34.1,7,20,35.0,22,64,34.4,18,25,72.0,10,24,34,13,22,23,13,5,3,5,62,Grupa Sierleccy-Czarni Słupsk,Sezon 2020/2021
2020-10-24 18:00,TS Wisła Chemart Kraków(d),102 : 53W,102,25,43,58.1,16,34,47.1,41,77,53.2,4,7,57.1,9,31,40,26,21,17,14,9,6,1,130,Grupa Sierleccy-Czarni Słupsk,Sezon 2020/2021
2020-11-08 17:30,Weegree AZS Politechnika Opolska(w),70 : 92W,92,31,41,75.6,8,23,34.8,39,64,60.9,6,9,66.7,5,24,29,28,21,15,14,11,3,4,121,Grupa Sierleccy-Czarni Słupsk,Sezon 2020/2021
2020-11-11 18:00,Elektrobud-Investment ZB Pruszków(d),73 : 60W,73,20,33,60.6,7,29,24.1,27,62,43.5,12,13,92.3,8,29,37,19,18,13,13,7,6,0,93,Grupa Sierleccy-Czarni Słupsk,Sezon 2020/2021
2020-11-15 17:00,KS Księżak Łowicz(w),81 : 80P,80,25,41,61.0,5,20,25.0,30,61,49.2,15,21,71.4,6,22,28,17,21,17,14,14,3,0,91,Grupa Sierleccy-Czarni Słupsk,Sezon 2020/2021
2020-11-20 18:00,Rawlplug Sokół Łańcut(d),86 : 74W,86,21,43,48.8,12,19,63.2,33,62,53.2,8,15,53.3,7,21,28,15,18,17,9,10,2,1,96,Grupa Sierleccy-Czarni Słupsk,Sezon 2020/2021
2020-11-29 18:00,GKS Tychy(w),85 : 93W,93,24,43,55.8,10,19,52.6,34,62,54.8,15,16,93.8,6,18,24,16,18,17,10,7,3,4,104,Grupa Sierleccy-Czarni Słupsk,Sezon 2020/2021
2020-12-03 18:00,WKK Wrocław(w),71 : 87W,87,21,41,51.2,13,32,40.6,34,73,46.6,6,9,66.7,10,33,43,22,25,14,11,8,4,2,111,Grupa Sierleccy-Czarni Słupsk,Sezon 2020/2021
2020-12-05 17:00,Zetkama Doral Nysa Kłodzko(w),70 : 98W,98,27,46,58.7,10,22,45.5,37,68,54.4,14,21,66.7,12,28,40,11,18,21,8,4,3,1,110,Grupa Sierleccy-Czarni Słupsk,Sezon 2020/2021
2020-12-11 18:00,TBS Śląsk II Wrocław(w),73 : 77W,77,21,41,51.2,9,25,36.0,30,66,45.5,8,16,50.0,12,28,40,18,22,20,14,5,2,4,84,Grupa Sierleccy-Czarni Słupsk,Sezon 2020/2021
2020-12-19 18:00,Pogoń Prudnik(d),90 : 82W,90,25,44,56.8,8,21,38.1,33,65,50.8,16,21,76.2,5,17,22,20,18,19,5,11,3,2,104,Grupa Sierleccy-Czarni Słupsk,Sezon 2020/2021
2021-01-02 18:00,Miasto Szkła Krosno(d),82 : 81W,82,24,39,61.5,7,24,29.2,31,63,49.2,13,19,68.4,8,28,36,21,18,22,13,7,1,1,96,Grupa Sierleccy-Czarni Słupsk,Sezon 2020/2021
2021-01-09 17:00,Decka Pelplin(w),83 : 82P,82,28,46,60.9,6,16,37.5,34,62,54.8,8,11,72.7,5,20,25,17,19,16,11,10,0,2,92,Grupa Sierleccy-Czarni Słupsk,Sezon 2020/2021
2021-01-16 18:00,Dziki Warszawa(d),65 : 62W,65,11,37,29.7,9,27,33.3,20,64,31.3,16,23,69.6,8,29,37,13,19,24,7,4,2,4,63,Grupa Sierleccy-Czarni Słupsk,Sezon 2020/2021
2021-01-20 18:00,Energa Kotwica Kołobrzeg(w),107 : 114W,114,27,48,56.3,13,38,34.2,40,86,46.5,21,27,77.8,14,29,43,22,19,24,7,8,1,4,129,Grupa Sierleccy-Czarni Słupsk,Sezon 2020/2021
2021-01-23 18:00,Górnik Trans.eu Wałbrzych(d),86 : 76W,86,18,41,43.9,10,34,29.4,28,75,37.3,20,28,71.4,9,29,38,21,20,21,7,7,4,1,94,Grupa Sierleccy-Czarni Słupsk,Sezon 2020/2021
2021-01-30 18:30,TS Wisła Chemart Kraków(w),65 : 79W,79,23,41,56.1,7,21,33.3,30,62,48.4,12,18,66.7,7,34,41,20,20,20,9,8,3,4,104,Grupa Sierleccy-Czarni Słupsk,Sezon 2020/2021
2021-02-06 18:00,WKK Wrocław(d),89 : 76W,89,23,47,48.9,11,24,45.8,34,71,47.9,10,13,76.9,13,26,39,24,21,14,10,7,1,3,110,Grupa Sierleccy-Czarni Słupsk,Sezon 2020/2021
2021-02-13 18:00,Weegree AZS Politechnika Opolska(d),72 : 60W,72,16,37,43.2,10,29,34.5,26,66,39.4,10,13,76.9,18,27,45,18,14,15,15,7,0,1,84,Grupa Sierleccy-Czarni Słupsk,Sezon 2020/2021
2021-02-20 18:00,Elektrobud-Investment ZB Pruszków(w),56 : 87W,87,26,44,59.1,8,17,47.1,34,61,55.7,11,20,55.0,14,20,34,17,17,16,14,8,0,2,96,Grupa Sierleccy-Czarni Słupsk,Sezon 2020/2021
2021-02-27 18:00,KS Księżak Łowicz(d),93 : 63W,93,21,39,53.8,14,33,42.4,35,72,48.6,9,13,69.2,11,25,36,22,22,19,11,5,2,4,106,Grupa Sierleccy-Czarni Słupsk,Sezon 2020/2021
2021-03-06 17:30,Rawlplug Sokół Łańcut(w),86 : 77P,77,16,38,42.1,14,27,51.9,30,65,46.2,3,4,75.0,3,20,23,15,17,13,11,8,0,4,76,Grupa Sierleccy-Czarni Słupsk,Sezon 2020/2021
2021-03-13 18:00,GKS Tychy(d),97 : 48W,97,26,39,66.7,10,23,43.5,36,62,58.1,15,22,68.2,11,28,39,25,17,21,10,13,3,4,134,Grupa Sierleccy-Czarni Słupsk,Sezon 2020/2021
2021-03-22 16:00,Zetkama Doral Nysa Kłodzko(d),100 : 67W,100,27,43,62.8,10,20,50.0,37,63,58.7,16,23,69.6,10,24,34,20,23,25,11,9,3,1,122,Grupa Sierleccy-Czarni Słupsk,Sezon 2020/2021
2021-03-27 18:00,TBS Śląsk II Wrocław(d),94 : 70W,94,22,40,55.0,13,35,37.1,35,75,46.7,11,16,68.8,11,22,33,26,15,18,5,11,2,4,116,Grupa Sierleccy-Czarni Słupsk,Sezon 2020/2021
2021-03-31 18:00,Pogoń Prudnik(w),66 : 80W,80,21,38,55.3,8,25,32.0,29,63,46.0,14,17,82.4,9,25,34,12,20,18,5,8,3,1,95,Grupa Sierleccy-Czarni Słupsk,Sezon 2020/2021
2021-04-10 18:00,Elektrobud-Investment ZB Pruszków(d),90 : 82W,90,26,50,52.0,7,22,31.8,33,72,45.8,17,20,85.0,15,22,37,24,20,21,9,10,0,3,110,Grupa Sierleccy-Czarni Słupsk,Sezon 2020/2021
2021-04-11 18:00,Elektrobud-Investment ZB Pruszków(d),84 : 75W,84,25,49,51.0,7,16,43.8,32,65,49.2,13,19,68.4,10,25,35,20,18,17,10,7,7,2,104,Grupa Sierleccy-Czarni Słupsk,Sezon 2020/2021
2021-04-17 15:30,Elektrobud-Investment ZB Pruszków(w),65 : 85W,85,15,32,46.9,12,18,66.7,27,50,54.0,19,22,86.4,5,18,23,18,18,20,13,8,3,2,98,Grupa Sierleccy-Czarni Słupsk,Sezon 2020/2021
2021-04-24 18:00,Rawlplug Sokół Łańcut(d),82 : 60W,82,26,41,63.4,7,20,35.0,33,61,54.1,9,13,69.2,7,30,37,21,23,17,10,7,4,1,109,Grupa Sierleccy-Czarni Słupsk,Sezon 2020/2021
2021-04-25 18:00,Rawlplug Sokół Łańcut(d),99 : 80W,99,27,38,71.1,10,25,40.0,37,63,58.7,15,15,100.0,9,18,27,21,19,19,13,13,3,1,124,Grupa Sierleccy-Czarni Słupsk,Sezon 2020/2021
2021-05-01 17:30,Rawlplug Sokół Łańcut(w),89 : 87P,87,22,44,50.0,10,18,55.6,32,62,51.6,13,20,65.0,12,23,35,15,22,17,12,10,2,3,100,Grupa Sierleccy-Czarni Słupsk,Sezon 2020/2021
2021-05-02 17:30,Rawlplug Sokół Łańcut(w),76 : 81W,81,23,37,62.2,8,19,42.1,31,56,55.4,11,15,73.3,7,28,35,16,21,15,15,7,1,1,96,Grupa Sierleccy-Czarni Słupsk,Sezon 2020/2021
2021-05-08 18:00,Górnik Trans.eu Wałbrzych(d),67 : 79P,67,24,48,50.0,4,20,20.0,28,68,41.2,7,14,50.0,14,22,36,12,19,20,12,4,5,3,65,Grupa Sierleccy-Czarni Słupsk,Sezon 2020/2021
2021-05-09 18:00,Górnik Trans.eu Wałbrzych(d),105 : 44W,105,19,38,50.0,18,26,69.2,37,64,57.8,13,18,72.2,7,34,41,28,22,17,16,12,5,2,143,Grupa Sierleccy-Czarni Słupsk,Sezon 2020/2021
2021-05-15 19:00,Górnik Trans.eu Wałbrzych(w),77 : 74P,74,16,33,48.5,9,25,36.0,25,58,43.1,15,23,65.2,9,23,32,17,25,20,14,8,4,1,80,Grupa Sierleccy-Czarni Słupsk,Sezon 2020/2021
2021-05-16 17:00,Górnik Trans.eu Wałbrzych(w),52 : 76W,76,18,33,54.5,5,23,21.7,23,56,41.1,25,29,86.2,11,33,44,14,19,24,12,5,2,2,92,Grupa Sierleccy-Czarni Słupsk,Sezon 2020/2021
2021-05-22 17:00,Górnik Trans.eu Wałbrzych(d),83 : 59W,83,14,33,42.4,13,29,44.8,27,62,43.5,16,19,84.2,9,32,41,13,17,21,10,9,2,2,100,Grupa Sierleccy-Czarni Słupsk,Sezon 2020/2021
2020-09-27 20:00,TBS Śląsk II Wrocław(w),92 : 88P,88,28,44,63.6,5,19,26.3,33,63,52.4,17,27,63.0,9,20,29,18,28,28,15,8,1,1,89,KS Księżak Łowicz,Sezon 2020/2021
2020-10-03 18:00,Pogoń Prudnik(d),103 : 79W,103,33,49,67.3,9,20,45.0,42,69,60.9,10,12,83.3,5,21,26,25,19,18,15,13,1,1,124,KS Księżak Łowicz,Sezon 2020/2021
2020-10-10 18:00,Miasto Szkła Krosno(w),72 : 79W,79,12,35,34.3,11,22,50.0,23,57,40.4,22,31,71.0,4,28,32,17,19,26,10,8,0,3,83,KS Księżak Łowicz,Sezon 2020/2021
2020-10-14 19:00,Decka Pelplin(d),97 : 83W,97,31,51,60.8,8,19,42.1,39,70,55.7,11,14,78.6,9,28,37,20,23,19,19,6,6,2,113,KS Księżak Łowicz,Sezon 2020/2021
2020-10-17 18:00,Dziki Warszawa(w),97 : 95P,95,24,41,58.5,7,24,29.2,31,65,47.7,26,36,72.2,10,31,41,23,21,25,14,4,0,2,105,KS Księżak Łowicz,Sezon 2020/2021
2020-10-24 18:00,Energa Kotwica Kołobrzeg(d),82 : 75W,82,23,35,65.7,7,23,30.4,30,58,51.7,15,19,78.9,4,34,38,17,21,21,18,7,2,2,96,KS Księżak Łowicz,Sezon 2020/2021
2020-10-31 18:00,Górnik Trans.eu Wałbrzych(d),93 : 81W,93,22,47,46.8,8,19,42.1,30,66,45.5,25,32,78.1,10,33,43,18,24,27,11,5,4,2,109,KS Księżak Łowicz,Sezon 2020/2021
2020-11-07 18:00,TS Wisła Chemart Kraków(d),94 : 107P,94,19,37,51.4,10,24,41.7,29,61,47.5,26,34,76.5,7,22,29,18,22,25,12,11,1,1,101,KS Księżak Łowicz,Sezon 2020/2021
2020-11-11 18:00,WKK Wrocław(w),96 : 79P,79,22,50,44.0,7,27,25.9,29,77,37.7,14,21,66.7,9,26,35,24,20,20,15,11,1,8,80,KS Księżak Łowicz,Sezon 2020/2021
2020-11-15 17:00,Grupa Sierleccy-Czarni Słupsk(d),81 : 80W,81,21,32,65.6,7,25,28.0,28,57,49.1,18,23,78.3,10,25,35,17,17,21,23,10,0,3,86,KS Księżak Łowicz,Sezon 2020/2021
2020-11-22 17:00,Elektrobud-Investment ZB Pruszków(w),63 : 54P,54,16,29,55.2,5,25,20.0,21,54,38.9,7,19,36.8,7,30,37,17,21,22,16,9,2,3,58,KS Księżak Łowicz,Sezon 2020/2021
2020-11-28 17:30,Weegree AZS Politechnika Opolska(w),96 : 84P,84,24,38,63.2,4,23,17.4,28,61,45.9,24,28,85.7,7,18,25,15,26,23,23,9,2,4,75,KS Księżak Łowicz,Sezon 2020/2021
2020-12-05 18:00,Rawlplug Sokół Łańcut(d),64 : 101P,64,18,44,40.9,5,13,38.5,23,57,40.4,13,15,86.7,6,18,24,13,17,15,22,10,1,5,54,KS Księżak Łowicz,Sezon 2020/2021
2020-12-12 19:00,GKS Tychy(w),80 : 99W,99,32,55,58.2,5,21,23.8,37,76,48.7,20,23,87.0,14,31,45,22,18,22,12,11,4,10,127,KS Księżak Łowicz,Sezon 2020/2021
2020-12-19 17:00,Zetkama Doral Nysa Kłodzko(d),121 : 90W,121,34,43,79.1,14,26,53.8,48,69,69.6,11,16,68.8,4,35,39,29,20,17,11,6,2,0,160,KS Księżak Łowicz,Sezon 2020/2021
2021-01-03 17:00,TBS Śląsk II Wrocław(d),86 : 94P,86,25,42,59.5,6,17,35.3,31,59,52.5,18,22,81.8,10,17,27,22,23,22,16,7,3,1,97,KS Księżak Łowicz,Sezon 2020/2021
2021-01-09 17:30,Pogoń Prudnik(w),85 : 97W,97,24,44,54.5,9,24,37.5,33,68,48.5,22,23,95.7,10,18,28,24,20,22,8,12,2,1,119,KS Księżak Łowicz,Sezon 2020/2021
2021-01-16 18:00,Miasto Szkła Krosno(d),86 : 83W,86,14,27,51.9,14,33,42.4,28,60,46.7,16,19,84.2,8,21,29,20,18,22,13,10,1,1,98,KS Księżak Łowicz,Sezon 2020/2021
2021-01-20 18:00,Decka Pelplin(w),87 : 95W,95,24,43,55.8,7,26,26.9,31,69,44.9,26,33,78.8,15,26,41,18,17,21,15,6,0,4,100,KS Księżak Łowicz,Sezon 2020/2021
2021-01-25 19:00,Dziki Warszawa(d),98 : 86W,98,30,49,61.2,6,23,26.1,36,72,50.0,20,26,76.9,9,30,39,24,21,23,19,7,1,2,108,KS Księżak Łowicz,Sezon 2020/2021
2021-01-30 17:00,Energa Kotwica Kołobrzeg(w),66 : 57P,57,11,31,35.5,10,39,25.6,21,70,30.0,5,10,50.0,12,29,41,18,23,19,9,4,3,4,60,KS Księżak Łowicz,Sezon 2020/2021
2021-02-06 18:00,Górnik Trans.eu Wałbrzych(w),98 : 74P,74,15,28,53.6,10,26,38.5,25,54,46.3,14,21,66.7,3,21,24,17,17,20,17,5,1,1,68,KS Księżak Łowicz,Sezon 2020/2021
2021-02-14 18:00,TS Wisła Chemart Kraków(w),74 : 91W,91,24,39,61.5,10,27,37.0,34,66,51.5,13,19,68.4,9,34,43,17,15,22,15,10,1,3,109,KS Księżak Łowicz,Sezon 2020/2021
2021-02-20 18:00,WKK Wrocław(d),72 : 92P,72,22,42,52.4,5,23,21.7,27,65,41.5,13,17,76.5,7,13,20,15,17,18,20,11,3,3,59,KS Księżak Łowicz,Sezon 2020/2021
2021-02-27 18:00,Grupa Sierleccy-Czarni Słupsk(w),93 : 63P,63,18,38,47.4,5,19,26.3,23,57,40.4,12,23,52.2,5,25,30,16,19,22,15,5,4,2,58,KS Księżak Łowicz,Sezon 2020/2021
2021-03-06 18:00,Elektrobud-Investment ZB Pruszków(d),78 : 79P,78,22,36,61.1,7,15,46.7,29,51,56.9,13,20,65.0,4,28,32,19,22,23,21,6,2,1,87,KS Księżak Łowicz,Sezon 2020/2021
2021-03-13 18:00,Weegree AZS Politechnika Opolska(d),79 : 87P,79,24,41,58.5,5,26,19.2,29,67,43.3,16,25,64.0,11,26,37,16,20,25,15,6,1,6,77,KS Księżak Łowicz,Sezon 2020/2021
2021-03-20 17:30,Rawlplug Sokół Łańcut(w),98 : 70P,70,21,43,48.8,5,15,33.3,26,58,44.8,13,20,65.0,5,23,28,17,20,21,19,9,2,4,68,KS Księżak Łowicz,Sezon 2020/2021
2021-03-27 18:00,GKS Tychy(d),108 : 97W,108,30,47,63.8,11,18,61.1,41,65,63.1,15,22,68.2,7,18,25,27,15,23,8,4,1,1,126,KS Księżak Łowicz,Sezon 2020/2021
2021-03-31 18:00,Zetkama Doral Nysa Kłodzko(w),76 : 86W,86,27,53,50.9,6,24,25.0,33,77,42.9,14,21,66.7,15,25,40,18,22,17,16,12,3,3,92,KS Księżak Łowicz,Sezon 2020/2021
2020-09-26 18:00,Grupa Sierleccy-Czarni Słupsk(d),68 : 78P,68,22,43,51.2,2,12,16.7,24,55,43.6,18,27,66.7,2,22,24,18,20,22,12,7,2,0,67,Miasto Szkła Krosno,Sezon 2020/2021
2020-10-03 18:00,Elektrobud-Investment ZB Pruszków(w),67 : 77W,77,21,44,47.7,7,22,31.8,28,66,42.4,14,19,73.7,9,25,34,14,29,22,13,7,4,5,80,Miasto Szkła Krosno,Sezon 2020/2021
2020-10-10 18:00,KS Księżak Łowicz(d),72 : 79P,72,21,47,44.7,7,31,22.6,28,78,35.9,9,13,69.2,17,29,46,21,26,18,13,4,3,0,79,Miasto Szkła Krosno,Sezon 2020/2021
2020-11-11 18:00,Weegree AZS Politechnika Opolska(d),89 : 75W,89,19,31,61.3,9,28,32.1,28,59,47.5,24,32,75.0,10,30,40,20,24,27,16,9,3,2,106,Miasto Szkła Krosno,Sezon 2020/2021
2020-11-15 17:00,Decka Pelplin(d),99 : 83W,99,31,49,63.3,8,21,38.1,39,70,55.7,13,20,65.0,5,20,25,24,25,18,15,17,2,1,114,Miasto Szkła Krosno,Sezon 2020/2021
2020-11-18 19:30,Zetkama Doral Nysa Kłodzko(w),68 : 74W,74,22,43,51.2,5,16,31.3,27,59,45.8,15,21,71.4,6,25,31,9,25,19,12,10,3,1,77,Miasto Szkła Krosno,Sezon 2020/2021
2020-11-21 18:00,Dziki Warszawa(w),69 : 61P,61,14,32,43.8,8,28,28.6,22,60,36.7,9,15,60.0,8,20,28,16,26,17,16,6,2,3,53,Miasto Szkła Krosno,Sezon 2020/2021
2020-11-25 17:30,GKS Tychy(d),94 : 100P,94,25,59,42.4,9,24,37.5,34,83,41.0,17,28,60.7,7,25,32,27,25,20,12,11,2,1,94,Miasto Szkła Krosno,Sezon 2020/2021
2020-11-28 17:00,Energa Kotwica Kołobrzeg(d),80 : 66W,80,25,43,58.1,6,20,30.0,31,63,49.2,12,20,60.0,9,33,42,24,23,21,16,10,2,3,102,Miasto Szkła Krosno,Sezon 2020/2021
2020-12-05 17:00,Górnik Trans.eu Wałbrzych(w),97 : 68P,68,19,45,42.2,4,19,21.1,23,64,35.9,18,30,60.0,10,22,32,13,26,25,13,9,3,2,59,Miasto Szkła Krosno,Sezon 2020/2021
2020-12-09 18:00,Rawlplug Sokół Łańcut(w),94 : 73P,73,20,42,47.6,9,26,34.6,29,68,42.6,6,11,54.5,12,20,32,13,20,17,11,7,0,3,70,Miasto Szkła Krosno,Sezon 2020/2021
2020-12-13 17:00,TS Wisła Chemart Kraków(d),76 : 74W,76,16,31,51.6,13,31,41.9,29,62,46.8,5,10,50.0,9,24,33,21,18,17,17,10,2,3,87,Miasto Szkła Krosno,Sezon 2020/2021
2020-12-16 18:30,Pogoń Prudnik(w),85 : 90W,90,17,29,58.6,13,30,43.3,30,59,50.8,17,21,81.0,8,21,29,24,19,22,14,8,1,1,105,Miasto Szkła Krosno,Sezon 2020/2021
2020-12-20 17:00,WKK Wrocław(d),88 : 98P,88,29,53,54.7,6,20,30.0,35,73,47.9,12,17,70.6,10,21,31,18,33,18,15,10,1,3,90,Miasto Szkła Krosno,Sezon 2020/2021
2021-01-02 18:00,Grupa Sierleccy-Czarni Słupsk(w),82 : 81P,81,26,47,55.3,5,18,27.8,31,65,47.7,14,22,63.6,3,24,27,14,22,18,10,7,1,1,78,Miasto Szkła Krosno,Sezon 2020/2021
2021-01-10 17:00,Elektrobud-Investment ZB Pruszków(d),73 : 80P,73,22,46,47.8,5,20,25.0,27,66,40.9,14,18,77.8,12,21,33,13,26,19,20,14,3,0,73,Miasto Szkła Krosno,Sezon 2020/2021
2021-01-16 18:00,KS Księżak Łowicz(w),86 : 83P,83,26,40,65.0,7,24,29.2,33,64,51.6,10,12,83.3,6,24,30,14,23,18,15,7,1,1,87,Miasto Szkła Krosno,Sezon 2020/2021
2021-01-20 18:00,Rawlplug Sokół Łańcut(d),75 : 88P,75,17,35,48.6,8,26,30.8,25,61,41.0,17,20,85.0,10,21,31,20,32,20,16,5,2,2,78,Miasto Szkła Krosno,Sezon 2020/2021
2021-01-23 18:00,GKS Tychy(w),73 : 87W,87,20,35,57.1,12,27,44.4,32,62,51.6,11,15,73.3,11,24,35,20,17,18,14,6,0,5,100,Miasto Szkła Krosno,Sezon 2020/2021
2021-01-30 17:00,Zetkama Doral Nysa Kłodzko(d),94 : 77W,94,18,34,52.9,14,27,51.9,32,61,52.5,16,24,66.7,8,25,33,27,21,18,14,8,2,0,113,Miasto Szkła Krosno,Sezon 2020/2021
2021-02-03 17:30,TBS Śląsk II Wrocław(d),80 : 77W,80,25,40,62.5,7,25,28.0,32,65,49.2,9,17,52.9,12,20,32,15,24,18,13,13,2,1,88,Miasto Szkła Krosno,Sezon 2020/2021
2021-02-06 13:00,TBS Śląsk II Wrocław(w),85 : 75P,75,17,31,54.8,8,24,33.3,25,55,45.5,17,20,85.0,5,21,26,20,22,22,17,6,3,1,80,Miasto Szkła Krosno,Sezon 2020/2021
2021-02-13 17:00,Pogoń Prudnik(d),95 : 70W,95,21,35,60.0,12,25,48.0,33,60,55.0,17,24,70.8,6,25,31,26,22,21,11,5,3,0,115,Miasto Szkła Krosno,Sezon 2020/2021
2021-02-20 17:30,Weegree AZS Politechnika Opolska(w),81 : 87W,87,24,41,58.5,6,19,31.6,30,60,50.0,21,23,91.3,7,20,27,21,17,21,17,12,5,5,103,Miasto Szkła Krosno,Sezon 2020/2021
2021-02-27 17:00,Decka Pelplin(w),83 : 91W,91,23,31,74.2,9,25,36.0,32,56,57.1,18,23,78.3,8,26,34,17,23,18,19,9,0,3,103,Miasto Szkła Krosno,Sezon 2020/2021
2021-03-06 17:00,Dziki Warszawa(d),87 : 82W,87,16,33,48.5,12,29,41.4,28,62,45.2,19,24,79.2,12,24,36,23,22,24,18,11,0,2,100,Miasto Szkła Krosno,Sezon 2020/2021
2021-03-13 17:00,Energa Kotwica Kołobrzeg(w),75 : 80W,80,16,30,53.3,9,30,30.0,25,60,41.7,21,30,70.0,6,27,33,15,18,25,11,10,1,1,84,Miasto Szkła Krosno,Sezon 2020/2021
2021-03-21 17:00,Górnik Trans.eu Wałbrzych(d),67 : 87P,67,13,35,37.1,8,23,34.8,21,58,36.2,17,20,85.0,10,27,37,13,27,19,21,6,0,1,62,Miasto Szkła Krosno,Sezon 2020/2021
2021-03-27 18:00,TS Wisła Chemart Kraków(w),75 : 89W,89,22,36,61.1,8,24,33.3,30,60,50.0,21,27,77.8,8,24,32,21,19,21,14,7,2,3,101,Miasto Szkła Krosno,Sezon 2020/2021
2021-03-31 18:00,WKK Wrocław(w),102 : 80P,80,19,31,61.3,11,27,40.7,30,58,51.7,9,16,56.3,6,20,26,21,19,19,21,10,4,1,85,Miasto Szkła Krosno,Sezon 2020/2021
2021-04-10 18:00,WKK Wrocław(w),84 : 77P,77,21,44,47.7,8,25,32.0,29,69,42.0,11,15,73.3,8,24,32,18,20,18,11,11,3,1,86,Miasto Szkła Krosno,Sezon 2020/2021
2021-04-11 18:00,WKK Wrocław(w),92 : 85P,85,26,46,56.5,6,19,31.6,32,65,49.2,15,19,78.9,9,22,31,18,25,23,13,9,3,3,96,Miasto Szkła Krosno,Sezon 2020/2021
2021-04-17 18:00,WKK Wrocław(d),62 : 72P,62,18,46,39.1,6,22,27.3,24,68,35.3,8,15,53.3,5,30,35,14,22,15,10,6,2,1,58,Miasto Szkła Krosno,Sezon 2020/2021
2020-09-27 17:30,Elektrobud-Investment ZB Pruszków(d),58 : 56W,58,14,29,48.3,6,23,26.1,20,52,38.5,12,18,66.7,6,34,40,19,21,18,16,7,3,1,73,Pogoń Prudnik,Sezon 2020/2021
2020-10-03 18:00,KS Księżak Łowicz(w),103 : 79P,79,18,31,58.1,9,30,30.0,27,61,44.3,16,19,84.2,6,18,24,13,19,19,23,6,1,1,63,Pogoń Prudnik,Sezon 2020/2021
2020-10-21 19:00,GKS Tychy(w),91 : 75P,75,17,36,47.2,9,23,39.1,26,59,44.1,14,20,70.0,7,17,24,17,19,18,15,14,3,4,79,Pogoń Prudnik,Sezon 2020/2021
2020-10-24 12:00,TBS Śląsk II Wrocław(w),84 : 77P,77,22,37,59.5,8,29,27.6,30,66,45.5,9,13,69.2,14,21,35,19,21,20,14,4,2,1,83,Pogoń Prudnik,Sezon 2020/2021
2020-11-04 18:30,Zetkama Doral Nysa Kłodzko(d),112 : 100W,112,26,39,66.7,7,17,41.2,33,56,58.9,39,41,95.1,5,25,30,21,19,29,13,2,4,1,131,Pogoń Prudnik,Sezon 2020/2021
2020-11-11 18:00,Decka Pelplin(w),80 : 77P,77,21,41,51.2,10,31,32.3,31,72,43.1,5,5,100.0,12,22,34,15,19,11,13,10,3,6,85,Pogoń Prudnik,Sezon 2020/2021
2020-11-14 17:30,Dziki Warszawa(d),78 : 76W,78,18,33,54.5,7,20,35.0,25,53,47.2,21,24,87.5,3,24,27,18,23,22,13,9,0,4,88,Pogoń Prudnik,Sezon 2020/2021
2020-11-18 18:30,Weegree AZS Politechnika Opolska(d),79 : 90P,79,11,31,35.5,13,33,39.4,24,64,37.5,18,20,90.0,5,21,26,19,23,22,13,6,1,4,76,Pogoń Prudnik,Sezon 2020/2021
2020-11-21 18:00,Energa Kotwica Kołobrzeg(w),76 : 71P,71,17,29,58.6,7,27,25.9,24,56,42.9,16,24,66.7,6,24,30,14,22,26,14,3,0,3,64,Pogoń Prudnik,Sezon 2020/2021
2020-11-28 17:30,Górnik Trans.eu Wałbrzych(d),90 : 95P,90,19,31,61.3,8,24,33.3,27,55,49.1,28,33,84.8,8,16,24,22,24,27,12,7,3,5,101,Pogoń Prudnik,Sezon 2020/2021
2020-12-02 18:30,Rawlplug Sokół Łańcut(d),80 : 98P,80,22,41,53.7,9,27,33.3,31,68,45.6,9,11,81.8,8,10,18,23,21,20,15,7,1,4,75,Pogoń Prudnik,Sezon 2020/2021
2020-12-05 18:00,TS Wisła Chemart Kraków(w),76 : 84W,84,24,38,63.2,9,25,36.0,33,63,52.4,9,9,100.0,4,30,34,18,18,17,11,5,4,3,104,Pogoń Prudnik,Sezon 2020/2021
2020-12-12 17:30,WKK Wrocław(d),75 : 86P,75,21,36,58.3,8,33,24.2,29,69,42.0,9,10,90.0,11,22,33,20,19,19,14,5,2,2,80,Pogoń Prudnik,Sezon 2020/2021
2020-12-16 18:30,Miasto Szkła Krosno(d),85 : 90P,85,22,39,56.4,11,22,50.0,33,61,54.1,8,9,88.9,6,15,21,26,23,19,14,9,1,1,99,Pogoń Prudnik,Sezon 2020/2021
2020-12-19 18:00,Grupa Sierleccy-Czarni Słupsk(w),90 : 82P,82,15,30,50.0,14,29,48.3,29,59,49.2,10,14,71.4,10,29,39,19,20,18,21,3,2,3,90,Pogoń Prudnik,Sezon 2020/2021
2021-01-02 18:00,Elektrobud-Investment ZB Pruszków(w),71 : 61P,61,17,34,50.0,7,26,26.9,24,60,40.0,6,11,54.5,10,21,31,16,20,14,16,8,2,1,61,Pogoń Prudnik,Sezon 2020/2021
2021-01-09 17:30,KS Księżak Łowicz(d),85 : 97P,85,21,35,60.0,9,25,36.0,30,60,50.0,16,19,84.2,7,18,25,23,22,20,16,4,1,2,89,Pogoń Prudnik,Sezon 2020/2021
2021-01-16 17:30,Rawlplug Sokół Łańcut(w),116 : 87P,87,23,42,54.8,10,24,41.7,33,66,50.0,11,17,64.7,5,18,23,12,21,18,10,5,0,6,78,Pogoń Prudnik,Sezon 2020/2021
2021-01-20 17:30,GKS Tychy(d),92 : 79W,92,12,23,52.2,18,31,58.1,30,54,55.6,14,21,66.7,3,22,25,24,17,21,13,10,0,1,107,Pogoń Prudnik,Sezon 2020/2021
2021-01-23 17:00,Zetkama Doral Nysa Kłodzko(w),67 : 94W,94,33,46,71.7,6,17,35.3,39,63,61.9,10,18,55.6,6,26,32,16,18,18,15,17,1,0,113,Pogoń Prudnik,Sezon 2020/2021
2021-01-29 17:30,TBS Śląsk II Wrocław(d),102 : 94W,102,25,44,56.8,10,26,38.5,35,70,50.0,22,24,91.7,6,26,32,21,20,26,13,5,1,1,111,Pogoń Prudnik,Sezon 2020/2021
2021-02-06 17:30,Weegree AZS Politechnika Opolska(w),79 : 65P,65,17,38,44.7,9,28,32.1,26,66,39.4,4,5,80.0,7,23,30,18,17,15,13,5,2,4,66,Pogoń Prudnik,Sezon 2020/2021
2021-02-13 17:00,Miasto Szkła Krosno(w),95 : 70P,70,14,38,36.8,10,32,31.3,24,70,34.3,12,15,80.0,13,20,33,11,23,21,14,7,0,3,58,Pogoń Prudnik,Sezon 2020/2021
2021-02-20 17:30,Decka Pelplin(d),76 : 85P,76,23,44,52.3,5,20,25.0,28,64,43.8,15,18,83.3,6,23,29,17,18,19,17,8,4,3,78,Pogoń Prudnik,Sezon 2020/2021
2021-02-27 18:00,Dziki Warszawa(w),78 : 71P,71,13,31,41.9,8,30,26.7,21,61,34.4,21,22,95.5,8,22,30,14,22,20,12,6,1,4,69,Pogoń Prudnik,Sezon 2020/2021
2021-03-06 17:30,Energa Kotwica Kołobrzeg(d),80 : 75W,80,15,30,50.0,13,32,40.6,28,62,45.2,11,13,84.6,13,21,34,22,16,20,12,3,1,2,92,Pogoń Prudnik,Sezon 2020/2021
2021-03-13 18:00,Górnik Trans.eu Wałbrzych(w),84 : 70P,70,16,31,51.6,10,36,27.8,26,67,38.8,8,15,53.3,10,26,36,20,22,20,12,6,2,4,74,Pogoń Prudnik,Sezon 2020/2021
2021-03-20 17:30,TS Wisła Chemart Kraków(d),84 : 82W,84,19,35,54.3,12,29,41.4,31,64,48.4,10,12,83.3,4,26,30,22,18,19,10,5,1,1,97,Pogoń Prudnik,Sezon 2020/2021
2021-03-27 18:00,WKK Wrocław(w),103 : 82P,82,15,24,62.5,11,34,32.4,26,58,44.8,19,30,63.3,8,20,28,17,21,27,13,1,3,3,75,Pogoń Prudnik,Sezon 2020/2021
2021-03-31 18:00,Grupa Sierleccy-Czarni Słupsk(d),66 : 80P,66,15,29,51.7,6,26,23.1,21,55,38.2,18,20,90.0,7,24,31,9,18,20,17,2,1,3,56,Pogoń Prudnik,Sezon 2020/2021
2020-09-26 17:00,Zetkama Doral Nysa Kłodzko(w),52 : 95W,95,17,31,54.8,18,30,60.0,35,61,57.4,7,13,53.8,9,30,39,28,12,15,18,5,3,1,120,Rawlplug Sokół Łańcut,Sezon 2020/2021
2020-10-02 18:00,TBS Śląsk II Wrocław(w),99 : 90P,90,28,41,68.3,6,24,25.0,34,65,52.3,16,22,72.7,15,19,34,19,26,22,16,4,2,1,96,Rawlplug Sokół Łańcut,Sezon 2020/2021
2020-10-17 16:00,Decka Pelplin(w),94 : 92P,92,23,47,48.9,10,27,37.0,33,74,44.6,16,21,76.2,13,14,27,24,26,21,15,11,1,5,94,Rawlplug Sokół Łańcut,Sezon 2020/2021
2020-10-24 17:30,Dziki Warszawa(d),93 : 86W,93,19,37,51.4,11,32,34.4,30,69,43.5,22,32,68.8,13,28,41,23,19,27,12,7,2,3,105,Rawlplug Sokół Łańcut,Sezon 2020/2021
2020-11-07 17:30,Górnik Trans.eu Wałbrzych(d),102 : 108P,102,12,29,41.4,18,40,45.0,30,69,43.5,24,37,64.9,8,24,32,19,34,28,15,6,3,3,95,Rawlplug Sokół Łańcut,Sezon 2020/2021
2020-11-11 18:00,TS Wisła Chemart Kraków(w),77 : 94W,94,25,39,64.1,11,27,40.7,36,66,54.5,11,14,78.6,13,18,31,25,15,15,13,12,4,1,120,Rawlplug Sokół Łańcut,Sezon 2020/2021
2020-11-14 17:30,WKK Wrocław(d),88 : 92P,88,20,37,54.1,11,34,32.4,31,71,43.7,15,21,71.4,15,26,41,20,23,20,17,5,3,5,94,Rawlplug Sokół Łańcut,Sezon 2020/2021
2020-11-18 18:00,Energa Kotwica Kołobrzeg(w),82 : 69P,69,14,40,35.0,9,31,29.0,23,71,32.4,14,20,70.0,17,23,40,11,17,21,16,9,4,2,63,Rawlplug Sokół Łańcut,Sezon 2020/2021
2020-11-20 18:00,Grupa Sierleccy-Czarni Słupsk(w),86 : 74P,74,15,33,45.5,12,25,48.0,27,58,46.6,8,9,88.9,4,23,27,16,18,18,16,2,1,2,72,Rawlplug Sokół Łańcut,Sezon 2020/2021
2020-11-28 17:30,Elektrobud-Investment ZB Pruszków(d),83 : 49W,83,21,40,52.5,9,29,31.0,30,69,43.5,14,18,77.8,16,34,50,19,11,19,13,9,1,0,106,Rawlplug Sokół Łańcut,Sezon 2020/2021
2020-12-02 18:30,Pogoń Prudnik(w),80 : 98W,98,20,32,62.5,11,27,40.7,31,59,52.5,25,29,86.2,10,21,31,28,20,21,16,9,4,1,122,Rawlplug Sokół Łańcut,Sezon 2020/2021
2020-12-05 18:00,KS Księżak Łowicz(w),64 : 101W,101,19,33,57.6,16,31,51.6,35,64,54.7,15,19,78.9,7,27,34,20,16,17,16,15,5,1,126,Rawlplug Sokół Łańcut,Sezon 2020/2021
2020-12-09 18:00,Miasto Szkła Krosno(d),94 : 73W,94,19,24,79.2,15,36,41.7,34,60,56.7,11,12,91.7,6,26,32,20,17,20,10,6,3,0,118,Rawlplug Sokół Łańcut,Sezon 2020/2021
2020-12-12 17:30,Weegree AZS Politechnika Opolska(w),94 : 116W,116,23,37,62.2,12,26,46.2,35,63,55.6,34,40,85.0,7,26,33,16,27,33,15,11,3,2,130,Rawlplug Sokół Łańcut,Sezon 2020/2021
2020-12-19 17:30,GKS Tychy(d),82 : 87P,82,26,38,68.4,6,29,20.7,32,67,47.8,12,19,63.2,14,23,37,17,20,23,15,10,5,0,94,Rawlplug Sokół Łańcut,Sezon 2020/2021
2021-01-03 17:30,Zetkama Doral Nysa Kłodzko(d),102 : 69W,102,22,33,66.7,16,34,47.1,38,67,56.7,10,14,71.4,15,22,37,29,23,12,17,15,3,0,136,Rawlplug Sokół Łańcut,Sezon 2020/2021
2021-01-10 17:30,TBS Śląsk II Wrocław(d),87 : 80W,87,21,43,48.8,8,21,38.1,29,64,45.3,21,27,77.8,13,21,34,16,18,25,16,14,3,0,97,Rawlplug Sokół Łańcut,Sezon 2020/2021
2021-01-16 17:30,Pogoń Prudnik(d),116 : 87W,116,21,33,63.6,16,34,47.1,37,67,55.2,26,31,83.9,12,30,42,32,18,21,11,9,6,0,159,Rawlplug Sokół Łańcut,Sezon 2020/2021
2021-01-20 18:00,Miasto Szkła Krosno(w),75 : 88W,88,13,24,54.2,10,26,38.5,23,50,46.0,32,37,86.5,5,21,26,18,20,31,10,4,2,2,96,Rawlplug Sokół Łańcut,Sezon 2020/2021
2021-01-23 17:30,Decka Pelplin(d),98 : 91W,98,25,40,62.5,11,23,47.8,36,63,57.1,15,20,75.0,9,21,30,25,22,18,14,12,1,2,120,Rawlplug Sokół Łańcut,Sezon 2020/2021
2021-01-30 18:00,Dziki Warszawa(w),74 : 96W,96,22,40,55.0,10,27,37.0,32,67,47.8,22,26,84.6,11,29,40,27,15,24,11,8,2,2,123,Rawlplug Sokół Łańcut,Sezon 2020/2021
2021-02-06 16:30,Energa Kotwica Kołobrzeg(d),92 : 76W,92,20,40,50.0,11,24,45.8,31,64,48.4,19,22,86.4,10,18,28,21,17,24,15,12,0,3,102,Rawlplug Sokół Łańcut,Sezon 2020/2021
2021-02-13 17:00,Górnik Trans.eu Wałbrzych(w),73 : 70P,70,15,39,38.5,7,29,24.1,22,68,32.4,19,29,65.5,15,27,42,14,17,21,14,6,4,1,66,Rawlplug Sokół Łańcut,Sezon 2020/2021
2021-02-20 17:30,TS Wisła Chemart Kraków(d),88 : 90P,88,22,38,57.9,8,29,27.6,30,67,44.8,20,27,74.1,9,22,31,23,22,21,12,8,0,2,94,Rawlplug Sokół Łańcut,Sezon 2020/2021
2021-02-27 18:00,WKK Wrocław(w),65 : 78W,78,15,34,44.1,11,35,31.4,26,69,37.7,15,17,88.2,11,27,38,17,23,18,12,6,3,4,85,Rawlplug Sokół Łańcut,Sezon 2020/2021
2021-03-06 17:30,Grupa Sierleccy-Czarni Słupsk(d),86 : 77W,86,26,40,65.0,8,28,28.6,34,68,50.0,10,14,71.4,11,28,39,23,13,17,12,8,4,0,110,Rawlplug Sokół Łańcut,Sezon 2020/2021
2021-03-13 18:00,Elektrobud-Investment ZB Pruszków(w),73 : 76W,76,15,28,53.6,9,26,34.6,24,54,44.4,19,28,67.9,6,26,32,16,12,25,17,6,2,2,76,Rawlplug Sokół Łańcut,Sezon 2020/2021
2021-03-20 17:30,KS Księżak Łowicz(d),98 : 70W,98,21,33,63.6,13,38,34.2,34,71,47.9,17,18,94.4,11,28,39,28,21,20,16,11,4,2,126,Rawlplug Sokół Łańcut,Sezon 2020/2021
2021-03-27 17:30,Weegree AZS Politechnika Opolska(d),92 : 94P,92,22,32,68.8,8,37,21.6,30,69,43.5,24,31,77.4,8,30,38,19,26,27,17,8,3,3,97,Rawlplug Sokół Łańcut,Sezon 2020/2021
2021-03-31 18:00,GKS Tychy(w),88 : 92W,92,19,41,46.3,11,27,40.7,30,68,44.1,21,24,87.5,12,18,30,19,22,24,15,6,1,4,92,Rawlplug Sokół Łańcut,Sezon 2020/2021
2021-04-10 17:30,GKS Tychy(d),93 : 68W,93,15,26,57.7,17,34,50.0,32,60,53.3,12,21,57.1,8,23,31,22,12,22,10,9,1,0,109,Rawlplug Sokół Łańcut,Sezon 2020/2021
2021-04-11 17:30,GKS Tychy(d),85 : 93P,85,17,32,53.1,9,34,26.5,26,66,39.4,24,27,88.9,13,23,36,23,15,23,8,5,7,2,105,Rawlplug Sokół Łańcut,Sezon 2020/2021
2021-04-17 18:00,GKS Tychy(w),82 : 94W,94,25,37,67.6,7,27,25.9,32,64,50.0,23,28,82.1,15,21,36,20,21,25,17,10,2,1,108,Rawlplug Sokół Łańcut,Sezon 2020/2021
2021-04-18 18:00,GKS Tychy(w),84 : 95W,95,18,32,56.3,12,28,42.9,30,60,50.0,23,24,95.8,4,17,21,16,22,26,13,10,1,3,99,Rawlplug Sokół Łańcut,Sezon 2020/2021
2021-04-24 18:00,Grupa Sierleccy-Czarni Słupsk(w),82 : 60P,60,12,39,30.8,7,26,26.9,19,65,29.2,15,22,68.2,13,20,33,11,17,22,9,7,1,4,50,Rawlplug Sokół Łańcut,Sezon 2020/2021
2021-04-25 18:00,Grupa Sierleccy-Czarni Słupsk(w),99 : 80P,80,23,42,54.8,7,17,41.2,30,59,50.8,13,19,68.4,8,14,22,11,19,19,17,7,1,3,69,Rawlplug Sokół Łańcut,Sezon 2020/2021
2021-05-01 17:30,Grupa Sierleccy-Czarni Słupsk(d),89 : 87W,89,17,34,50.0,11,28,39.3,28,62,45.2,22,28,78.6,9,20,29,19,17,22,12,8,3,2,96,Rawlplug Sokół Łańcut,Sezon 2020/2021
2021-05-02 17:30,Grupa Sierleccy-Czarni Słupsk(d),76 : 81P,76,15,29,51.7,11,30,36.7,26,59,44.1,13,20,65.0,6,20,26,18,16,21,13,7,1,1,75,Rawlplug Sokół Łańcut,Sezon 2020/2021
2021-05-08 17:30,WKK Wrocław(d),91 : 93P,91,16,32,50.0,13,31,41.9,29,63,46.0,20,24,83.3,6,21,27,26,17,19,12,2,2,0,98,Rawlplug Sokół Łańcut,Sezon 2020/2021
2021-05-15 17:00,WKK Wrocław(w),77 : 90W,90,25,45,55.6,10,33,30.3,35,78,44.9,10,15,66.7,8,23,31,25,22,18,10,14,3,7,105,Rawlplug Sokół Łańcut,Sezon 2020/2021
2020-09-27 20:00,KS Księżak Łowicz(d),92 : 88W,92,22,39,56.4,9,29,31.0,31,68,45.6,21,31,67.7,14,22,36,15,29,28,15,4,1,1,86,TBS Śląsk II Wrocław,Sezon 2020/2021
2020-10-02 18:00,Rawlplug Sokół Łańcut(d),99 : 90W,99,26,45,57.8,8,19,42.1,34,64,53.1,23,27,85.2,9,14,23,23,22,26,9,7,1,2,110,TBS Śląsk II Wrocław,Sezon 2020/2021
2020-10-16 19:30,Zetkama Doral Nysa Kłodzko(w),80 : 82W,82,25,43,58.1,5,21,23.8,30,64,46.9,17,29,58.6,9,24,33,10,20,23,11,7,1,1,76,TBS Śląsk II Wrocław,Sezon 2020/2021
2020-10-18 18:00,Weegree AZS Politechnika Opolska(d),100 : 81W,100,26,48,54.2,10,29,34.5,36,77,46.8,18,32,56.3,17,23,40,24,21,25,12,11,1,4,109,TBS Śląsk II Wrocław,Sezon 2020/2021
2020-10-24 12:00,Pogoń Prudnik(d),84 : 77W,84,21,39,53.8,8,28,28.6,29,67,43.3,18,26,69.2,16,19,35,18,20,21,8,10,1,2,94,TBS Śląsk II Wrocław,Sezon 2020/2021
2020-10-28 19:00,GKS Tychy(d),76 : 90P,76,17,44,38.6,11,24,45.8,28,68,41.2,9,14,64.3,10,18,28,23,18,16,12,6,4,2,80,TBS Śląsk II Wrocław,Sezon 2020/2021
2020-11-07 18:00,Decka Pelplin(d),82 : 83P,82,29,50,58.0,5,25,20.0,34,75,45.3,9,20,45.0,15,22,37,14,24,21,13,7,2,2,77,TBS Śląsk II Wrocław,Sezon 2020/2021
2020-11-11 18:00,Dziki Warszawa(w),84 : 63P,63,19,53,35.8,6,23,26.1,25,76,32.9,7,13,53.8,12,25,37,14,21,22,13,7,0,5,51,TBS Śląsk II Wrocław,Sezon 2020/2021
2020-11-14 13:00,Energa Kotwica Kołobrzeg(d),77 : 74W,77,22,50,44.0,7,27,25.9,29,77,37.7,12,17,70.6,14,34,48,14,24,22,26,8,4,7,72,TBS Śląsk II Wrocław,Sezon 2020/2021
2020-11-20 19:45,Górnik Trans.eu Wałbrzych(w),77 : 70P,70,19,46,41.3,6,19,31.6,25,65,38.5,14,18,77.8,13,21,34,15,25,20,16,10,3,4,72,TBS Śląsk II Wrocław,Sezon 2020/2021
2020-11-28 18:30,TS Wisła Chemart Kraków(d),111 : 85W,111,31,47,66.0,12,27,44.4,43,74,58.1,13,15,86.7,8,22,30,30,22,22,10,9,3,1,140,TBS Śląsk II Wrocław,Sezon 2020/2021
2020-12-06 18:00,WKK Wrocław(w),85 : 65P,65,24,47,51.1,3,18,16.7,27,65,41.5,8,14,57.1,6,26,32,15,16,13,13,4,3,5,62,TBS Śląsk II Wrocław,Sezon 2020/2021
2020-12-11 18:00,Grupa Sierleccy-Czarni Słupsk(d),73 : 77P,73,29,54,53.7,1,15,6.7,30,69,43.5,12,16,75.0,7,22,29,14,20,22,10,8,4,2,75,TBS Śląsk II Wrocław,Sezon 2020/2021
2020-12-19 18:00,Elektrobud-Investment ZB Pruszków(w),97 : 78P,78,19,48,39.6,7,14,50.0,26,62,41.9,19,33,57.6,12,16,28,12,18,31,16,9,1,5,62,TBS Śląsk II Wrocław,Sezon 2020/2021
2021-01-03 17:00,KS Księżak Łowicz(w),86 : 94W,94,24,32,75.0,12,29,41.4,36,61,59.0,10,15,66.7,8,17,25,20,22,23,15,7,1,3,102,TBS Śląsk II Wrocław,Sezon 2020/2021
2021-01-10 17:30,Rawlplug Sokół Łańcut(w),87 : 80P,80,24,40,60.0,8,22,36.4,32,62,51.6,8,16,50.0,7,24,31,18,25,18,19,9,0,3,81,TBS Śląsk II Wrocław,Sezon 2020/2021
2021-01-15 18:00,GKS Tychy(w),81 : 77P,77,18,37,48.6,11,30,36.7,29,67,43.3,8,8,100.0,6,22,28,17,19,17,13,8,5,2,84,TBS Śląsk II Wrocław,Sezon 2020/2021
2021-01-20 18:00,Zetkama Doral Nysa Kłodzko(d),106 : 77W,106,32,52,61.5,10,30,33.3,42,82,51.2,12,16,75.0,15,29,44,29,28,16,11,9,6,0,139,TBS Śląsk II Wrocław,Sezon 2020/2021
2021-01-23 17:30,Weegree AZS Politechnika Opolska(w),82 : 76P,76,19,34,55.9,9,27,33.3,28,61,45.9,11,16,68.8,7,20,27,15,24,19,22,13,2,3,73,TBS Śląsk II Wrocław,Sezon 2020/2021
2021-01-29 17:30,Pogoń Prudnik(w),102 : 94P,94,31,50,62.0,7,31,22.6,38,81,46.9,11,14,78.6,11,23,34,20,26,19,11,7,1,1,99,TBS Śląsk II Wrocław,Sezon 2020/2021
2021-02-03 17:30,Miasto Szkła Krosno(w),80 : 77P,77,17,29,58.6,10,26,38.5,27,55,49.1,13,21,61.9,10,19,29,11,18,24,20,8,1,2,70,TBS Śląsk II Wrocław,Sezon 2020/2021
2021-02-06 13:00,Miasto Szkła Krosno(d),85 : 75W,85,25,43,58.1,7,23,30.4,32,66,48.5,14,17,82.4,6,18,24,22,23,22,9,7,1,3,93,TBS Śląsk II Wrocław,Sezon 2020/2021
2021-02-16 18:00,Decka Pelplin(w),69 : 82W,82,23,46,50.0,8,21,38.1,31,67,46.3,12,13,92.3,10,25,35,15,18,16,9,8,1,1,95,TBS Śląsk II Wrocław,Sezon 2020/2021
2021-02-21 15:00,Dziki Warszawa(d),96 : 77W,96,27,50,54.0,11,26,42.3,38,76,50.0,9,16,56.3,13,34,47,27,22,19,15,7,3,3,120,TBS Śląsk II Wrocław,Sezon 2020/2021
2021-02-27 17:00,Energa Kotwica Kołobrzeg(w),84 : 77P,77,15,37,40.5,12,29,41.4,27,66,40.9,11,16,68.8,13,30,43,13,16,17,15,3,5,2,82,TBS Śląsk II Wrocław,Sezon 2020/2021
2021-03-05 20:00,Górnik Trans.eu Wałbrzych(d),57 : 69P,57,17,43,39.5,4,26,15.4,21,69,30.4,11,18,61.1,10,26,36,15,20,21,15,9,6,6,53,TBS Śląsk II Wrocław,Sezon 2020/2021
2021-03-13 18:00,TS Wisła Chemart Kraków(w),62 : 74W,74,21,39,53.8,7,21,33.3,28,60,46.7,11,12,91.7,7,30,37,16,20,16,14,8,7,3,95,TBS Śląsk II Wrocław,Sezon 2020/2021
2021-03-22 19:00,WKK Wrocław(d),94 : 92W,94,25,43,58.1,10,24,41.7,35,67,52.2,14,21,66.7,7,32,39,23,22,21,16,5,8,5,114,TBS Śląsk II Wrocław,Sezon 2020/2021
2021-03-27 18:00,Grupa Sierleccy-Czarni Słupsk(w),94 : 70P,70,17,29,58.6,8,26,30.8,25,55,45.5,12,17,70.6,5,24,29,14,18,15,18,4,4,2,68,TBS Śląsk II Wrocław,Sezon 2020/2021
2021-03-31 18:00,Elektrobud-Investment ZB Pruszków(d),75 : 66W,75,20,39,51.3,7,21,33.3,27,60,45.0,14,17,82.4,8,22,30,15,22,21,12,9,3,0,84,TBS Śląsk II Wrocław,Sezon 2020/2021
2020-09-26 18:00,Dziki Warszawa(w),84 : 62P,62,14,30,46.7,7,32,21.9,21,62,33.9,13,15,86.7,8,24,32,14,18,16,16,2,0,6,51,TS Wisła Chemart Kraków,Sezon 2020/2021
2020-10-03 18:00,Energa Kotwica Kołobrzeg(d),78 : 75W,78,13,24,54.2,15,39,38.5,28,63,44.4,7,20,35.0,9,31,40,22,20,20,14,3,6,1,87,TS Wisła Chemart Kraków,Sezon 2020/2021
2020-10-10 17:00,Górnik Trans.eu Wałbrzych(w),91 : 79P,79,21,38,55.3,7,20,35.0,28,58,48.3,16,25,64.0,6,25,31,16,23,20,19,6,4,3,78,TS Wisła Chemart Kraków,Sezon 2020/2021
2020-10-14 18:00,Weegree AZS Politechnika Opolska(w),95 : 94P,94,24,41,58.5,11,17,64.7,35,58,60.3,13,18,72.2,1,19,20,21,22,18,16,4,1,3,96,TS Wisła Chemart Kraków,Sezon 2020/2021
2020-10-24 18:00,Grupa Sierleccy-Czarni Słupsk(w),102 : 53P,53,11,29,37.9,6,32,18.8,17,61,27.9,13,18,72.2,7,25,32,8,17,21,18,7,1,6,34,TS Wisła Chemart Kraków,Sezon 2020/2021
2020-10-31 18:00,Elektrobud-Investment ZB Pruszków(d),55 : 61P,55,15,41,36.6,4,17,23.5,19,58,32.8,13,21,61.9,10,30,40,15,18,18,19,11,4,4,59,TS Wisła Chemart Kraków,Sezon 2020/2021
2020-11-07 18:00,KS Księżak Łowicz(w),94 : 107W,107,17,30,56.7,19,37,51.4,36,67,53.7,16,21,76.2,9,23,32,23,25,22,17,3,1,1,113,TS Wisła Chemart Kraków,Sezon 2020/2021
2020-11-11 18:00,Rawlplug Sokół Łańcut(d),77 : 94P,77,21,40,52.5,9,23,39.1,30,63,47.6,8,13,61.5,11,15,26,16,15,15,15,6,1,4,73,TS Wisła Chemart Kraków,Sezon 2020/2021
2020-11-14 18:00,GKS Tychy(w),74 : 87W,87,22,35,62.9,11,32,34.4,33,67,49.3,10,14,71.4,10,23,33,21,19,17,13,9,3,4,102,TS Wisła Chemart Kraków,Sezon 2020/2021
2020-11-18 18:00,WKK Wrocław(d),80 : 67W,80,19,43,44.2,10,23,43.5,29,66,43.9,12,20,60.0,12,32,44,17,19,19,11,5,3,3,93,TS Wisła Chemart Kraków,Sezon 2020/2021
2020-11-21 18:00,Zetkama Doral Nysa Kłodzko(d),96 : 83W,96,20,42,47.6,15,37,40.5,35,79,44.3,11,18,61.1,17,24,41,27,20,20,12,8,3,3,112,TS Wisła Chemart Kraków,Sezon 2020/2021
2020-11-28 18:30,TBS Śląsk II Wrocław(w),111 : 85P,85,18,35,51.4,11,29,37.9,29,64,45.3,16,24,66.7,6,22,28,17,22,22,14,4,1,3,78,TS Wisła Chemart Kraków,Sezon 2020/2021
2020-12-05 18:00,Pogoń Prudnik(d),76 : 84P,76,19,40,47.5,11,37,29.7,30,77,39.0,5,10,50.0,16,22,38,20,17,18,8,5,3,4,82,TS Wisła Chemart Kraków,Sezon 2020/2021
2020-12-13 17:00,Miasto Szkła Krosno(w),76 : 74P,74,14,26,53.8,12,32,37.5,26,58,44.8,10,12,83.3,5,23,28,12,17,18,18,10,3,2,75,TS Wisła Chemart Kraków,Sezon 2020/2021
2020-12-19 18:00,Decka Pelplin(d),75 : 92P,75,20,39,51.3,4,21,19.0,24,60,40.0,23,36,63.9,12,22,34,13,16,25,22,13,0,4,64,TS Wisła Chemart Kraków,Sezon 2020/2021
2021-01-03 18:00,Dziki Warszawa(d),75 : 91P,75,21,42,50.0,7,19,36.8,28,61,45.9,12,21,57.1,10,17,27,17,18,19,11,7,0,4,73,TS Wisła Chemart Kraków,Sezon 2020/2021
2021-01-09 18:00,Energa Kotwica Kołobrzeg(w),86 : 84P,84,22,37,59.5,8,25,32.0,30,62,48.4,16,28,57.1,10,24,34,20,22,23,14,7,2,1,89,TS Wisła Chemart Kraków,Sezon 2020/2021
2021-01-16 18:00,Górnik Trans.eu Wałbrzych(d),80 : 77W,80,19,39,48.7,8,24,33.3,27,63,42.9,18,27,66.7,11,23,34,21,24,26,13,4,2,1,83,TS Wisła Chemart Kraków,Sezon 2020/2021
2021-01-20 20:00,Weegree AZS Politechnika Opolska(d),62 : 83P,62,17,34,50.0,4,21,19.0,21,55,38.2,16,25,64.0,9,22,31,8,18,19,15,5,1,4,49,TS Wisła Chemart Kraków,Sezon 2020/2021
2021-01-24 18:00,WKK Wrocław(w),100 : 69P,69,17,33,51.5,5,22,22.7,22,55,40.0,20,31,64.5,6,25,31,18,20,20,18,5,2,4,63,TS Wisła Chemart Kraków,Sezon 2020/2021
2021-01-30 18:30,Grupa Sierleccy-Czarni Słupsk(d),65 : 79P,65,11,30,36.7,11,29,37.9,22,59,37.3,10,22,45.5,6,24,30,15,20,20,15,6,4,3,56,TS Wisła Chemart Kraków,Sezon 2020/2021
2021-02-06 18:00,Elektrobud-Investment ZB Pruszków(w),73 : 59P,59,19,41,46.3,4,20,20.0,23,61,37.7,9,11,81.8,8,23,31,12,16,14,18,10,5,3,59,TS Wisła Chemart Kraków,Sezon 2020/2021
2021-02-14 18:00,KS Księżak Łowicz(d),74 : 91P,74,22,47,46.8,9,25,36.0,31,72,43.1,3,5,60.0,4,23,27,21,22,15,13,4,3,1,73,TS Wisła Chemart Kraków,Sezon 2020/2021
2021-02-20 17:30,Rawlplug Sokół Łańcut(w),88 : 90W,90,20,38,52.6,12,26,46.2,32,64,50.0,14,19,73.7,7,26,33,15,21,22,13,7,2,0,97,TS Wisła Chemart Kraków,Sezon 2020/2021
2021-02-28 18:00,GKS Tychy(d),58 : 67P,58,14,28,50.0,7,39,17.9,21,67,31.3,9,15,60.0,10,23,33,16,19,19,13,8,4,1,54,TS Wisła Chemart Kraków,Sezon 2020/2021
2021-03-06 17:00,Zetkama Doral Nysa Kłodzko(w),85 : 92W,92,15,40,37.5,10,21,47.6,25,61,41.0,32,38,84.2,8,29,37,12,27,31,13,5,4,0,95,TS Wisła Chemart Kraków,Sezon 2020/2021
2021-03-13 18:00,TBS Śląsk II Wrocław(d),62 : 74P,62,18,41,43.9,5,30,16.7,23,71,32.4,11,16,68.8,16,21,37,18,16,20,13,8,3,7,62,TS Wisła Chemart Kraków,Sezon 2020/2021
2021-03-20 17:30,Pogoń Prudnik(w),84 : 82P,82,18,37,48.6,10,26,38.5,28,63,44.4,16,19,84.2,5,23,28,17,19,18,8,6,1,1,88,TS Wisła Chemart Kraków,Sezon 2020/2021
2021-03-27 18:00,Miasto Szkła Krosno(d),75 : 89P,75,16,33,48.5,11,27,40.7,27,60,45.0,10,15,66.7,6,18,24,22,21,19,16,9,3,2,79,TS Wisła Chemart Kraków,Sezon 2020/2021
2021-03-31 18:00,Decka Pelplin(w),105 : 78P,78,21,39,53.8,9,28,32.1,30,67,44.8,9,12,75.0,11,23,34,17,22,15,23,4,2,5,72,TS Wisła Chemart Kraków,Sezon 2020/2021
2020-09-26 18:00,GKS Tychy(w),78 : 75P,75,18,44,40.9,6,26,23.1,24,70,34.3,21,31,67.7,6,34,40,20,24,24,16,6,5,8,74,Weegree AZS Politechnika Opolska,Sezon 2020/2021
2020-10-03 17:30,Górnik Trans.eu Wałbrzych(d),73 : 78P,73,20,43,46.5,6,19,31.6,26,62,41.9,15,20,75.0,10,28,38,22,19,17,18,7,7,1,88,Weegree AZS Politechnika Opolska,Sezon 2020/2021
2020-10-10 17:00,Zetkama Doral Nysa Kłodzko(w),85 : 97W,97,21,39,53.8,11,25,44.0,32,64,50.0,22,30,73.3,11,28,39,15,19,21,11,6,4,0,110,Weegree AZS Politechnika Opolska,Sezon 2020/2021
2020-10-14 18:00,TS Wisła Chemart Kraków(d),95 : 94W,95,33,44,75.0,4,17,23.5,37,61,60.7,17,19,89.5,4,16,20,22,18,21,14,9,3,1,109,Weegree AZS Politechnika Opolska,Sezon 2020/2021
2020-10-18 18:00,TBS Śląsk II Wrocław(w),100 : 81P,81,23,46,50.0,4,20,20.0,27,66,40.9,23,27,85.2,12,26,38,16,25,21,23,6,4,1,79,Weegree AZS Politechnika Opolska,Sezon 2020/2021
2020-11-08 17:30,Grupa Sierleccy-Czarni Słupsk(d),70 : 92P,70,16,32,50.0,9,22,40.9,25,54,46.3,11,14,78.6,3,19,22,23,16,20,18,5,4,3,74,Weegree AZS Politechnika Opolska,Sezon 2020/2021
2020-11-11 18:00,Miasto Szkła Krosno(w),89 : 75P,75,21,41,51.2,5,19,26.3,26,60,43.3,18,27,66.7,8,20,28,13,27,23,18,8,2,3,65,Weegree AZS Politechnika Opolska,Sezon 2020/2021
2020-11-14 17:30,Elektrobud-Investment ZB Pruszków(d),97 : 92W,97,26,44,59.1,7,12,58.3,33,56,58.9,24,27,88.9,3,17,20,22,20,23,14,13,7,0,119,Weegree AZS Politechnika Opolska,Sezon 2020/2021
2020-11-18 18:30,Pogoń Prudnik(w),79 : 90W,90,29,47,61.7,5,14,35.7,34,61,55.7,17,24,70.8,6,29,35,21,22,23,10,4,4,1,110,Weegree AZS Politechnika Opolska,Sezon 2020/2021
2020-11-21 17:00,Decka Pelplin(w),80 : 97W,97,32,53,60.4,7,15,46.7,39,68,57.4,12,20,60.0,6,21,27,20,23,24,11,12,4,3,112,Weegree AZS Politechnika Opolska,Sezon 2020/2021
2020-11-25 18:00,WKK Wrocław(d),72 : 91P,72,19,49,38.8,6,25,24.0,25,74,33.8,16,20,80.0,11,21,32,20,24,22,15,8,4,6,68,Weegree AZS Politechnika Opolska,Sezon 2020/2021
2020-11-28 17:30,KS Księżak Łowicz(d),96 : 84W,96,28,45,62.2,5,20,25.0,33,65,50.8,25,28,89.3,12,24,36,25,23,26,20,11,4,2,117,Weegree AZS Politechnika Opolska,Sezon 2020/2021
2020-12-05 18:00,Dziki Warszawa(w),98 : 88P,88,20,38,52.6,9,23,39.1,29,61,47.5,21,27,77.8,6,22,28,25,21,20,15,6,3,2,97,Weegree AZS Politechnika Opolska,Sezon 2020/2021
2020-12-12 17:30,Rawlplug Sokół Łańcut(d),94 : 116P,94,30,48,62.5,3,23,13.0,33,71,46.5,25,29,86.2,9,20,29,17,33,27,15,6,2,3,91,Weegree AZS Politechnika Opolska,Sezon 2020/2021
2020-12-19 18:00,Energa Kotwica Kołobrzeg(w),89 : 95W,95,28,45,62.2,6,29,20.7,34,74,45.9,21,32,65.6,8,31,39,20,29,26,16,7,7,6,101,Weegree AZS Politechnika Opolska,Sezon 2020/2021
2021-01-03 17:30,GKS Tychy(d),84 : 91P,84,24,39,61.5,6,28,21.4,30,67,44.8,18,21,85.7,6,19,25,21,24,25,15,8,3,3,86,Weegree AZS Politechnika Opolska,Sezon 2020/2021
2021-01-09 17:00,Górnik Trans.eu Wałbrzych(w),69 : 59P,59,20,46,43.5,1,11,9.1,21,57,36.8,16,30,53.3,12,29,41,12,22,29,20,8,5,4,55,Weegree AZS Politechnika Opolska,Sezon 2020/2021
2021-01-16 17:30,Zetkama Doral Nysa Kłodzko(d),86 : 64W,86,32,48,66.7,3,14,21.4,35,62,56.5,13,17,76.5,10,28,38,19,21,24,17,7,4,1,106,Weegree AZS Politechnika Opolska,Sezon 2020/2021
2021-01-20 20:00,TS Wisła Chemart Kraków(w),62 : 83W,83,18,32,56.3,10,27,37.0,28,59,47.5,17,23,73.9,9,25,34,20,19,18,12,9,4,1,101,Weegree AZS Politechnika Opolska,Sezon 2020/2021
2021-01-23 17:30,TBS Śląsk II Wrocław(d),82 : 76W,82,21,40,52.5,6,21,28.6,27,61,44.3,22,29,75.9,12,22,34,24,19,24,22,11,3,2,91,Weegree AZS Politechnika Opolska,Sezon 2020/2021
2021-01-30 18:00,WKK Wrocław(w),89 : 72P,72,15,40,37.5,9,28,32.1,24,68,35.3,15,22,68.2,9,24,33,19,18,22,10,9,1,2,73,Weegree AZS Politechnika Opolska,Sezon 2020/2021
2021-02-06 17:30,Pogoń Prudnik(d),79 : 65W,79,24,41,58.5,6,22,27.3,30,63,47.6,13,16,81.3,7,31,38,17,15,16,15,8,4,2,95,Weegree AZS Politechnika Opolska,Sezon 2020/2021
2021-02-13 18:00,Grupa Sierleccy-Czarni Słupsk(w),72 : 60P,60,15,37,40.5,8,22,36.4,23,59,39.0,6,10,60.0,8,17,25,13,15,14,12,8,1,0,55,Weegree AZS Politechnika Opolska,Sezon 2020/2021
2021-02-20 17:30,Miasto Szkła Krosno(d),81 : 87P,81,23,39,59.0,8,18,44.4,31,57,54.4,11,14,78.6,4,19,23,19,21,17,21,7,5,5,85,Weegree AZS Politechnika Opolska,Sezon 2020/2021
2021-02-28 17:00,Elektrobud-Investment ZB Pruszków(w),67 : 72W,72,19,34,55.9,3,17,17.6,22,51,43.1,25,37,67.6,4,30,34,13,19,27,18,11,6,3,77,Weegree AZS Politechnika Opolska,Sezon 2020/2021
2021-03-06 17:30,Decka Pelplin(d),107 : 82W,107,28,46,60.9,11,30,36.7,39,76,51.3,18,21,85.7,11,29,40,27,19,22,15,7,5,1,131,Weegree AZS Politechnika Opolska,Sezon 2020/2021
2021-03-13 18:00,KS Księżak Łowicz(w),79 : 87W,87,25,46,54.3,6,22,27.3,31,68,45.6,19,25,76.0,8,25,33,13,25,20,12,4,6,1,88,Weegree AZS Politechnika Opolska,Sezon 2020/2021
2021-03-20 17:30,Dziki Warszawa(d),89 : 96P,89,25,45,55.6,4,18,22.2,29,63,46.0,27,32,84.4,6,17,23,25,29,28,17,9,1,4,91,Weegree AZS Politechnika Opolska,Sezon 2020/2021
2021-03-27 17:30,Rawlplug Sokół Łańcut(w),92 : 94W,94,24,43,55.8,7,23,30.4,31,66,47.0,25,36,69.4,5,29,34,15,27,26,14,8,3,3,94,Weegree AZS Politechnika Opolska,Sezon 2020/2021
2021-03-31 18:00,Energa Kotwica Kołobrzeg(d),89 : 87W,89,25,46,54.3,9,27,33.3,34,73,46.6,12,19,63.2,12,22,34,30,11,19,7,10,1,1,111,Weegree AZS Politechnika Opolska,Sezon 2020/2021
2021-04-10 17:00,Górnik Trans.eu Wałbrzych(w),103 : 67P,67,16,41,39.0,6,17,35.3,22,58,37.9,17,25,68.0,9,22,31,17,19,24,18,3,2,4,58,Weegree AZS Politechnika Opolska,Sezon 2020/2021
2021-04-11 17:00,Górnik Trans.eu Wałbrzych(w),88 : 84P,84,18,31,58.1,10,27,37.0,28,58,48.3,18,27,66.7,5,28,33,17,27,24,20,9,2,3,86,Weegree AZS Politechnika Opolska,Sezon 2020/2021
2021-04-18 11:00,Górnik Trans.eu Wałbrzych(d),86 : 84W,86,25,45,55.6,7,24,29.2,32,69,46.4,15,24,62.5,9,29,38,23,24,27,12,7,4,2,100,Weegree AZS Politechnika Opolska,Sezon 2020/2021
2021-04-19 19:00,Górnik Trans.eu Wałbrzych(d),81 : 99P,81,16,29,55.2,8,35,22.9,24,64,37.5,25,31,80.6,12,20,32,18,30,25,13,3,1,2,76,Weegree AZS Politechnika Opolska,Sezon 2020/2021
2020-09-26 17:00,Decka Pelplin(w),77 : 93W,93,26,42,61.9,9,26,34.6,35,68,51.5,14,23,60.9,7,32,39,18,20,19,17,9,7,1,107,WKK Wrocław,Sezon 2020/2021
2020-10-03 18:00,Dziki Warszawa(d),98 : 105P,98,25,48,52.1,6,19,31.6,31,67,46.3,30,37,81.1,12,23,35,25,29,28,13,3,4,1,109,WKK Wrocław,Sezon 2020/2021
2020-10-10 18:00,Energa Kotwica Kołobrzeg(w),73 : 80W,80,19,42,45.2,9,23,39.1,28,65,43.1,15,22,68.2,9,26,35,15,22,21,15,10,4,1,85,WKK Wrocław,Sezon 2020/2021
2020-10-14 18:00,Górnik Trans.eu Wałbrzych(d),75 : 70W,75,20,46,43.5,8,20,40.0,28,66,42.4,11,19,57.9,8,34,42,20,22,22,21,5,8,5,83,WKK Wrocław,Sezon 2020/2021
2020-11-08 17:00,Elektrobud-Investment ZB Pruszków(w),56 : 64W,64,19,43,44.2,4,13,30.8,23,56,41.1,14,22,63.6,5,21,26,15,13,21,14,9,5,2,64,WKK Wrocław,Sezon 2020/2021
2020-11-11 18:00,KS Księżak Łowicz(d),96 : 79W,96,21,40,52.5,13,27,48.1,34,67,50.7,15,21,71.4,8,34,42,30,20,20,17,8,8,1,128,WKK Wrocław,Sezon 2020/2021
2020-11-14 17:30,Rawlplug Sokół Łańcut(w),88 : 92W,92,25,45,55.6,8,25,32.0,33,70,47.1,18,25,72.0,8,25,33,20,20,23,13,7,5,3,100,WKK Wrocław,Sezon 2020/2021
2020-11-18 18:00,TS Wisła Chemart Kraków(w),80 : 67P,67,18,46,39.1,5,24,20.8,23,70,32.9,16,18,88.9,10,25,35,15,19,19,9,6,3,3,68,WKK Wrocław,Sezon 2020/2021
2020-11-22 18:00,GKS Tychy(d),105 : 76W,105,22,34,64.7,13,25,52.0,35,59,59.3,22,26,84.6,6,28,34,33,15,20,14,7,7,1,144,WKK Wrocław,Sezon 2020/2021
2020-11-25 18:00,Weegree AZS Politechnika Opolska(w),72 : 91W,91,24,41,58.5,7,19,36.8,31,60,51.7,22,28,78.6,6,28,34,23,22,24,17,7,6,4,109,WKK Wrocław,Sezon 2020/2021
2020-11-28 17:00,Zetkama Doral Nysa Kłodzko(w),84 : 89W,89,28,47,59.6,7,21,33.3,35,68,51.5,12,17,70.6,10,24,34,12,21,20,15,7,5,1,94,WKK Wrocław,Sezon 2020/2021
2020-12-03 18:00,Grupa Sierleccy-Czarni Słupsk(d),71 : 87P,71,15,42,35.7,5,20,25.0,20,62,32.3,26,33,78.8,8,28,36,11,14,25,10,8,2,4,69,WKK Wrocław,Sezon 2020/2021
2020-12-06 18:00,TBS Śląsk II Wrocław(d),85 : 65W,85,21,42,50.0,11,25,44.0,32,67,47.8,10,15,66.7,6,29,35,26,13,16,12,10,5,3,109,WKK Wrocław,Sezon 2020/2021
2020-12-12 17:30,Pogoń Prudnik(w),75 : 86W,86,25,48,52.1,8,19,42.1,33,67,49.3,12,20,60.0,11,23,34,24,19,19,11,6,2,2,99,WKK Wrocław,Sezon 2020/2021
2020-12-20 17:00,Miasto Szkła Krosno(w),88 : 98W,98,23,40,57.5,8,19,42.1,31,59,52.5,28,41,68.3,11,26,37,15,18,32,14,8,3,1,106,WKK Wrocław,Sezon 2020/2021
2021-01-03 18:00,Decka Pelplin(d),95 : 92W,95,22,47,46.8,7,21,33.3,29,68,42.6,30,40,75.0,19,28,47,25,18,29,13,7,6,5,118,WKK Wrocław,Sezon 2020/2021
2021-01-09 18:00,Dziki Warszawa(w),86 : 73P,73,18,35,51.4,9,28,32.1,27,63,42.9,10,20,50.0,8,27,35,22,18,20,14,6,2,2,78,WKK Wrocław,Sezon 2020/2021
2021-01-16 18:00,Energa Kotwica Kołobrzeg(d),89 : 83W,89,22,39,56.4,10,39,25.6,32,78,41.0,15,27,55.6,16,27,43,23,21,25,6,3,3,5,97,WKK Wrocław,Sezon 2020/2021
2021-01-20 17:00,Górnik Trans.eu Wałbrzych(w),90 : 95W,95,26,57,45.6,8,24,33.3,34,81,42.0,19,26,73.1,10,34,44,20,18,20,10,5,5,4,105,WKK Wrocław,Sezon 2020/2021
2021-01-24 18:00,TS Wisła Chemart Kraków(d),100 : 69W,100,28,56,50.0,9,25,36.0,37,81,45.7,17,20,85.0,16,27,43,28,20,20,8,13,4,2,133,WKK Wrocław,Sezon 2020/2021
2021-01-30 18:00,Weegree AZS Politechnika Opolska(d),89 : 72W,89,28,44,63.6,7,23,30.4,35,67,52.2,12,18,66.7,8,33,41,26,22,18,15,5,2,1,110,WKK Wrocław,Sezon 2020/2021
2021-02-06 18:00,Grupa Sierleccy-Czarni Słupsk(w),89 : 76P,76,20,33,60.6,6,23,26.1,26,56,46.4,18,26,69.2,4,24,28,16,14,21,11,5,3,1,79,WKK Wrocław,Sezon 2020/2021
2021-02-13 18:00,Elektrobud-Investment ZB Pruszków(d),103 : 67W,103,23,40,57.5,11,20,55.0,34,60,56.7,24,29,82.8,7,32,39,32,21,27,20,11,2,1,136,WKK Wrocław,Sezon 2020/2021
2021-02-20 18:00,KS Księżak Łowicz(w),72 : 92W,92,23,35,65.7,11,24,45.8,34,59,57.6,13,17,76.5,7,30,37,19,18,17,22,11,3,3,111,WKK Wrocław,Sezon 2020/2021
2021-02-27 18:00,Rawlplug Sokół Łańcut(d),65 : 78P,65,17,39,43.6,4,23,17.4,21,62,33.9,19,24,79.2,12,30,42,18,19,23,15,9,4,3,77,WKK Wrocław,Sezon 2020/2021
2021-03-06 18:00,GKS Tychy(w),83 : 82P,82,23,46,50.0,8,25,32.0,31,71,43.7,12,21,57.1,10,23,33,13,16,19,9,9,2,4,81,WKK Wrocław,Sezon 2020/2021
2021-03-13 18:00,Zetkama Doral Nysa Kłodzko(d),100 : 64W,100,31,52,59.6,5,22,22.7,36,74,48.6,23,35,65.7,12,29,41,26,23,25,12,14,4,4,123,WKK Wrocław,Sezon 2020/2021
2021-03-22 19:00,TBS Śląsk II Wrocław(w),94 : 92P,92,20,47,42.6,11,35,31.4,31,82,37.8,19,27,70.4,17,26,43,14,21,22,12,10,5,8,93,WKK Wrocław,Sezon 2020/2021
2021-03-27 18:00,Pogoń Prudnik(d),103 : 82W,103,27,41,65.9,10,30,33.3,37,71,52.1,19,20,95.0,9,28,37,28,27,21,7,8,3,3,137,WKK Wrocław,Sezon 2020/2021
2021-03-31 18:00,Miasto Szkła Krosno(d),102 : 80W,102,27,44,61.4,12,24,50.0,39,68,57.4,12,19,63.2,5,21,26,32,19,19,15,12,1,4,122,WKK Wrocław,Sezon 2020/2021
2021-04-10 18:00,Miasto Szkła Krosno(d),84 : 77W,84,24,49,49.0,9,27,33.3,33,76,43.4,9,14,64.3,18,29,47,23,19,19,16,4,1,3,95,WKK Wrocław,Sezon 2020/2021
2021-04-11 18:00,Miasto Szkła Krosno(d),92 : 85W,92,24,39,61.5,9,25,36.0,33,64,51.6,17,25,68.0,7,22,29,22,23,25,13,4,3,3,98,WKK Wrocław,Sezon 2020/2021
2021-04-17 18:00,Miasto Szkła Krosno(w),62 : 72W,72,22,42,52.4,3,19,15.8,25,61,41.0,19,27,70.4,9,32,41,15,16,21,10,2,1,2,77,WKK Wrocław,Sezon 2020/2021
2021-04-24 17:00,Górnik Trans.eu Wałbrzych(w),63 : 83W,83,17,37,45.9,11,28,39.3,28,65,43.1,16,23,69.6,7,32,39,22,18,21,15,6,3,4,94,WKK Wrocław,Sezon 2020/2021
2021-04-25 17:00,Górnik Trans.eu Wałbrzych(w),88 : 66P,66,18,40,45.0,5,20,25.0,23,60,38.3,15,18,83.3,2,22,24,16,18,20,17,6,0,2,55,WKK Wrocław,Sezon 2020/2021
2021-05-01 18:00,Górnik Trans.eu Wałbrzych(d),93 : 95P,93,23,51,45.1,8,19,42.1,31,70,44.3,23,34,67.6,14,23,37,23,35,28,9,4,1,6,99,WKK Wrocław,Sezon 2020/2021
2021-05-02 18:00,Górnik Trans.eu Wałbrzych(d),78 : 74W,78,24,49,49.0,3,22,13.6,27,71,38.0,21,26,80.8,16,23,39,20,19,25,11,7,6,3,90,WKK Wrocław,Sezon 2020/2021
2021-05-05 18:30,Górnik Trans.eu Wałbrzych(w),89 : 70P,70,22,48,45.8,4,12,33.3,26,60,43.3,14,21,66.7,5,26,31,13,19,20,17,6,1,4,63,WKK Wrocław,Sezon 2020/2021
2021-05-08 17:30,Rawlplug Sokół Łańcut(w),91 : 93W,93,29,46,63.0,8,18,44.4,37,64,57.8,11,16,68.8,6,26,32,20,19,17,12,10,0,2,111,WKK Wrocław,Sezon 2020/2021
2021-05-15 17:00,Rawlplug Sokół Łańcut(d),77 : 90P,77,19,40,47.5,7,21,33.3,26,61,42.6,18,23,78.3,12,25,37,21,18,22,21,5,7,3,86,WKK Wrocław,Sezon 2020/2021
2020-09-26 17:00,Rawlplug Sokół Łańcut(d),52 : 95P,52,17,39,43.6,4,22,18.2,21,61,34.4,6,10,60.0,9,17,26,14,15,12,15,6,1,3,40,Zetkama Doral Nysa Kłodzko,Sezon 2020/2021
2020-10-03 18:00,GKS Tychy(w),106 : 92P,92,21,42,50.0,11,24,45.8,32,66,48.5,17,23,73.9,11,12,23,18,25,21,16,13,2,2,92,Zetkama Doral Nysa Kłodzko,Sezon 2020/2021
2020-10-10 17:00,Weegree AZS Politechnika Opolska(d),85 : 97P,85,21,42,50.0,10,27,37.0,31,69,44.9,13,15,86.7,9,25,34,18,21,19,10,6,0,4,93,Zetkama Doral Nysa Kłodzko,Sezon 2020/2021
2020-10-16 19:30,TBS Śląsk II Wrocław(d),80 : 82P,80,20,40,50.0,9,32,28.1,29,72,40.3,13,16,81.3,18,28,46,18,24,20,16,4,1,1,87,Zetkama Doral Nysa Kłodzko,Sezon 2020/2021
2020-10-31 17:00,Decka Pelplin(w),98 : 91P,91,30,47,63.8,6,22,27.3,36,69,52.2,13,21,61.9,9,26,35,26,25,19,13,7,3,0,108,Zetkama Doral Nysa Kłodzko,Sezon 2020/2021
2020-11-04 18:30,Pogoń Prudnik(w),112 : 100P,100,27,49,55.1,9,29,31.0,36,78,46.2,19,24,79.2,12,16,28,24,29,18,10,8,1,4,104,Zetkama Doral Nysa Kłodzko,Sezon 2020/2021
2020-11-11 18:00,Energa Kotwica Kołobrzeg(w),87 : 78P,78,16,40,40.0,10,33,30.3,26,73,35.6,16,26,61.5,16,24,40,19,20,21,12,8,0,3,76,Zetkama Doral Nysa Kłodzko,Sezon 2020/2021
2020-11-14 17:00,Górnik Trans.eu Wałbrzych(d),70 : 82P,70,16,39,41.0,7,22,31.8,23,61,37.7,17,27,63.0,11,22,33,15,15,22,17,5,0,6,58,Zetkama Doral Nysa Kłodzko,Sezon 2020/2021
2020-11-18 19:30,Miasto Szkła Krosno(d),68 : 74P,68,14,35,40.0,8,22,36.4,22,57,38.6,16,22,72.7,10,24,34,16,19,25,16,5,1,3,67,Zetkama Doral Nysa Kłodzko,Sezon 2020/2021
2020-11-21 18:00,TS Wisła Chemart Kraków(w),96 : 83P,83,26,49,53.1,6,18,33.3,32,67,47.8,13,22,59.1,9,27,36,15,20,20,18,4,3,3,79,Zetkama Doral Nysa Kłodzko,Sezon 2020/2021
2020-11-28 17:00,WKK Wrocław(d),84 : 89P,84,23,51,45.1,5,15,33.3,28,66,42.4,23,28,82.1,10,23,33,14,20,20,13,8,1,5,84,Zetkama Doral Nysa Kłodzko,Sezon 2020/2021
2020-12-05 17:00,Grupa Sierleccy-Czarni Słupsk(d),70 : 98P,70,13,33,39.4,12,22,54.5,25,55,45.5,8,16,50.0,2,17,19,14,21,18,9,1,1,3,58,Zetkama Doral Nysa Kłodzko,Sezon 2020/2021
2020-12-09 18:00,Dziki Warszawa(w),92 : 60P,60,14,37,37.8,5,10,50.0,19,47,40.4,17,26,65.4,10,25,35,14,18,20,29,4,2,4,49,Zetkama Doral Nysa Kłodzko,Sezon 2020/2021
2020-12-13 16:00,Elektrobud-Investment ZB Pruszków(d),60 : 95P,60,15,27,55.6,5,25,20.0,20,52,38.5,15,21,71.4,3,23,26,14,16,18,15,4,0,1,51,Zetkama Doral Nysa Kłodzko,Sezon 2020/2021
2020-12-19 17:00,KS Księżak Łowicz(w),121 : 90P,90,24,49,49.0,8,26,30.8,32,75,42.7,18,26,69.2,10,20,30,16,17,20,9,7,0,2,83,Zetkama Doral Nysa Kłodzko,Sezon 2020/2021
2021-01-03 17:30,Rawlplug Sokół Łańcut(w),102 : 69P,69,18,38,47.4,5,15,33.3,23,53,43.4,18,25,72.0,9,12,21,10,12,22,21,5,0,3,47,Zetkama Doral Nysa Kłodzko,Sezon 2020/2021
2021-01-09 17:00,GKS Tychy(d),68 : 87P,68,14,34,41.2,5,24,20.8,19,58,32.8,25,38,65.8,7,20,27,17,17,28,11,9,2,4,60,Zetkama Doral Nysa Kłodzko,Sezon 2020/2021
2021-01-16 17:30,Weegree AZS Politechnika Opolska(w),86 : 64P,64,17,35,48.6,5,20,25.0,22,55,40.0,15,20,75.0,5,17,22,13,24,21,15,8,1,4,55,Zetkama Doral Nysa Kłodzko,Sezon 2020/2021
2021-01-20 18:00,TBS Śląsk II Wrocław(w),106 : 77P,77,19,37,51.4,5,20,25.0,24,57,42.1,24,34,70.6,5,19,24,16,16,28,19,8,0,6,63,Zetkama Doral Nysa Kłodzko,Sezon 2020/2021
2021-01-23 17:00,Pogoń Prudnik(d),67 : 94P,67,21,39,53.8,4,24,16.7,25,63,39.7,13,17,76.5,13,19,32,10,18,18,20,9,0,1,56,Zetkama Doral Nysa Kłodzko,Sezon 2020/2021
2021-01-30 17:00,Miasto Szkła Krosno(w),94 : 77P,77,14,28,50.0,12,23,52.2,26,51,51.0,13,24,54.2,4,17,21,15,18,21,13,9,0,2,73,Zetkama Doral Nysa Kłodzko,Sezon 2020/2021
2021-02-06 17:00,Decka Pelplin(d),74 : 84P,74,18,40,45.0,10,29,34.5,28,69,40.6,8,10,80.0,9,23,32,18,13,16,12,10,0,3,79,Zetkama Doral Nysa Kłodzko,Sezon 2020/2021
2021-02-20 17:00,Energa Kotwica Kołobrzeg(d),54 : 83P,54,13,28,46.4,6,24,25.0,19,52,36.5,10,16,62.5,8,18,26,12,16,19,24,13,1,2,43,Zetkama Doral Nysa Kłodzko,Sezon 2020/2021
2021-02-27 18:00,Górnik Trans.eu Wałbrzych(w),95 : 64P,64,17,32,53.1,8,25,32.0,25,57,43.9,6,8,75.0,5,15,20,19,22,17,23,10,2,3,58,Zetkama Doral Nysa Kłodzko,Sezon 2020/2021
2021-03-06 17:00,TS Wisła Chemart Kraków(d),85 : 92P,85,20,34,58.8,8,29,27.6,28,63,44.4,21,31,67.7,8,25,33,15,31,27,13,6,0,4,81,Zetkama Doral Nysa Kłodzko,Sezon 2020/2021
2021-03-10 19:00,Dziki Warszawa(d),91 : 85W,91,21,33,63.6,6,22,27.3,27,55,49.1,31,36,86.1,10,23,33,24,24,30,17,9,1,1,108,Zetkama Doral Nysa Kłodzko,Sezon 2020/2021
2021-03-13 18:00,WKK Wrocław(w),100 : 64P,64,13,37,35.1,6,23,26.1,19,60,31.7,20,27,74.1,9,28,37,12,25,23,21,6,4,4,54,Zetkama Doral Nysa Kłodzko,Sezon 2020/2021
2021-03-22 16:00,Grupa Sierleccy-Czarni Słupsk(w),100 : 67P,67,13,38,34.2,6,18,33.3,19,56,33.9,23,28,82.1,12,17,29,9,25,23,16,6,1,3,54,Zetkama Doral Nysa Kłodzko,Sezon 2020/2021
2021-03-28 17:00,Elektrobud-Investment ZB Pruszków(w),84 : 69P,69,18,46,39.1,6,17,35.3,24,63,38.1,15,19,78.9,4,30,34,14,20,17,16,11,3,3,72,Zetkama Doral Nysa Kłodzko,Sezon 2020/2021
2021-03-31 18:00,KS Księżak Łowicz(d),76 : 86P,76,21,43,48.8,8,19,42.1,29,62,46.8,10,17,58.8,7,24,31,20,18,22,24,4,3,3,70,Zetkama Doral Nysa Kłodzko,Sezon 2020/2021
2019-09-28 19:00,GKS Tychy(w),108 : 94P,94,28,43,65.1,4,18,22.2,32,61,52.5,26,34,76.5,9,20,29,13,21,30,13,6,0,1,92,Biofarm Basket Poznań,Sezon 2019/2020
2019-10-05 16:00,STK Czarni Słupsk(d),90 : 91P,90,20,40,50.0,9,22,40.9,29,62,46.8,23,31,74.2,6,28,34,19,31,25,16,10,3,2,99,Biofarm Basket Poznań,Sezon 2019/2020
2019-10-12 17:00,Elektrobud-Investment ZB Pruszków(d),69 : 78P,69,20,35,57.1,4,26,15.4,24,61,39.3,17,31,54.8,9,20,29,13,23,27,13,8,4,1,59,Biofarm Basket Poznań,Sezon 2019/2020
2019-10-16 19:00,Timeout Polonia 1912 Leszno(d),104 : 101W,104,30,51,58.8,9,26,34.6,39,77,50.6,17,27,63.0,8,34,42,23,22,22,9,7,5,2,124,Biofarm Basket Poznań,Sezon 2019/2020
2019-10-20 16:30,Górnik Trans.eu Wałbrzych(w),68 : 59P,59,14,39,35.9,6,23,26.1,20,62,32.3,13,24,54.2,13,28,41,11,19,23,21,9,2,5,48,Biofarm Basket Poznań,Sezon 2019/2020
2019-11-02 17:00,Zetkama Doral Nysa Kłodzko(w),94 : 85P,85,17,43,39.5,8,23,34.8,25,66,37.9,27,32,84.4,11,23,34,18,27,22,15,4,3,1,83,Biofarm Basket Poznań,Sezon 2019/2020
2019-11-09 17:00,KS Księżak Łowicz(d),81 : 85P,81,19,41,46.3,10,25,40.0,29,66,43.9,13,19,68.4,14,21,35,19,22,24,21,9,2,1,82,Biofarm Basket Poznań,Sezon 2019/2020
2019-11-17 17:00,Energa Kotwica Kołobrzeg(w),88 : 77P,77,23,32,71.9,9,34,26.5,32,66,48.5,4,10,40.0,8,25,33,16,18,15,15,4,0,1,75,Biofarm Basket Poznań,Sezon 2019/2020
2019-11-23 17:00,Pogoń Prudnik(d),87 : 80W,87,27,42,64.3,4,28,14.3,31,70,44.3,21,23,91.3,14,26,40,18,23,23,11,6,4,0,103,Biofarm Basket Poznań,Sezon 2019/2020
2019-11-30 16:30,Miasto Szkła Krosno(w),80 : 71P,71,17,31,54.8,7,22,31.8,24,53,45.3,16,23,69.6,8,18,26,16,15,18,12,7,1,2,73,Biofarm Basket Poznań,Sezon 2019/2020
2019-12-07 18:00,Weegree AZS Politechnika Opolska(d),82 : 72W,82,15,35,42.9,12,29,41.4,27,64,42.2,16,22,72.7,7,28,35,15,27,24,10,8,2,0,89,Biofarm Basket Poznań,Sezon 2019/2020
2019-12-14 18:00,WKK Wrocław(w),74 : 61P,61,18,54,33.3,7,24,29.2,25,78,32.1,4,5,80.0,16,24,40,10,18,19,11,4,7,6,57,Biofarm Basket Poznań,Sezon 2019/2020
2019-12-22 16:00,Rawlplug Sokół Łańcut(d),77 : 92P,77,19,35,54.3,9,25,36.0,28,60,46.7,12,12,100.0,4,19,23,24,22,17,17,4,2,2,81,Biofarm Basket Poznań,Sezon 2019/2020
2020-01-04 17:00,GKS Tychy(d),83 : 68W,83,24,34,70.6,7,31,22.6,31,65,47.7,14,23,60.9,13,25,38,21,21,25,15,12,6,0,102,Biofarm Basket Poznań,Sezon 2019/2020
2020-01-11 18:00,STK Czarni Słupsk(w),70 : 63P,63,18,37,48.6,5,29,17.2,23,66,34.8,12,21,57.1,11,26,37,19,19,25,14,10,0,0,63,Biofarm Basket Poznań,Sezon 2019/2020
2020-01-18 18:00,Elektrobud-Investment ZB Pruszków(w),74 : 66P,66,21,40,52.5,3,28,10.7,24,68,35.3,15,25,60.0,14,27,41,16,16,22,14,8,3,2,66,Biofarm Basket Poznań,Sezon 2019/2020
2020-01-22 20:00,Timeout Polonia 1912 Leszno(w),68 : 88W,88,24,48,50.0,5,21,23.8,29,69,42.0,25,37,67.6,15,36,51,14,29,24,13,10,6,0,104,Biofarm Basket Poznań,Sezon 2019/2020
2020-01-25 17:00,Górnik Trans.eu Wałbrzych(d),83 : 80W,83,21,34,61.8,6,28,21.4,27,62,43.5,23,30,76.7,6,30,36,21,29,26,16,9,2,2,93,Biofarm Basket Poznań,Sezon 2019/2020
2020-02-09 17:00,Zetkama Doral Nysa Kłodzko(d),81 : 74W,81,22,43,51.2,8,26,30.8,30,69,43.5,13,22,59.1,10,21,31,16,23,18,6,6,3,2,83,Biofarm Basket Poznań,Sezon 2019/2020
2020-02-16 17:00,KS Księżak Łowicz(w),71 : 85W,85,21,38,55.3,9,28,32.1,30,66,45.5,16,22,72.7,15,26,41,14,23,23,15,7,0,2,90,Biofarm Basket Poznań,Sezon 2019/2020
2020-02-22 17:00,Energa Kotwica Kołobrzeg(d),88 : 66W,88,25,43,58.1,9,24,37.5,34,67,50.7,11,17,64.7,7,28,35,24,16,16,6,8,6,4,116,Biofarm Basket Poznań,Sezon 2019/2020
2020-02-29 17:30,Pogoń Prudnik(w),95 : 78P,78,23,39,59.0,6,25,24.0,29,64,45.3,14,22,63.6,7,21,28,22,23,22,12,6,0,1,79,Biofarm Basket Poznań,Sezon 2019/2020
2020-03-08 16:00,Miasto Szkła Krosno(d),65 : 74P,65,13,26,50.0,10,42,23.8,23,68,33.8,9,17,52.9,15,16,31,13,18,18,8,7,3,3,58,Biofarm Basket Poznań,Sezon 2019/2020
2019-10-05 17:00,Zetkama Doral Nysa Kłodzko(w),89 : 87P,87,22,33,66.7,10,24,41.7,32,57,56.1,13,25,52.0,5,16,21,22,23,23,7,4,3,3,93,Elektrobud-Investment ZB Pruszków,Sezon 2019/2020
2019-10-12 17:00,Biofarm Basket Poznań(w),69 : 78W,78,14,35,40.0,10,28,35.7,24,63,38.1,20,26,76.9,15,25,40,17,27,21,17,6,1,4,80,Elektrobud-Investment ZB Pruszków,Sezon 2019/2020
2019-10-16 18:30,KS Księżak Łowicz(w),104 : 90P,90,20,39,51.3,10,31,32.3,30,70,42.9,20,26,76.9,10,19,29,19,18,20,16,13,2,1,91,Elektrobud-Investment ZB Pruszków,Sezon 2019/2020
2019-10-20 18:00,Energa Kotwica Kołobrzeg(d),66 : 87P,66,16,34,47.1,8,26,30.8,24,60,40.0,10,12,83.3,4,19,23,18,21,16,21,7,8,0,63,Elektrobud-Investment ZB Pruszków,Sezon 2019/2020
2019-10-26 17:30,Pogoń Prudnik(w),80 : 88W,88,20,40,50.0,12,24,50.0,32,64,50.0,12,19,63.2,9,28,37,17,27,21,17,11,2,2,99,Elektrobud-Investment ZB Pruszków,Sezon 2019/2020
2019-11-02 18:00,Miasto Szkła Krosno(d),67 : 65W,67,13,38,34.2,8,26,30.8,21,64,32.8,17,23,73.9,12,18,30,13,19,23,6,11,0,2,66,Elektrobud-Investment ZB Pruszków,Sezon 2019/2020
2019-11-06 19:00,Weegree AZS Politechnika Opolska(w),75 : 77W,77,23,44,52.3,6,16,37.5,29,60,48.3,13,16,81.3,5,22,27,16,18,18,11,7,2,3,84,Elektrobud-Investment ZB Pruszków,Sezon 2019/2020
2019-11-09 18:00,WKK Wrocław(d),79 : 90P,79,24,44,54.5,6,21,28.6,30,65,46.2,13,20,65.0,11,18,29,14,21,25,14,8,0,3,74,Elektrobud-Investment ZB Pruszków,Sezon 2019/2020
2019-11-16 17:30,Rawlplug Sokół Łańcut(w),81 : 60P,60,10,31,32.3,8,25,32.0,18,56,32.1,16,22,72.7,7,23,30,9,21,22,17,9,0,1,47,Elektrobud-Investment ZB Pruszków,Sezon 2019/2020
2019-11-23 18:00,GKS Tychy(d),83 : 89P,83,12,25,48.0,13,33,39.4,25,58,43.1,20,37,54.1,7,20,27,14,23,31,12,11,2,0,75,Elektrobud-Investment ZB Pruszków,Sezon 2019/2020
2019-11-30 18:00,STK Czarni Słupsk(w),84 : 68P,68,20,36,55.6,5,26,19.2,25,62,40.3,13,17,76.5,5,20,25,10,12,15,11,5,0,2,56,Elektrobud-Investment ZB Pruszków,Sezon 2019/2020
2019-12-14 18:00,Timeout Polonia 1912 Leszno(d),80 : 86P,80,18,39,46.2,11,26,42.3,29,65,44.6,11,16,68.8,4,21,25,18,23,15,10,10,2,1,84,Elektrobud-Investment ZB Pruszków,Sezon 2019/2020
2019-12-21 18:00,Górnik Trans.eu Wałbrzych(d),79 : 82P,79,25,43,58.1,4,17,23.5,29,60,48.3,17,21,81.0,3,19,22,17,26,19,15,14,2,5,84,Elektrobud-Investment ZB Pruszków,Sezon 2019/2020
2020-01-11 18:00,Zetkama Doral Nysa Kłodzko(d),88 : 73W,88,19,38,50.0,10,26,38.5,29,64,45.3,20,27,74.1,11,24,35,17,25,20,9,11,4,2,104,Elektrobud-Investment ZB Pruszków,Sezon 2019/2020
2020-01-18 18:00,Biofarm Basket Poznań(d),74 : 66W,74,16,30,53.3,10,29,34.5,26,59,44.1,12,15,80.0,5,26,31,14,22,16,17,8,2,3,76,Elektrobud-Investment ZB Pruszków,Sezon 2019/2020
2020-01-22 19:00,KS Księżak Łowicz(d),72 : 69W,72,22,40,55.0,5,20,25.0,27,60,45.0,13,21,61.9,8,28,36,11,21,21,15,10,1,2,74,Elektrobud-Investment ZB Pruszków,Sezon 2019/2020
2020-01-25 18:00,Energa Kotwica Kołobrzeg(w),92 : 73P,73,18,35,51.4,8,29,27.6,26,64,40.6,13,22,59.1,6,11,17,13,18,21,12,8,1,1,53,Elektrobud-Investment ZB Pruszków,Sezon 2019/2020
2020-02-01 18:00,Pogoń Prudnik(d),74 : 75P,74,13,35,37.1,10,27,37.0,23,62,37.1,18,24,75.0,11,23,34,10,26,18,9,5,2,1,71,Elektrobud-Investment ZB Pruszków,Sezon 2019/2020
2020-02-09 18:00,Miasto Szkła Krosno(w),71 : 76W,76,22,35,62.9,7,23,30.4,29,58,50.0,11,24,45.8,3,23,26,13,24,24,13,10,1,1,71,Elektrobud-Investment ZB Pruszków,Sezon 2019/2020
2020-02-12 19:00,Weegree AZS Politechnika Opolska(d),86 : 82W,86,13,37,35.1,15,32,46.9,28,69,40.6,15,20,75.0,5,33,38,16,23,15,14,9,7,3,96,Elektrobud-Investment ZB Pruszków,Sezon 2019/2020
2020-02-19 18:00,WKK Wrocław(w),76 : 79W,79,18,37,48.6,11,24,45.8,29,61,47.5,10,16,62.5,7,23,30,19,23,18,16,10,1,2,85,Elektrobud-Investment ZB Pruszków,Sezon 2019/2020
2020-02-22 18:00,Rawlplug Sokół Łańcut(d),80 : 88P,80,20,37,54.1,10,29,34.5,30,66,45.5,10,12,83.3,6,16,22,14,22,19,11,7,3,1,77,Elektrobud-Investment ZB Pruszków,Sezon 2019/2020
2020-02-29 19:00,GKS Tychy(w),96 : 76P,76,16,39,41.0,9,25,36.0,25,64,39.1,17,26,65.4,8,15,23,13,25,25,13,9,2,6,62,Elektrobud-Investment ZB Pruszków,Sezon 2019/2020
2020-03-07 18:00,STK Czarni Słupsk(d),82 : 76W,82,21,28,75.0,9,30,30.0,30,58,51.7,13,17,76.5,5,18,23,13,16,17,9,11,3,1,91,Elektrobud-Investment ZB Pruszków,Sezon 2019/2020
2019-09-27 18:00,WKK Wrocław(w),102 : 82P,82,20,45,44.4,8,28,28.6,28,73,38.4,18,24,75.0,13,23,36,14,17,22,10,12,2,7,85,Energa Kotwica Kołobrzeg,Sezon 2019/2020
2019-10-05 18:30,Rawlplug Sokół Łańcut(d),78 : 93P,78,26,43,60.5,5,20,25.0,31,63,49.2,11,18,61.1,6,22,28,14,18,15,18,10,0,1,73,Energa Kotwica Kołobrzeg,Sezon 2019/2020
2019-10-12 18:00,GKS Tychy(w),86 : 83P,83,25,51,49.0,8,25,32.0,33,76,43.4,9,15,60.0,10,24,34,13,17,19,8,7,3,5,83,Energa Kotwica Kołobrzeg,Sezon 2019/2020
2019-10-16 19:00,STK Czarni Słupsk(d),58 : 80P,58,18,36,50.0,1,21,4.8,19,57,33.3,19,27,70.4,6,25,31,11,20,18,13,8,0,0,49,Energa Kotwica Kołobrzeg,Sezon 2019/2020
2019-10-20 18:00,Elektrobud-Investment ZB Pruszków(w),66 : 87W,87,28,51,54.9,4,16,25.0,32,67,47.8,19,23,82.6,9,30,39,19,16,21,12,15,0,8,109,Energa Kotwica Kołobrzeg,Sezon 2019/2020
2019-10-26 18:00,Timeout Polonia 1912 Leszno(d),89 : 76W,89,20,43,46.5,12,25,48.0,32,68,47.1,13,19,68.4,15,26,41,12,19,19,8,4,2,1,98,Energa Kotwica Kołobrzeg,Sezon 2019/2020
2019-11-02 17:30,Górnik Trans.eu Wałbrzych(w),76 : 74P,74,17,42,40.5,8,24,33.3,25,66,37.9,16,25,64.0,15,26,41,13,20,20,16,8,0,1,70,Energa Kotwica Kołobrzeg,Sezon 2019/2020
2019-11-09 17:00,Zetkama Doral Nysa Kłodzko(w),81 : 67P,67,16,40,40.0,6,25,24.0,22,65,33.8,17,22,77.3,19,22,41,14,22,18,20,8,0,2,62,Energa Kotwica Kołobrzeg,Sezon 2019/2020
2019-11-17 17:00,Biofarm Basket Poznań(d),88 : 77W,88,22,37,59.5,11,30,36.7,33,67,49.3,11,14,78.6,9,24,33,16,16,18,10,12,1,0,103,Energa Kotwica Kołobrzeg,Sezon 2019/2020
2019-11-23 18:00,KS Księżak Łowicz(w),111 : 109P,109,35,47,74.5,6,24,25.0,41,71,57.7,21,28,75.0,12,19,31,20,23,22,18,13,1,2,119,Energa Kotwica Kołobrzeg,Sezon 2019/2020
2019-12-07 18:00,Pogoń Prudnik(d),71 : 87P,71,17,33,51.5,6,25,24.0,23,58,39.7,19,26,73.1,6,25,31,10,19,22,13,10,5,1,72,Energa Kotwica Kołobrzeg,Sezon 2019/2020
2019-12-14 18:00,Miasto Szkła Krosno(w),98 : 91P,91,24,41,58.5,10,27,37.0,34,68,50.0,13,15,86.7,9,12,21,14,17,16,15,8,3,4,86,Energa Kotwica Kołobrzeg,Sezon 2019/2020
2019-12-21 18:00,Weegree AZS Politechnika Opolska(d),75 : 89P,75,22,44,50.0,5,21,23.8,27,65,41.5,16,22,72.7,8,21,29,13,23,24,15,6,3,5,67,Energa Kotwica Kołobrzeg,Sezon 2019/2020
2020-01-06 17:00,WKK Wrocław(d),92 : 96P,92,27,55,49.1,10,19,52.6,37,74,50.0,8,13,61.5,18,25,43,16,21,12,15,3,3,3,100,Energa Kotwica Kołobrzeg,Sezon 2019/2020
2020-01-11 17:30,Rawlplug Sokół Łańcut(w),99 : 94P,94,22,39,56.4,12,23,52.2,34,62,54.8,14,20,70.0,10,22,32,22,28,19,17,3,0,5,100,Energa Kotwica Kołobrzeg,Sezon 2019/2020
2020-01-18 18:00,GKS Tychy(d),76 : 91P,76,14,38,36.8,11,27,40.7,25,65,38.5,15,24,62.5,18,25,43,13,18,20,16,3,1,5,71,Energa Kotwica Kołobrzeg,Sezon 2019/2020
2020-01-22 18:00,STK Czarni Słupsk(w),92 : 66P,66,19,41,46.3,5,21,23.8,24,62,38.7,13,17,76.5,10,24,34,12,15,19,16,3,2,2,59,Energa Kotwica Kołobrzeg,Sezon 2019/2020
2020-01-25 18:00,Elektrobud-Investment ZB Pruszków(d),92 : 73W,92,21,30,70.0,11,19,57.9,32,49,65.3,17,23,73.9,5,37,42,9,21,18,23,9,1,1,107,Energa Kotwica Kołobrzeg,Sezon 2019/2020
2020-01-31 18:00,Timeout Polonia 1912 Leszno(w),94 : 79P,79,15,44,34.1,12,26,46.2,27,70,38.6,13,15,86.7,11,23,34,11,22,19,8,6,1,4,78,Energa Kotwica Kołobrzeg,Sezon 2019/2020
2020-02-08 18:00,Górnik Trans.eu Wałbrzych(d),77 : 72W,77,20,40,50.0,8,20,40.0,28,60,46.7,13,18,72.2,5,26,31,17,16,20,16,6,2,4,80,Energa Kotwica Kołobrzeg,Sezon 2019/2020
2020-02-15 18:00,Zetkama Doral Nysa Kłodzko(d),72 : 67W,72,17,34,50.0,5,22,22.7,22,56,39.3,23,32,71.9,6,26,32,16,19,24,9,7,4,3,79,Energa Kotwica Kołobrzeg,Sezon 2019/2020
2020-02-22 17:00,Biofarm Basket Poznań(w),88 : 66P,66,22,49,44.9,3,15,20.0,25,64,39.1,13,19,68.4,9,27,36,13,16,16,11,5,4,6,68,Energa Kotwica Kołobrzeg,Sezon 2019/2020
2020-02-29 18:00,KS Księżak Łowicz(d),105 : 83W,105,30,52,57.7,10,26,38.5,40,78,51.3,15,19,78.9,16,25,41,26,19,21,15,9,2,2,126,Energa Kotwica Kołobrzeg,Sezon 2019/2020
2019-09-28 19:00,Biofarm Basket Poznań(d),108 : 94W,108,25,45,55.6,14,29,48.3,39,74,52.7,16,23,69.6,14,24,38,22,30,21,12,8,1,0,123,GKS Tychy,Sezon 2019/2020
2019-10-05 18:00,KS Księżak Łowicz(w),81 : 78P,78,23,34,67.6,5,21,23.8,28,55,50.9,17,19,89.5,6,19,25,12,28,20,15,8,0,2,79,GKS Tychy,Sezon 2019/2020
2019-10-12 18:00,Energa Kotwica Kołobrzeg(d),86 : 83W,86,24,45,53.3,8,23,34.8,32,68,47.1,14,15,93.3,7,30,37,21,19,17,11,5,5,3,106,GKS Tychy,Sezon 2019/2020
2019-10-16 18:30,Pogoń Prudnik(w),81 : 78P,78,22,47,46.8,9,25,36.0,31,72,43.1,7,8,87.5,9,20,29,21,22,17,10,8,1,1,85,GKS Tychy,Sezon 2019/2020
2019-10-19 18:00,Miasto Szkła Krosno(d),62 : 69P,62,10,31,32.3,10,32,31.3,20,63,31.7,12,13,92.3,7,24,31,13,21,17,15,11,1,7,59,GKS Tychy,Sezon 2019/2020
2019-10-26 17:30,Weegree AZS Politechnika Opolska(w),83 : 87W,87,29,39,74.4,6,23,26.1,35,62,56.5,11,15,73.3,8,17,25,19,20,19,16,10,1,5,95,GKS Tychy,Sezon 2019/2020
2019-11-02 18:00,WKK Wrocław(w),92 : 61P,61,17,37,45.9,3,22,13.6,20,59,33.9,18,28,64.3,11,28,39,17,26,19,16,3,3,2,58,GKS Tychy,Sezon 2019/2020
2019-11-06 18:00,Rawlplug Sokół Łańcut(w),89 : 103W,103,23,37,62.2,11,23,47.8,34,60,56.7,24,27,88.9,7,21,28,19,25,25,17,7,2,0,113,GKS Tychy,Sezon 2019/2020
2019-11-16 19:00,STK Czarni Słupsk(d),84 : 91P,84,25,45,55.6,4,19,21.1,29,64,45.3,22,25,88.0,8,16,24,18,21,22,6,8,1,5,91,GKS Tychy,Sezon 2019/2020
2019-11-23 18:00,Elektrobud-Investment ZB Pruszków(w),83 : 89W,89,19,29,65.5,11,29,37.9,30,58,51.7,18,22,81.8,4,32,36,19,31,23,18,9,0,2,103,GKS Tychy,Sezon 2019/2020
2019-11-30 18:00,Timeout Polonia 1912 Leszno(d),92 : 82W,92,25,46,54.3,9,26,34.6,34,72,47.2,15,18,83.3,13,22,35,19,19,16,9,10,3,3,109,GKS Tychy,Sezon 2019/2020
2019-12-08 17:30,Górnik Trans.eu Wałbrzych(w),77 : 57P,57,7,21,33.3,8,24,33.3,15,45,33.3,19,38,50.0,11,25,36,11,18,24,17,4,1,2,43,GKS Tychy,Sezon 2019/2020
2019-12-21 17:00,Zetkama Doral Nysa Kłodzko(w),68 : 63P,63,17,35,48.6,6,22,27.3,23,57,40.4,11,19,57.9,11,30,41,14,25,20,15,4,0,3,65,GKS Tychy,Sezon 2019/2020
2020-01-04 17:00,Biofarm Basket Poznań(w),83 : 68P,68,19,45,42.2,6,16,37.5,25,61,41.0,12,17,70.6,9,20,29,13,25,21,22,7,0,6,54,GKS Tychy,Sezon 2019/2020
2020-01-11 18:00,KS Księżak Łowicz(d),99 : 82W,99,34,47,72.3,6,23,26.1,40,70,57.1,13,16,81.3,6,29,35,19,27,20,12,7,6,3,121,GKS Tychy,Sezon 2019/2020
2020-01-18 18:00,Energa Kotwica Kołobrzeg(w),76 : 91W,91,22,36,61.1,12,29,41.4,34,65,52.3,11,14,78.6,5,21,26,19,20,18,6,5,5,1,106,GKS Tychy,Sezon 2019/2020
2020-01-22 19:00,Pogoń Prudnik(d),94 : 99P,94,27,41,65.9,8,23,34.8,35,64,54.7,16,20,80.0,8,17,25,21,26,19,11,7,1,3,104,GKS Tychy,Sezon 2019/2020
2020-01-26 18:00,Miasto Szkła Krosno(w),88 : 81P,81,15,28,53.6,12,26,46.2,27,54,50.0,15,22,68.2,7,12,19,17,22,21,9,3,1,2,78,GKS Tychy,Sezon 2019/2020
2020-02-01 18:00,Weegree AZS Politechnika Opolska(d),88 : 84W,88,19,39,48.7,6,30,20.0,25,69,36.2,32,35,91.4,19,25,44,14,26,26,10,5,2,2,96,GKS Tychy,Sezon 2019/2020
2020-02-08 18:00,WKK Wrocław(d),92 : 101P,92,29,44,65.9,5,20,25.0,34,64,53.1,19,21,90.5,8,25,33,18,23,20,14,5,4,4,106,GKS Tychy,Sezon 2019/2020
2020-02-12 19:00,Rawlplug Sokół Łańcut(d),73 : 83P,73,23,39,59.0,5,25,20.0,28,64,43.8,12,20,60.0,10,20,30,18,22,20,18,10,3,2,72,GKS Tychy,Sezon 2019/2020
2020-02-22 18:00,STK Czarni Słupsk(w),85 : 64P,64,8,29,27.6,11,31,35.5,19,60,31.7,15,20,75.0,9,25,34,11,19,17,10,4,2,3,59,GKS Tychy,Sezon 2019/2020
2020-02-29 19:00,Elektrobud-Investment ZB Pruszków(d),96 : 76W,96,32,50,64.0,4,7,57.1,36,57,63.2,20,29,69.0,7,33,40,24,25,25,15,8,6,2,129,GKS Tychy,Sezon 2019/2020
2020-03-07 19:00,Timeout Polonia 1912 Leszno(w),72 : 89W,89,21,43,48.8,9,23,39.1,30,66,45.5,20,27,74.1,10,25,35,13,22,21,5,7,1,4,97,GKS Tychy,Sezon 2019/2020
2019-09-28 20:00,Timeout Polonia 1912 Leszno(w),63 : 96W,96,31,51,60.8,6,19,31.6,37,70,52.9,16,25,64.0,13,31,44,19,22,22,8,5,2,0,116,Górnik Trans.eu Wałbrzych,Sezon 2019/2020
2019-10-16 19:30,Zetkama Doral Nysa Kłodzko(w),66 : 81W,81,16,42,38.1,13,27,48.1,29,69,42.0,10,17,58.8,13,27,40,18,21,14,10,7,6,2,95,Górnik Trans.eu Wałbrzych,Sezon 2019/2020
2019-10-20 16:30,Biofarm Basket Poznań(d),68 : 59W,68,25,52,48.1,4,24,16.7,29,76,38.2,6,14,42.9,17,26,43,16,23,19,14,11,5,2,74,Górnik Trans.eu Wałbrzych,Sezon 2019/2020
2019-10-26 18:00,KS Księżak Łowicz(w),89 : 84P,84,26,42,61.9,5,24,20.8,31,66,47.0,17,26,65.4,10,24,34,17,30,19,10,10,2,1,93,Górnik Trans.eu Wałbrzych,Sezon 2019/2020
2019-11-02 17:30,Energa Kotwica Kołobrzeg(d),76 : 74W,76,19,40,47.5,7,23,30.4,26,63,41.3,17,23,73.9,10,28,38,19,21,19,14,10,1,0,87,Górnik Trans.eu Wałbrzych,Sezon 2019/2020
2019-11-06 18:30,Pogoń Prudnik(w),83 : 87W,87,20,35,57.1,10,23,43.5,30,58,51.7,17,23,73.9,4,22,26,23,19,24,9,6,6,2,105,Górnik Trans.eu Wałbrzych,Sezon 2019/2020
2019-11-09 17:00,Miasto Szkła Krosno(d),86 : 80W,86,15,40,37.5,11,40,27.5,26,80,32.5,23,33,69.7,15,36,51,21,30,28,14,11,2,3,93,Górnik Trans.eu Wałbrzych,Sezon 2019/2020
2019-11-17 17:30,Weegree AZS Politechnika Opolska(w),75 : 89W,89,21,42,50.0,9,18,50.0,30,60,50.0,20,25,80.0,11,23,34,14,26,19,17,8,1,0,94,Górnik Trans.eu Wałbrzych,Sezon 2019/2020
2019-11-24 16:00,WKK Wrocław(d),80 : 82P,80,25,55,45.5,7,20,35.0,32,75,42.7,9,15,60.0,15,24,39,23,21,19,10,8,4,5,95,Górnik Trans.eu Wałbrzych,Sezon 2019/2020
2019-12-01 16:30,Rawlplug Sokół Łańcut(d),82 : 76W,82,19,38,50.0,6,21,28.6,25,59,42.4,26,38,68.4,13,26,39,19,29,28,20,8,1,0,83,Górnik Trans.eu Wałbrzych,Sezon 2019/2020
2019-12-08 17:30,GKS Tychy(d),77 : 57W,77,17,36,47.2,12,30,40.0,29,66,43.9,7,12,58.3,10,22,32,24,24,18,9,11,2,1,95,Górnik Trans.eu Wałbrzych,Sezon 2019/2020
2019-12-14 18:00,STK Czarni Słupsk(w),75 : 80W,80,19,42,45.2,9,25,36.0,28,67,41.8,15,22,68.2,7,28,35,16,19,17,5,5,5,5,90,Górnik Trans.eu Wałbrzych,Sezon 2019/2020
2019-12-21 18:00,Elektrobud-Investment ZB Pruszków(w),79 : 82W,82,24,41,58.5,5,16,31.3,29,57,50.9,19,29,65.5,10,22,32,14,20,25,18,9,5,2,86,Górnik Trans.eu Wałbrzych,Sezon 2019/2020
2020-01-04 17:00,Timeout Polonia 1912 Leszno(d),84 : 79W,84,24,42,57.1,4,20,20.0,28,62,45.2,24,37,64.9,13,23,36,12,28,23,11,10,5,1,89,Górnik Trans.eu Wałbrzych,Sezon 2019/2020
2020-01-22 18:00,Zetkama Doral Nysa Kłodzko(d),90 : 86W,90,16,35,45.7,11,23,47.8,27,58,46.6,25,38,65.8,11,24,35,17,27,26,13,8,5,2,98,Górnik Trans.eu Wałbrzych,Sezon 2019/2020
2020-01-25 17:00,Biofarm Basket Poznań(w),83 : 80P,80,15,36,41.7,9,27,33.3,24,63,38.1,23,32,71.9,11,28,39,17,26,29,19,10,2,2,81,Górnik Trans.eu Wałbrzych,Sezon 2019/2020
2020-02-02 16:30,KS Księżak Łowicz(d),84 : 78W,84,25,42,59.5,8,21,38.1,33,63,52.4,10,18,55.6,11,26,37,17,24,22,13,8,2,1,97,Górnik Trans.eu Wałbrzych,Sezon 2019/2020
2020-02-08 18:00,Energa Kotwica Kołobrzeg(w),77 : 72P,72,14,34,41.2,10,27,37.0,24,61,39.3,14,20,70.0,7,22,29,11,20,16,13,6,4,2,66,Górnik Trans.eu Wałbrzych,Sezon 2019/2020
2020-02-12 18:00,Pogoń Prudnik(d),82 : 71W,82,22,48,45.8,10,30,33.3,32,78,41.0,8,12,66.7,13,21,34,17,22,16,8,14,3,2,92,Górnik Trans.eu Wałbrzych,Sezon 2019/2020
2020-02-16 18:00,Miasto Szkła Krosno(w),94 : 78P,78,16,36,44.4,8,25,32.0,24,61,39.3,22,26,84.6,6,13,19,12,16,24,8,10,0,3,70,Górnik Trans.eu Wałbrzych,Sezon 2019/2020
2020-02-22 17:00,Weegree AZS Politechnika Opolska(d),89 : 83W,89,20,34,58.8,8,25,32.0,28,59,47.5,25,33,75.8,9,27,36,23,28,25,18,11,5,2,107,Górnik Trans.eu Wałbrzych,Sezon 2019/2020
2020-03-01 18:00,WKK Wrocław(w),65 : 78W,78,23,47,48.9,5,24,20.8,28,71,39.4,17,21,81.0,10,34,44,17,25,18,14,9,2,2,89,Górnik Trans.eu Wałbrzych,Sezon 2019/2020
2020-03-07 17:30,Rawlplug Sokół Łańcut(w),78 : 81W,81,22,38,57.9,8,20,40.0,30,58,51.7,13,20,65.0,10,24,34,21,26,21,19,10,6,3,98,Górnik Trans.eu Wałbrzych,Sezon 2019/2020
2019-09-28 18:30,Rawlplug Sokół Łańcut(d),75 : 89P,75,21,36,58.3,6,22,27.3,27,58,46.6,15,23,65.2,8,20,28,17,18,22,16,6,4,1,75,KS Księżak Łowicz,Sezon 2019/2020
2019-10-05 18:00,GKS Tychy(d),81 : 78W,81,21,36,58.3,6,26,23.1,27,62,43.5,21,23,91.3,11,20,31,15,20,28,13,9,2,0,88,KS Księżak Łowicz,Sezon 2019/2020
2019-10-12 18:00,STK Czarni Słupsk(w),81 : 78P,78,20,40,50.0,8,25,32.0,28,65,43.1,14,20,70.0,10,22,32,18,24,19,11,5,1,2,80,KS Księżak Łowicz,Sezon 2019/2020
2019-10-16 18:30,Elektrobud-Investment ZB Pruszków(d),104 : 90W,104,29,48,60.4,9,20,45.0,38,68,55.9,19,20,95.0,10,27,37,22,21,17,19,11,1,2,125,KS Księżak Łowicz,Sezon 2019/2020
2019-10-19 18:00,Timeout Polonia 1912 Leszno(w),88 : 75P,75,19,39,48.7,11,26,42.3,30,65,46.2,4,12,33.3,8,24,32,9,25,19,15,10,1,3,69,KS Księżak Łowicz,Sezon 2019/2020
2019-10-26 18:00,Górnik Trans.eu Wałbrzych(d),89 : 84W,89,20,36,55.6,6,26,23.1,26,62,41.9,31,38,81.6,15,30,45,18,19,30,13,7,1,2,104,KS Księżak Łowicz,Sezon 2019/2020
2019-11-06 18:30,Zetkama Doral Nysa Kłodzko(d),100 : 93W,100,23,43,53.5,7,19,36.8,30,62,48.4,33,39,84.6,16,21,37,17,17,24,16,8,3,1,111,KS Księżak Łowicz,Sezon 2019/2020
2019-11-09 17:00,Biofarm Basket Poznań(w),81 : 85W,85,22,36,61.1,9,25,36.0,31,61,50.8,14,20,70.0,9,21,30,17,24,21,18,13,1,2,92,KS Księżak Łowicz,Sezon 2019/2020
2019-11-23 18:00,Energa Kotwica Kołobrzeg(d),111 : 109W,111,32,46,69.6,7,23,30.4,39,69,56.5,26,33,78.8,12,17,29,20,25,23,18,11,2,1,118,KS Księżak Łowicz,Sezon 2019/2020
2019-11-30 17:30,Pogoń Prudnik(w),110 : 83P,83,20,40,50.0,6,21,28.6,26,61,42.6,25,29,86.2,2,20,22,14,23,24,9,7,0,3,78,KS Księżak Łowicz,Sezon 2019/2020
2019-12-07 18:00,Miasto Szkła Krosno(d),90 : 86W,90,22,44,50.0,7,23,30.4,29,67,43.3,25,29,86.2,12,28,40,15,21,26,13,8,3,0,101,KS Księżak Łowicz,Sezon 2019/2020
2019-12-15 17:30,Weegree AZS Politechnika Opolska(w),80 : 117W,117,31,48,64.6,12,27,44.4,43,75,57.3,19,23,82.6,7,31,38,20,20,23,6,6,1,3,140,KS Księżak Łowicz,Sezon 2019/2020
2019-12-21 17:00,WKK Wrocław(d),111 : 107W,111,27,52,51.9,11,27,40.7,38,79,48.1,24,27,88.9,10,26,36,20,29,22,12,3,0,3,114,KS Księżak Łowicz,Sezon 2019/2020
2020-01-04 17:30,Rawlplug Sokół Łańcut(w),88 : 79P,79,20,42,47.6,11,25,44.0,31,67,46.3,6,10,60.0,8,24,32,19,15,17,12,8,0,3,86,KS Księżak Łowicz,Sezon 2019/2020
2020-01-11 18:00,GKS Tychy(w),99 : 82P,82,18,36,50.0,5,23,21.7,23,59,39.0,31,34,91.2,7,24,31,12,20,27,14,7,3,6,82,KS Księżak Łowicz,Sezon 2019/2020
2020-01-18 18:00,STK Czarni Słupsk(d),88 : 85W,88,15,28,53.6,10,28,35.7,25,56,44.6,28,31,90.3,7,29,36,13,19,27,14,7,0,1,96,KS Księżak Łowicz,Sezon 2019/2020
2020-01-22 19:00,Elektrobud-Investment ZB Pruszków(w),72 : 69P,69,15,32,46.9,9,33,27.3,24,65,36.9,12,18,66.7,11,24,35,15,22,20,16,9,2,1,67,KS Księżak Łowicz,Sezon 2019/2020
2020-01-25 18:00,Timeout Polonia 1912 Leszno(d),101 : 78W,101,26,47,55.3,9,19,47.4,35,66,53.0,22,28,78.6,10,30,40,20,19,25,6,5,1,1,124,KS Księżak Łowicz,Sezon 2019/2020
2020-02-02 16:30,Górnik Trans.eu Wałbrzych(w),84 : 78P,78,21,40,52.5,6,22,27.3,27,62,43.5,18,25,72.0,11,17,28,13,22,24,14,12,1,2,76,KS Księżak Łowicz,Sezon 2019/2020
2020-02-12 19:30,Zetkama Doral Nysa Kłodzko(w),91 : 93W,93,19,35,54.3,13,27,48.1,32,62,51.6,16,21,76.2,7,26,33,13,23,17,11,8,2,5,103,KS Księżak Łowicz,Sezon 2019/2020
2020-02-16 17:00,Biofarm Basket Poznań(d),71 : 85P,71,16,41,39.0,7,20,35.0,23,61,37.7,18,23,78.3,9,22,31,10,25,23,15,7,2,0,63,KS Księżak Łowicz,Sezon 2019/2020
2020-02-29 18:00,Energa Kotwica Kołobrzeg(w),105 : 83P,83,20,38,52.6,9,32,28.1,29,70,41.4,16,22,72.7,14,17,31,17,21,19,22,7,2,2,71,KS Księżak Łowicz,Sezon 2019/2020
2020-03-07 18:00,Pogoń Prudnik(d),110 : 92W,110,34,50,68.0,6,26,23.1,40,76,52.6,24,30,80.0,14,24,38,16,20,26,6,9,3,0,128,KS Księżak Łowicz,Sezon 2019/2020
2019-10-05 18:00,Weegree AZS Politechnika Opolska(d),78 : 80P,78,17,34,50.0,11,30,36.7,28,64,43.8,11,13,84.6,8,26,34,17,22,18,12,7,3,1,89,Miasto Szkła Krosno,Sezon 2019/2020
2019-10-12 18:00,WKK Wrocław(w),64 : 65W,65,11,31,35.5,9,24,37.5,20,55,36.4,16,26,61.5,14,28,42,16,22,21,17,6,2,4,69,Miasto Szkła Krosno,Sezon 2019/2020
2019-10-19 18:00,GKS Tychy(w),62 : 69W,69,17,31,54.8,7,24,29.2,24,55,43.6,14,24,58.3,6,27,33,16,17,21,17,7,7,1,74,Miasto Szkła Krosno,Sezon 2019/2020
2019-10-26 18:00,STK Czarni Słupsk(d),74 : 72W,74,19,41,46.3,8,26,30.8,27,67,40.3,12,21,57.1,8,28,36,16,19,19,12,7,3,2,75,Miasto Szkła Krosno,Sezon 2019/2020
2019-11-02 18:00,Elektrobud-Investment ZB Pruszków(w),67 : 65P,65,22,45,48.9,3,10,30.0,25,55,45.5,12,15,80.0,8,31,39,6,23,19,15,5,2,0,69,Miasto Szkła Krosno,Sezon 2019/2020
2019-11-06 18:00,Timeout Polonia 1912 Leszno(d),78 : 71W,78,19,39,48.7,10,30,33.3,29,69,42.0,10,13,76.9,10,28,38,15,21,17,11,8,1,0,86,Miasto Szkła Krosno,Sezon 2019/2020
2019-11-09 17:00,Górnik Trans.eu Wałbrzych(w),86 : 80P,80,19,48,39.6,8,37,21.6,27,85,31.8,18,31,58.1,18,39,57,16,28,30,16,9,3,2,78,Miasto Szkła Krosno,Sezon 2019/2020
2019-11-20 18:00,Rawlplug Sokół Łańcut(d),83 : 76W,83,27,44,61.4,5,21,23.8,32,65,49.2,14,18,77.8,10,30,40,15,20,18,13,7,2,0,97,Miasto Szkła Krosno,Sezon 2019/2020
2019-11-23 17:00,Zetkama Doral Nysa Kłodzko(w),82 : 79P,79,18,31,58.1,11,28,39.3,29,59,49.2,10,15,66.7,8,21,29,19,19,17,19,7,1,0,81,Miasto Szkła Krosno,Sezon 2019/2020
2019-11-30 16:30,Biofarm Basket Poznań(d),80 : 71W,80,22,42,52.4,10,28,35.7,32,70,45.7,6,6,100.0,11,23,34,20,18,15,11,8,2,1,95,Miasto Szkła Krosno,Sezon 2019/2020
2019-12-07 18:00,KS Księżak Łowicz(w),90 : 86P,86,18,28,64.3,10,35,28.6,28,63,44.4,20,29,69.0,9,26,35,17,26,21,12,9,0,3,91,Miasto Szkła Krosno,Sezon 2019/2020
2019-12-14 18:00,Energa Kotwica Kołobrzeg(d),98 : 91W,98,30,46,65.2,8,17,47.1,38,63,60.3,14,18,77.8,9,20,29,23,16,17,11,8,4,3,122,Miasto Szkła Krosno,Sezon 2019/2020
2019-12-21 17:30,Pogoń Prudnik(w),69 : 84W,84,16,32,50.0,12,23,52.2,28,55,50.9,16,22,72.7,5,25,30,18,29,21,12,4,2,1,93,Miasto Szkła Krosno,Sezon 2019/2020
2020-01-12 17:00,Weegree AZS Politechnika Opolska(w),104 : 101P,101,27,43,62.8,11,32,34.4,38,75,50.7,14,17,82.4,10,23,33,23,26,24,11,7,3,2,116,Miasto Szkła Krosno,Sezon 2019/2020
2020-01-18 18:00,WKK Wrocław(d),67 : 70P,65,17,38,44.7,8,25,32.0,25,63,39.7,7,10,70.0,11,22,33,18,17,11,11,5,1,3,70,Miasto Szkła Krosno,Sezon 2019/2020
2020-01-22 18:00,Rawlplug Sokół Łańcut(w),92 : 89P,89,25,42,59.5,7,20,35.0,32,62,51.6,18,23,78.3,11,23,34,15,26,22,13,6,5,4,101,Miasto Szkła Krosno,Sezon 2019/2020
2020-01-26 18:00,GKS Tychy(d),88 : 81W,88,22,38,57.9,10,20,50.0,32,58,55.2,14,18,77.8,8,19,27,25,22,22,6,6,2,1,112,Miasto Szkła Krosno,Sezon 2019/2020
2020-02-01 18:00,STK Czarni Słupsk(w),93 : 74P,74,17,38,44.7,11,28,39.3,28,66,42.4,7,10,70.0,8,18,26,15,18,16,13,3,1,3,65,Miasto Szkła Krosno,Sezon 2019/2020
2020-02-09 18:00,Elektrobud-Investment ZB Pruszków(d),71 : 76P,71,17,34,50.0,5,20,25.0,22,54,40.7,22,32,68.8,7,28,35,16,24,24,16,10,1,1,75,Miasto Szkła Krosno,Sezon 2019/2020
2020-02-12 20:00,Timeout Polonia 1912 Leszno(w),79 : 71P,71,19,42,45.2,7,25,28.0,26,67,38.8,12,17,70.6,13,29,42,10,26,20,15,8,2,3,72,Miasto Szkła Krosno,Sezon 2019/2020
2020-02-16 18:00,Górnik Trans.eu Wałbrzych(d),94 : 78W,94,31,39,79.5,6,17,35.3,37,56,66.1,14,18,77.8,6,27,33,22,24,16,20,5,3,0,114,Miasto Szkła Krosno,Sezon 2019/2020
2020-02-29 18:00,Zetkama Doral Nysa Kłodzko(d),95 : 58W,95,22,40,55.0,9,22,40.9,31,62,50.0,24,34,70.6,12,31,43,26,19,25,13,10,1,1,121,Miasto Szkła Krosno,Sezon 2019/2020
2020-03-08 16:00,Biofarm Basket Poznań(w),65 : 74W,74,18,32,56.3,7,20,35.0,25,52,48.1,17,18,94.4,11,26,37,14,19,18,14,6,3,3,92,Miasto Szkła Krosno,Sezon 2019/2020
2019-09-29 17:00,Weegree AZS Politechnika Opolska(w),90 : 79P,79,24,41,58.5,4,22,18.2,28,63,44.4,19,22,86.4,4,29,33,18,32,23,8,2,3,1,89,Pogoń Prudnik,Sezon 2019/2020
2019-10-05 17:30,WKK Wrocław(d),91 : 85W,91,14,37,37.8,17,38,44.7,31,75,41.3,12,17,70.6,16,23,39,26,20,18,8,5,2,4,106,Pogoń Prudnik,Sezon 2019/2020
2019-10-12 17:30,Rawlplug Sokół Łańcut(w),101 : 92P,92,22,36,61.1,11,28,39.3,33,64,51.6,15,18,83.3,7,20,27,20,20,23,10,6,0,4,101,Pogoń Prudnik,Sezon 2019/2020
2019-10-16 18:30,GKS Tychy(d),81 : 78W,81,14,31,45.2,12,28,42.9,26,59,44.1,17,20,85.0,9,26,35,18,18,22,14,6,1,1,91,Pogoń Prudnik,Sezon 2019/2020
2019-10-19 18:00,STK Czarni Słupsk(w),76 : 74P,74,18,34,52.9,8,25,32.0,26,59,44.1,14,20,70.0,9,22,31,13,19,21,8,4,1,3,76,Pogoń Prudnik,Sezon 2019/2020
2019-10-26 17:30,Elektrobud-Investment ZB Pruszków(d),80 : 88P,80,15,32,46.9,7,27,25.9,22,59,37.3,29,37,78.4,9,22,31,15,21,26,16,10,2,2,77,Pogoń Prudnik,Sezon 2019/2020
2019-11-02 18:00,Timeout Polonia 1912 Leszno(w),84 : 70P,70,18,33,54.5,7,29,24.1,25,62,40.3,13,22,59.1,9,28,37,11,21,22,13,5,3,1,67,Pogoń Prudnik,Sezon 2019/2020
2019-11-06 18:30,Górnik Trans.eu Wałbrzych(d),83 : 87P,83,12,31,38.7,15,28,53.6,27,59,45.8,14,14,100.0,4,21,25,16,24,19,13,4,2,6,85,Pogoń Prudnik,Sezon 2019/2020
2019-11-16 17:30,Zetkama Doral Nysa Kłodzko(d),88 : 72W,88,23,41,56.1,10,28,35.7,33,69,47.8,12,15,80.0,8,28,36,21,26,20,10,8,1,1,105,Pogoń Prudnik,Sezon 2019/2020
2019-11-23 17:00,Biofarm Basket Poznań(w),87 : 80P,80,16,34,47.1,10,32,31.3,26,66,39.4,18,26,69.2,13,24,37,17,23,23,11,9,0,4,84,Pogoń Prudnik,Sezon 2019/2020
2019-11-30 17:30,KS Księżak Łowicz(d),110 : 83W,110,26,44,59.1,13,24,54.2,39,68,57.4,19,21,90.5,7,29,36,26,24,22,12,1,3,0,133,Pogoń Prudnik,Sezon 2019/2020
2019-12-07 18:00,Energa Kotwica Kołobrzeg(w),71 : 87W,87,19,39,48.7,12,29,41.4,31,68,45.6,13,20,65.0,9,26,35,18,22,19,13,9,1,5,93,Pogoń Prudnik,Sezon 2019/2020
2019-12-21 17:30,Miasto Szkła Krosno(d),69 : 84P,69,14,29,48.3,5,26,19.2,19,55,34.5,26,31,83.9,7,23,30,12,22,29,11,5,1,2,65,Pogoń Prudnik,Sezon 2019/2020
2020-01-04 17:30,Weegree AZS Politechnika Opolska(d),96 : 68W,96,23,34,67.6,9,30,30.0,32,64,50.0,23,27,85.2,11,25,36,23,20,23,9,8,4,0,122,Pogoń Prudnik,Sezon 2019/2020
2020-01-12 18:00,WKK Wrocław(w),96 : 79P,79,18,33,54.5,12,32,37.5,30,65,46.2,7,9,77.8,11,20,31,27,18,12,19,7,0,6,88,Pogoń Prudnik,Sezon 2019/2020
2020-01-18 17:30,Rawlplug Sokół Łańcut(d),79 : 86P,79,18,39,46.2,5,19,26.3,23,58,39.7,28,31,90.3,8,18,26,22,27,26,13,8,2,2,86,Pogoń Prudnik,Sezon 2019/2020
2020-01-22 19:00,GKS Tychy(w),94 : 99W,99,16,26,61.5,15,32,46.9,31,58,53.4,22,28,78.6,10,19,29,25,19,26,14,8,3,1,117,Pogoń Prudnik,Sezon 2019/2020
2020-01-25 17:30,STK Czarni Słupsk(d),72 : 89P,72,19,32,59.4,8,27,29.6,27,59,45.8,10,12,83.3,3,24,27,24,15,19,19,4,2,1,76,Pogoń Prudnik,Sezon 2019/2020
2020-02-01 18:00,Elektrobud-Investment ZB Pruszków(w),74 : 75W,75,9,26,34.6,11,28,39.3,20,54,37.0,24,27,88.9,7,22,29,21,19,26,12,5,1,2,82,Pogoń Prudnik,Sezon 2019/2020
2020-02-08 17:30,Timeout Polonia 1912 Leszno(d),87 : 84W,87,18,29,62.1,13,28,46.4,31,57,54.4,12,17,70.6,3,20,23,30,22,17,13,4,1,0,101,Pogoń Prudnik,Sezon 2019/2020
2020-02-12 18:00,Górnik Trans.eu Wałbrzych(w),82 : 71P,71,10,25,40.0,11,26,42.3,21,51,41.2,18,22,81.8,7,30,37,13,17,22,21,3,2,3,71,Pogoń Prudnik,Sezon 2019/2020
2020-02-22 17:00,Zetkama Doral Nysa Kłodzko(w),71 : 74W,74,16,33,48.5,11,28,39.3,27,61,44.3,9,16,56.3,7,26,33,17,24,21,9,6,1,2,81,Pogoń Prudnik,Sezon 2019/2020
2020-02-29 17:30,Biofarm Basket Poznań(d),95 : 78W,95,20,32,62.5,13,32,40.6,33,64,51.6,16,18,88.9,8,24,32,27,22,23,9,9,1,0,122,Pogoń Prudnik,Sezon 2019/2020
2020-03-07 18:00,KS Księżak Łowicz(w),110 : 92P,92,27,38,71.1,9,30,30.0,36,68,52.9,11,13,84.6,7,23,30,23,26,20,13,5,0,3,103,Pogoń Prudnik,Sezon 2019/2020
2019-09-28 18:30,KS Księżak Łowicz(w),75 : 89W,89,28,49,57.1,7,20,35.0,35,69,50.7,12,17,70.6,7,23,30,18,22,18,8,12,1,4,103,Rawlplug Sokół Łańcut,Sezon 2019/2020
2019-10-05 18:30,Energa Kotwica Kołobrzeg(w),78 : 93W,93,23,34,67.6,12,33,36.4,35,67,52.2,11,16,68.8,7,24,31,19,15,17,14,12,1,0,105,Rawlplug Sokół Łańcut,Sezon 2019/2020
2019-10-12 17:30,Pogoń Prudnik(d),101 : 92W,101,28,46,60.9,10,30,33.3,38,76,50.0,15,19,78.9,17,21,38,15,23,19,9,6,4,0,113,Rawlplug Sokół Łańcut,Sezon 2019/2020
2019-10-19 17:30,Weegree AZS Politechnika Opolska(d),102 : 75W,102,20,41,48.8,17,36,47.2,37,77,48.1,11,14,78.6,13,22,35,24,25,14,7,20,1,1,132,Rawlplug Sokół Łańcut,Sezon 2019/2020
2019-10-26 18:00,WKK Wrocław(w),78 : 84W,84,21,46,45.7,11,28,39.3,32,74,43.2,9,15,60.0,12,24,36,21,19,19,14,12,3,7,94,Rawlplug Sokół Łańcut,Sezon 2019/2020
2019-11-06 18:00,GKS Tychy(d),89 : 103P,89,22,36,61.1,9,26,34.6,31,62,50.0,18,27,66.7,10,18,28,20,26,24,19,12,0,2,90,Rawlplug Sokół Łańcut,Sezon 2019/2020
2019-11-09 18:00,STK Czarni Słupsk(w),95 : 88P,88,21,39,53.8,12,27,44.4,33,66,50.0,10,12,83.3,8,15,23,20,19,20,9,6,0,2,93,Rawlplug Sokół Łańcut,Sezon 2019/2020
2019-11-16 17:30,Elektrobud-Investment ZB Pruszków(d),81 : 60W,81,15,30,50.0,12,24,50.0,27,54,50.0,15,21,71.4,6,33,39,18,22,21,16,15,1,0,105,Rawlplug Sokół Łańcut,Sezon 2019/2020
2019-11-20 18:00,Miasto Szkła Krosno(w),83 : 76P,76,15,31,48.4,9,34,26.5,24,65,36.9,19,23,82.6,9,18,27,13,20,19,12,11,0,2,70,Rawlplug Sokół Łańcut,Sezon 2019/2020
2019-11-23 17:30,Timeout Polonia 1912 Leszno(d),87 : 89P,87,21,39,53.8,11,28,39.3,32,67,47.8,12,15,80.0,4,29,33,18,25,19,8,3,1,0,96,Rawlplug Sokół Łańcut,Sezon 2019/2020
2019-12-01 16:30,Górnik Trans.eu Wałbrzych(w),82 : 76P,76,19,39,48.7,5,21,23.8,24,60,40.0,23,33,69.7,10,24,34,18,28,29,13,12,0,1,81,Rawlplug Sokół Łańcut,Sezon 2019/2020
2019-12-14 17:30,Zetkama Doral Nysa Kłodzko(d),93 : 69W,93,17,31,54.8,10,28,35.7,27,59,45.8,29,35,82.9,13,25,38,22,20,25,12,7,2,1,112,Rawlplug Sokół Łańcut,Sezon 2019/2020
2019-12-22 16:00,Biofarm Basket Poznań(w),77 : 92W,92,30,47,63.8,6,22,27.3,36,69,52.2,14,16,87.5,12,23,35,20,17,22,12,8,2,2,110,Rawlplug Sokół Łańcut,Sezon 2019/2020
2020-01-04 17:30,KS Księżak Łowicz(d),88 : 79W,88,28,41,68.3,9,28,32.1,37,69,53.6,5,7,71.4,7,28,35,20,17,15,11,6,3,0,107,Rawlplug Sokół Łańcut,Sezon 2019/2020
2020-01-11 17:30,Energa Kotwica Kołobrzeg(d),99 : 94W,99,21,34,61.8,11,27,40.7,32,61,52.5,24,31,77.4,8,16,24,26,19,28,11,10,5,0,117,Rawlplug Sokół Łańcut,Sezon 2019/2020
2020-01-18 17:30,Pogoń Prudnik(w),79 : 86W,86,24,40,60.0,4,17,23.5,28,57,49.1,26,34,76.5,9,24,33,19,26,27,16,7,2,2,94,Rawlplug Sokół Łańcut,Sezon 2019/2020
2020-01-22 18:00,Miasto Szkła Krosno(d),92 : 89W,92,24,43,55.8,7,18,38.9,31,61,50.8,23,26,88.5,5,17,22,16,22,26,9,8,4,5,100,Rawlplug Sokół Łańcut,Sezon 2019/2020
2020-01-25 17:30,Weegree AZS Politechnika Opolska(w),94 : 78P,78,25,48,52.1,7,21,33.3,32,69,46.4,7,15,46.7,10,18,28,20,20,18,12,9,1,3,79,Rawlplug Sokół Łańcut,Sezon 2019/2020
2020-02-05 18:00,WKK Wrocław(d),79 : 88P,79,19,46,41.3,9,30,30.0,28,76,36.8,14,20,70.0,8,23,31,20,23,19,6,6,3,7,79,Rawlplug Sokół Łańcut,Sezon 2019/2020
2020-02-12 19:00,GKS Tychy(w),73 : 83W,83,14,25,56.0,11,26,42.3,25,51,49.0,22,25,88.0,4,25,29,18,20,22,22,11,2,3,92,Rawlplug Sokół Łańcut,Sezon 2019/2020
2020-02-15 17:30,STK Czarni Słupsk(d),73 : 79P,73,17,34,50.0,9,31,29.0,26,65,40.0,12,15,80.0,10,26,36,19,17,18,13,3,2,4,78,Rawlplug Sokół Łańcut,Sezon 2019/2020
2020-02-22 18:00,Elektrobud-Investment ZB Pruszków(w),80 : 88W,88,28,46,60.9,6,20,30.0,34,66,51.5,14,22,63.6,9,28,37,21,19,21,12,5,1,3,100,Rawlplug Sokół Łańcut,Sezon 2019/2020
2020-02-29 18:00,Timeout Polonia 1912 Leszno(w),70 : 80W,80,19,33,57.6,9,24,37.5,28,57,49.1,15,20,75.0,2,37,39,9,23,16,13,8,2,1,91,Rawlplug Sokół Łańcut,Sezon 2019/2020
2020-03-07 17:30,Górnik Trans.eu Wałbrzych(d),78 : 81P,78,22,41,53.7,6,26,23.1,28,67,41.8,16,22,72.7,14,19,33,17,21,26,17,8,3,6,77,Rawlplug Sokół Łańcut,Sezon 2019/2020
2019-09-28 18:00,Zetkama Doral Nysa Kłodzko(d),71 : 69W,71,15,26,57.7,10,31,32.3,25,57,43.9,11,18,61.1,9,20,29,18,19,18,12,7,7,1,81,STK Czarni Słupsk,Sezon 2019/2020
2019-10-05 16:00,Biofarm Basket Poznań(w),90 : 91W,91,24,44,54.5,4,25,16.0,28,69,40.6,31,42,73.8,17,26,43,15,26,31,13,9,2,3,95,STK Czarni Słupsk,Sezon 2019/2020
2019-10-12 18:00,KS Księżak Łowicz(d),81 : 78W,81,16,32,50.0,11,26,42.3,27,58,46.6,16,26,61.5,9,30,39,27,19,23,16,5,2,1,97,STK Czarni Słupsk,Sezon 2019/2020
2019-10-16 19:00,Energa Kotwica Kołobrzeg(w),58 : 80W,80,16,33,48.5,11,27,40.7,27,60,45.0,15,21,71.4,8,27,35,17,18,20,14,6,0,0,85,STK Czarni Słupsk,Sezon 2019/2020
2019-10-19 18:00,Pogoń Prudnik(d),76 : 74W,76,22,39,56.4,6,26,23.1,28,65,43.1,14,18,77.8,13,25,38,20,22,18,9,7,3,1,94,STK Czarni Słupsk,Sezon 2019/2020
2019-10-26 18:00,Miasto Szkła Krosno(w),74 : 72P,72,17,43,39.5,10,25,40.0,27,68,39.7,8,9,88.9,8,31,39,14,19,19,14,7,2,3,78,STK Czarni Słupsk,Sezon 2019/2020
2019-11-02 18:00,Weegree AZS Politechnika Opolska(d),89 : 77W,89,28,41,68.3,8,25,32.0,36,66,54.5,9,19,47.4,8,22,30,19,18,16,8,11,2,2,103,STK Czarni Słupsk,Sezon 2019/2020
2019-11-06 18:00,WKK Wrocław(w),95 : 89P,89,19,43,44.2,12,28,42.9,31,71,43.7,15,19,78.9,16,19,35,24,19,17,12,4,1,7,97,STK Czarni Słupsk,Sezon 2019/2020
2019-11-09 18:00,Rawlplug Sokół Łańcut(d),95 : 88W,95,21,32,65.6,13,33,39.4,34,65,52.3,14,18,77.8,14,24,38,25,20,19,11,4,2,0,118,STK Czarni Słupsk,Sezon 2019/2020
2019-11-16 19:00,GKS Tychy(w),84 : 91W,91,20,38,52.6,11,26,42.3,31,64,48.4,18,22,81.8,13,21,34,19,22,20,13,2,5,1,101,STK Czarni Słupsk,Sezon 2019/2020
2019-11-30 18:00,Elektrobud-Investment ZB Pruszków(d),84 : 68W,84,20,40,50.0,11,23,47.8,31,63,49.2,11,16,68.8,6,29,35,25,16,12,9,4,2,0,104,STK Czarni Słupsk,Sezon 2019/2020
2019-12-07 18:00,Timeout Polonia 1912 Leszno(d),90 : 84W,90,19,43,44.2,11,30,36.7,30,73,41.1,19,28,67.9,14,26,40,23,22,20,7,5,0,1,99,STK Czarni Słupsk,Sezon 2019/2020
2019-12-14 18:00,Górnik Trans.eu Wałbrzych(d),75 : 80P,75,24,42,57.1,6,29,20.7,30,71,42.3,9,11,81.8,9,33,42,14,18,19,7,2,5,5,88,STK Czarni Słupsk,Sezon 2019/2020
2020-01-04 17:00,Zetkama Doral Nysa Kłodzko(w),89 : 78P,78,16,35,45.7,7,27,25.9,23,62,37.1,25,34,73.5,12,20,32,12,30,24,10,4,2,0,70,STK Czarni Słupsk,Sezon 2019/2020
2020-01-11 18:00,Biofarm Basket Poznań(d),70 : 63W,70,14,36,38.9,9,27,33.3,23,63,36.5,15,20,75.0,10,31,41,15,25,19,16,7,0,0,72,STK Czarni Słupsk,Sezon 2019/2020
2020-01-18 18:00,KS Księżak Łowicz(w),88 : 85P,85,19,42,45.2,13,36,36.1,32,78,41.0,8,13,61.5,17,25,42,18,27,19,11,6,1,0,90,STK Czarni Słupsk,Sezon 2019/2020
2020-01-22 18:00,Energa Kotwica Kołobrzeg(d),92 : 66W,92,25,44,56.8,10,31,32.3,35,75,46.7,12,18,66.7,12,22,34,25,19,15,8,12,2,2,111,STK Czarni Słupsk,Sezon 2019/2020
2020-01-25 17:30,Pogoń Prudnik(w),72 : 89W,89,23,42,54.8,10,29,34.5,33,71,46.5,13,16,81.3,10,24,34,25,19,15,9,9,1,2,108,STK Czarni Słupsk,Sezon 2019/2020
2020-02-01 18:00,Miasto Szkła Krosno(d),93 : 74W,93,18,35,51.4,13,24,54.2,31,59,52.5,18,22,81.8,6,20,26,27,16,18,10,9,3,1,116,STK Czarni Słupsk,Sezon 2019/2020
2020-02-08 17:30,Weegree AZS Politechnika Opolska(w),111 : 105P,105,19,38,50.0,14,36,38.9,33,74,44.6,25,30,83.3,11,25,36,18,32,22,12,5,4,3,110,STK Czarni Słupsk,Sezon 2019/2020
2020-02-12 18:00,WKK Wrocław(d),76 : 81P,76,21,46,45.7,9,25,36.0,30,71,42.3,7,14,50.0,7,28,35,17,22,14,7,6,2,3,81,STK Czarni Słupsk,Sezon 2019/2020
2020-02-15 17:30,Rawlplug Sokół Łańcut(w),73 : 79W,79,14,35,40.0,13,29,44.8,27,64,42.2,12,14,85.7,8,25,33,16,18,17,11,2,4,2,84,STK Czarni Słupsk,Sezon 2019/2020
2020-02-22 18:00,GKS Tychy(d),85 : 64W,85,25,41,61.0,8,23,34.8,33,64,51.6,11,15,73.3,8,31,39,27,17,19,6,5,3,2,118,STK Czarni Słupsk,Sezon 2019/2020
2020-03-07 18:00,Elektrobud-Investment ZB Pruszków(w),82 : 76P,76,20,37,54.1,10,26,38.5,30,63,47.6,6,11,54.5,15,24,39,20,18,15,19,7,1,3,86,STK Czarni Słupsk,Sezon 2019/2020
2019-09-28 20:00,Górnik Trans.eu Wałbrzych(d),63 : 96P,63,16,38,42.1,7,28,25.0,23,66,34.8,10,20,50.0,12,22,34,15,22,22,11,5,0,2,53,Timeout Polonia 1912 Leszno,Sezon 2019/2020
2019-10-11 20:00,Zetkama Doral Nysa Kłodzko(d),79 : 64W,79,21,36,58.3,10,29,34.5,31,65,47.7,7,13,53.8,9,31,40,16,16,16,16,5,2,4,86,Timeout Polonia 1912 Leszno,Sezon 2019/2020
2019-10-16 19:00,Biofarm Basket Poznań(w),104 : 101P,101,13,30,43.3,20,40,50.0,33,70,47.1,15,25,60.0,6,30,36,25,22,21,11,4,2,5,110,Timeout Polonia 1912 Leszno,Sezon 2019/2020
2019-10-19 18:00,KS Księżak Łowicz(d),88 : 75W,88,21,38,55.3,11,26,42.3,32,64,50.0,13,21,61.9,9,29,38,12,19,25,16,8,3,1,93,Timeout Polonia 1912 Leszno,Sezon 2019/2020
2019-10-26 18:00,Energa Kotwica Kołobrzeg(w),89 : 76P,76,21,41,51.2,7,24,29.2,28,65,43.1,13,17,76.5,7,19,26,12,19,19,6,4,1,2,72,Timeout Polonia 1912 Leszno,Sezon 2019/2020
2019-11-02 18:00,Pogoń Prudnik(d),84 : 70W,84,22,43,51.2,10,21,47.6,32,64,50.0,10,23,43.5,8,26,34,18,22,21,9,7,1,3,90,Timeout Polonia 1912 Leszno,Sezon 2019/2020
2019-11-06 18:00,Miasto Szkła Krosno(w),78 : 71P,71,18,37,48.6,6,23,26.1,24,60,40.0,17,22,77.3,8,26,34,14,17,21,14,8,0,1,72,Timeout Polonia 1912 Leszno,Sezon 2019/2020
2019-11-10 18:00,Weegree AZS Politechnika Opolska(d),94 : 82W,94,26,49,53.1,9,20,45.0,35,69,50.7,15,22,68.2,10,30,40,20,20,22,12,7,2,0,110,Timeout Polonia 1912 Leszno,Sezon 2019/2020
2019-11-16 18:00,WKK Wrocław(d),83 : 92P,83,23,37,62.2,8,21,38.1,31,58,53.4,13,19,68.4,7,30,37,20,20,20,20,5,3,3,95,Timeout Polonia 1912 Leszno,Sezon 2019/2020
2019-11-23 17:30,Rawlplug Sokół Łańcut(w),87 : 89W,89,20,38,52.6,12,28,42.9,32,66,48.5,13,21,61.9,8,28,36,19,19,25,9,4,0,1,97,Timeout Polonia 1912 Leszno,Sezon 2019/2020
2019-11-30 18:00,GKS Tychy(w),92 : 82P,82,19,30,63.3,11,28,39.3,30,58,51.7,11,14,78.6,4,23,27,21,16,19,15,5,3,3,92,Timeout Polonia 1912 Leszno,Sezon 2019/2020
2019-12-07 18:00,STK Czarni Słupsk(w),90 : 84P,84,19,35,54.3,7,23,30.4,26,58,44.8,25,35,71.4,8,27,35,17,20,22,10,4,1,0,89,Timeout Polonia 1912 Leszno,Sezon 2019/2020
2019-12-14 18:00,Elektrobud-Investment ZB Pruszków(w),80 : 86W,86,21,39,53.8,8,21,38.1,29,60,48.3,20,31,64.5,13,29,42,16,15,23,18,8,1,2,93,Timeout Polonia 1912 Leszno,Sezon 2019/2020
2020-01-04 17:00,Górnik Trans.eu Wałbrzych(w),84 : 79P,79,20,39,51.3,8,23,34.8,28,62,45.2,15,27,55.6,13,24,37,14,23,28,14,7,1,5,78,Timeout Polonia 1912 Leszno,Sezon 2019/2020
2020-01-18 17:00,Zetkama Doral Nysa Kłodzko(w),97 : 93P,93,13,33,39.4,16,41,39.0,29,74,39.2,19,31,61.3,6,34,40,14,30,27,13,7,2,1,86,Timeout Polonia 1912 Leszno,Sezon 2019/2020
2020-01-22 20:00,Biofarm Basket Poznań(d),68 : 88P,68,13,40,32.5,7,25,28.0,20,65,30.8,21,35,60.0,12,25,37,12,25,29,15,5,0,6,48,Timeout Polonia 1912 Leszno,Sezon 2019/2020
2020-01-25 18:00,KS Księżak Łowicz(w),101 : 78P,78,19,42,45.2,9,22,40.9,28,64,43.8,13,19,68.4,4,24,28,12,25,18,10,2,1,1,69,Timeout Polonia 1912 Leszno,Sezon 2019/2020
2020-01-31 18:00,Energa Kotwica Kołobrzeg(d),94 : 79W,94,22,39,56.4,12,30,40.0,34,69,49.3,14,19,73.7,14,28,42,17,19,22,12,3,4,1,108,Timeout Polonia 1912 Leszno,Sezon 2019/2020
2020-02-08 17:30,Pogoń Prudnik(w),87 : 84P,84,20,42,47.6,7,23,30.4,27,65,41.5,23,27,85.2,11,20,31,18,17,22,8,8,0,1,91,Timeout Polonia 1912 Leszno,Sezon 2019/2020
2020-02-12 20:00,Miasto Szkła Krosno(d),79 : 71W,79,11,35,31.4,14,26,53.8,25,61,41.0,15,26,57.7,7,30,37,18,20,25,10,10,3,2,90,Timeout Polonia 1912 Leszno,Sezon 2019/2020
2020-02-15 17:30,Weegree AZS Politechnika Opolska(w),74 : 92W,92,23,40,57.5,9,24,37.5,32,64,50.0,19,26,73.1,7,24,31,29,17,22,9,8,2,1,114,Timeout Polonia 1912 Leszno,Sezon 2019/2020
2020-02-26 18:00,WKK Wrocław(w),66 : 87W,87,20,36,55.6,12,28,42.9,32,64,50.0,11,18,61.1,6,32,38,21,16,19,10,7,2,0,106,Timeout Polonia 1912 Leszno,Sezon 2019/2020
2020-02-29 18:00,Rawlplug Sokół Łańcut(d),70 : 80P,70,20,46,43.5,7,25,28.0,27,71,38.0,9,20,45.0,11,26,37,16,16,23,12,7,1,2,64,Timeout Polonia 1912 Leszno,Sezon 2019/2020
2020-03-07 19:00,GKS Tychy(d),72 : 89P,72,18,34,52.9,7,27,25.9,25,61,41.0,15,19,78.9,8,26,34,11,22,22,13,4,4,1,72,Timeout Polonia 1912 Leszno,Sezon 2019/2020
2019-09-29 17:00,Pogoń Prudnik(d),90 : 79W,90,20,36,55.6,5,26,19.2,25,62,40.3,35,39,89.7,4,30,34,13,23,31,5,5,1,3,97,Weegree AZS Politechnika Opolska,Sezon 2019/2020
2019-10-05 18:00,Miasto Szkła Krosno(w),78 : 80W,80,17,33,51.5,11,25,44.0,28,58,48.3,13,20,65.0,6,22,28,18,18,22,12,7,1,3,85,Weegree AZS Politechnika Opolska,Sezon 2019/2020
2019-10-16 18:00,WKK Wrocław(d),102 : 105P,102,22,45,48.9,12,25,48.0,34,70,48.6,22,24,91.7,8,17,25,21,23,21,11,8,1,2,108,Weegree AZS Politechnika Opolska,Sezon 2019/2020
2019-10-19 17:30,Rawlplug Sokół Łańcut(w),102 : 75P,75,18,35,51.4,9,18,50.0,27,53,50.9,12,18,66.7,7,23,30,13,14,25,22,3,1,1,68,Weegree AZS Politechnika Opolska,Sezon 2019/2020
2019-10-26 17:30,GKS Tychy(d),83 : 87P,83,27,41,65.9,4,14,28.6,31,55,56.4,17,24,70.8,5,16,21,20,19,20,20,11,5,1,89,Weegree AZS Politechnika Opolska,Sezon 2019/2020
2019-11-02 18:00,STK Czarni Słupsk(w),89 : 77P,77,17,34,50.0,9,23,39.1,26,57,45.6,16,18,88.9,7,19,26,13,16,18,16,2,2,2,71,Weegree AZS Politechnika Opolska,Sezon 2019/2020
2019-11-06 19:00,Elektrobud-Investment ZB Pruszków(d),75 : 77P,75,18,37,48.6,7,24,29.2,25,61,41.0,18,21,85.7,9,26,35,13,19,18,13,7,3,2,81,Weegree AZS Politechnika Opolska,Sezon 2019/2020
2019-11-10 18:00,Timeout Polonia 1912 Leszno(w),94 : 82P,82,19,46,41.3,8,19,42.1,27,65,41.5,20,27,74.1,11,24,35,11,22,20,13,7,0,2,77,Weegree AZS Politechnika Opolska,Sezon 2019/2020
2019-11-17 17:30,Górnik Trans.eu Wałbrzych(d),75 : 89P,75,17,42,40.5,7,20,35.0,24,62,38.7,20,23,87.0,8,19,27,18,20,25,12,10,0,1,77,Weegree AZS Politechnika Opolska,Sezon 2019/2020
2019-11-30 18:00,Zetkama Doral Nysa Kłodzko(d),89 : 65W,89,25,43,58.1,7,18,38.9,32,61,52.5,18,24,75.0,8,24,32,23,17,19,11,11,1,5,110,Weegree AZS Politechnika Opolska,Sezon 2019/2020
2019-12-07 18:00,Biofarm Basket Poznań(w),82 : 72P,72,12,38,31.6,6,21,28.6,18,59,30.5,30,34,88.2,10,29,39,16,25,26,13,4,0,2,73,Weegree AZS Politechnika Opolska,Sezon 2019/2020
2019-12-15 17:30,KS Księżak Łowicz(d),80 : 117P,80,19,43,44.2,7,26,26.9,26,69,37.7,21,24,87.5,9,19,28,11,24,20,12,4,3,1,68,Weegree AZS Politechnika Opolska,Sezon 2019/2020
2019-12-21 18:00,Energa Kotwica Kołobrzeg(w),75 : 89W,89,28,44,63.6,7,21,33.3,35,65,53.8,12,27,44.4,8,26,34,19,24,22,12,7,5,3,97,Weegree AZS Politechnika Opolska,Sezon 2019/2020
2020-01-04 17:30,Pogoń Prudnik(w),96 : 68P,68,19,40,47.5,3,19,15.8,22,59,37.3,21,23,91.3,10,19,29,15,24,20,18,1,0,4,56,Weegree AZS Politechnika Opolska,Sezon 2019/2020
2020-01-12 17:00,Miasto Szkła Krosno(d),104 : 101W,104,31,51,60.8,6,19,31.6,37,70,52.9,24,33,72.7,12,19,31,22,24,26,12,7,2,3,112,Weegree AZS Politechnika Opolska,Sezon 2019/2020
2020-01-22 18:00,WKK Wrocław(w),92 : 90P,90,21,36,58.3,10,31,32.3,31,67,46.3,18,21,85.7,6,28,34,32,21,21,11,6,1,4,113,Weegree AZS Politechnika Opolska,Sezon 2019/2020
2020-01-25 17:30,Rawlplug Sokół Łańcut(d),94 : 78W,94,25,44,56.8,10,23,43.5,35,67,52.2,14,18,77.8,13,25,38,21,18,20,11,6,3,1,115,Weegree AZS Politechnika Opolska,Sezon 2019/2020
2020-02-01 18:00,GKS Tychy(w),88 : 84P,84,21,34,61.8,8,34,23.5,29,68,42.6,18,21,85.7,13,22,35,13,27,26,12,4,2,2,84,Weegree AZS Politechnika Opolska,Sezon 2019/2020
2020-02-08 17:30,STK Czarni Słupsk(d),111 : 105W,111,25,40,62.5,10,25,40.0,35,65,53.8,31,38,81.6,7,25,32,33,23,31,8,6,3,4,140,Weegree AZS Politechnika Opolska,Sezon 2019/2020
2020-02-12 19:00,Elektrobud-Investment ZB Pruszków(w),86 : 82P,82,20,48,41.7,9,28,32.1,29,76,38.2,15,24,62.5,14,32,46,20,17,21,15,10,3,7,90,Weegree AZS Politechnika Opolska,Sezon 2019/2020
2020-02-15 17:30,Timeout Polonia 1912 Leszno(d),74 : 92P,74,24,45,53.3,5,22,22.7,29,67,43.3,11,12,91.7,8,22,30,18,22,17,14,5,1,2,75,Weegree AZS Politechnika Opolska,Sezon 2019/2020
2020-02-22 17:00,Górnik Trans.eu Wałbrzych(w),89 : 83P,83,13,37,35.1,10,31,32.3,23,68,33.8,27,33,81.8,17,23,40,20,25,28,19,11,2,5,86,Weegree AZS Politechnika Opolska,Sezon 2019/2020
2020-03-07 17:00,Zetkama Doral Nysa Kłodzko(w),100 : 99P,99,20,36,55.6,10,28,35.7,30,64,46.9,29,36,80.6,6,27,33,13,22,24,12,8,4,2,104,Weegree AZS Politechnika Opolska,Sezon 2019/2020
2019-09-27 18:00,Energa Kotwica Kołobrzeg(d),102 : 82W,102,24,35,68.6,16,34,47.1,40,69,58.0,6,10,60.0,5,28,33,29,22,17,16,4,7,2,126,WKK Wrocław,Sezon 2019/2020
2019-10-05 17:30,Pogoń Prudnik(w),91 : 85P,85,24,41,58.5,8,26,30.8,32,67,47.8,13,17,76.5,6,27,33,18,18,19,9,6,4,2,98,WKK Wrocław,Sezon 2019/2020
2019-10-12 18:00,Miasto Szkła Krosno(d),64 : 65P,64,17,30,56.7,6,29,20.7,23,59,39.0,12,21,57.1,10,20,30,11,21,22,10,11,4,2,65,WKK Wrocław,Sezon 2019/2020
2019-10-16 18:00,Weegree AZS Politechnika Opolska(w),102 : 105W,105,29,41,70.7,7,21,33.3,36,62,58.1,26,34,76.5,11,25,36,20,22,23,15,4,2,1,118,WKK Wrocław,Sezon 2019/2020
2019-10-26 18:00,Rawlplug Sokół Łańcut(d),78 : 84P,78,17,34,50.0,10,27,37.0,27,61,44.3,14,16,87.5,5,28,33,24,19,19,21,8,7,3,93,WKK Wrocław,Sezon 2019/2020
2019-11-02 18:00,GKS Tychy(d),92 : 61W,92,20,35,57.1,9,29,31.0,29,64,45.3,25,31,80.6,7,29,36,25,20,26,9,13,2,3,118,WKK Wrocław,Sezon 2019/2020
2019-11-06 18:00,STK Czarni Słupsk(d),95 : 89W,95,31,39,79.5,6,24,25.0,37,63,58.7,15,20,75.0,5,22,27,25,17,19,8,5,7,1,120,WKK Wrocław,Sezon 2019/2020
2019-11-09 18:00,Elektrobud-Investment ZB Pruszków(w),79 : 90W,90,28,45,62.2,6,13,46.2,34,58,58.6,16,23,69.6,8,28,36,28,25,21,17,9,3,0,118,WKK Wrocław,Sezon 2019/2020
2019-11-16 18:00,Timeout Polonia 1912 Leszno(w),83 : 92W,92,24,43,55.8,10,23,43.5,34,66,51.5,14,20,70.0,4,21,25,18,21,20,5,11,3,3,106,WKK Wrocław,Sezon 2019/2020
2019-11-24 16:00,Górnik Trans.eu Wałbrzych(w),80 : 82W,82,21,48,43.8,7,19,36.8,28,67,41.8,19,24,79.2,11,24,35,12,19,21,10,6,5,4,86,WKK Wrocław,Sezon 2019/2020
2019-12-07 17:00,Zetkama Doral Nysa Kłodzko(w),70 : 86W,86,23,43,53.5,5,21,23.8,28,64,43.8,25,31,80.6,4,32,36,15,17,24,10,6,9,1,100,WKK Wrocław,Sezon 2019/2020
2019-12-14 18:00,Biofarm Basket Poznań(d),74 : 61W,74,19,42,45.2,8,23,34.8,27,65,41.5,12,14,85.7,10,33,43,18,19,18,11,5,6,7,95,WKK Wrocław,Sezon 2019/2020
2019-12-21 17:00,KS Księżak Łowicz(w),111 : 107P,107,33,47,70.2,4,24,16.7,37,71,52.1,29,39,74.4,9,28,37,13,22,28,12,4,3,0,108,WKK Wrocław,Sezon 2019/2020
2020-01-06 17:00,Energa Kotwica Kołobrzeg(w),92 : 96W,96,30,49,61.2,6,25,24.0,36,74,48.6,18,24,75.0,13,16,29,12,13,21,9,6,3,3,93,WKK Wrocław,Sezon 2019/2020
2020-01-12 18:00,Pogoń Prudnik(d),96 : 79W,96,25,38,65.8,10,26,38.5,35,64,54.7,16,20,80.0,8,19,27,28,12,18,10,8,6,0,122,WKK Wrocław,Sezon 2019/2020
2020-01-18 18:00,Miasto Szkła Krosno(w),67 : 70W,70,14,27,51.9,9,24,37.5,23,51,45.1,15,26,57.7,3,28,31,18,11,22,15,8,3,1,76,WKK Wrocław,Sezon 2019/2020
2020-01-22 18:00,Weegree AZS Politechnika Opolska(d),92 : 90W,92,22,38,57.9,11,28,39.3,33,66,50.0,15,18,83.3,7,21,28,31,21,21,10,8,4,1,117,WKK Wrocław,Sezon 2019/2020
2020-02-05 18:00,Rawlplug Sokół Łańcut(w),79 : 88W,88,20,41,48.8,8,19,42.1,28,60,46.7,24,30,80.0,9,38,47,14,19,23,15,5,7,3,108,WKK Wrocław,Sezon 2019/2020
2020-02-08 18:00,GKS Tychy(w),92 : 101W,101,19,39,48.7,16,33,48.5,35,72,48.6,15,18,83.3,9,19,28,20,20,23,8,9,4,4,114,WKK Wrocław,Sezon 2019/2020
2020-02-12 18:00,STK Czarni Słupsk(w),76 : 81W,81,20,43,46.5,8,19,42.1,28,62,45.2,17,26,65.4,8,34,42,23,15,22,13,3,3,2,96,WKK Wrocław,Sezon 2019/2020
2020-02-19 18:00,Elektrobud-Investment ZB Pruszków(d),76 : 79P,76,24,44,54.5,2,14,14.3,26,58,44.8,22,28,78.6,7,25,32,15,19,23,14,5,2,1,78,WKK Wrocław,Sezon 2019/2020
2020-02-26 18:00,Timeout Polonia 1912 Leszno(d),66 : 87P,66,14,42,33.3,10,28,35.7,24,70,34.3,8,10,80.0,10,24,34,13,19,16,10,6,0,2,61,WKK Wrocław,Sezon 2019/2020
2020-03-01 18:00,Górnik Trans.eu Wałbrzych(d),65 : 78P,65,16,41,39.0,4,21,19.0,20,62,32.3,21,31,67.7,9,30,39,15,18,25,14,8,2,2,63,WKK Wrocław,Sezon 2019/2020
2019-09-28 18:00,STK Czarni Słupsk(w),71 : 69P,69,23,45,51.1,5,24,20.8,28,69,40.6,8,11,72.7,9,24,33,19,18,19,12,6,1,7,72,Zetkama Doral Nysa Kłodzko,Sezon 2019/2020
2019-10-05 17:00,Elektrobud-Investment ZB Pruszków(d),89 : 87W,89,19,37,51.4,12,17,70.6,31,54,57.4,15,19,78.9,4,20,24,23,23,23,9,3,3,3,106,Zetkama Doral Nysa Kłodzko,Sezon 2019/2020
2019-10-11 20:00,Timeout Polonia 1912 Leszno(w),79 : 64P,64,20,46,43.5,6,23,26.1,26,69,37.7,6,8,75.0,10,25,35,8,16,15,14,7,4,2,59,Zetkama Doral Nysa Kłodzko,Sezon 2019/2020
2019-10-16 19:30,Górnik Trans.eu Wałbrzych(d),66 : 81P,66,16,38,42.1,8,25,32.0,24,63,38.1,10,23,43.5,13,25,38,17,15,21,16,6,2,6,61,Zetkama Doral Nysa Kłodzko,Sezon 2019/2020
2019-11-02 17:00,Biofarm Basket Poznań(d),94 : 85W,94,24,43,55.8,7,23,30.4,31,66,47.0,25,34,73.5,10,25,35,16,22,25,11,6,1,3,97,Zetkama Doral Nysa Kłodzko,Sezon 2019/2020
2019-11-06 18:30,KS Księżak Łowicz(w),100 : 93P,93,32,55,58.2,8,21,38.1,40,76,52.6,5,9,55.6,12,18,30,17,25,17,16,11,1,3,96,Zetkama Doral Nysa Kłodzko,Sezon 2019/2020
2019-11-09 17:00,Energa Kotwica Kołobrzeg(d),81 : 67W,81,18,38,47.4,9,18,50.0,27,56,48.2,18,25,72.0,9,22,31,20,18,22,12,14,2,0,100,Zetkama Doral Nysa Kłodzko,Sezon 2019/2020
2019-11-16 17:30,Pogoń Prudnik(w),88 : 72P,72,19,38,50.0,6,20,30.0,25,58,43.1,16,26,61.5,7,26,33,17,20,26,13,5,1,1,72,Zetkama Doral Nysa Kłodzko,Sezon 2019/2020
2019-11-23 17:00,Miasto Szkła Krosno(d),82 : 79W,82,24,42,57.1,7,23,30.4,31,65,47.7,13,18,72.2,10,21,31,20,17,19,10,15,0,1,99,Zetkama Doral Nysa Kłodzko,Sezon 2019/2020
2019-11-30 18:00,Weegree AZS Politechnika Opolska(w),89 : 65P,65,24,40,60.0,2,18,11.1,26,58,44.8,11,18,61.1,7,18,25,15,20,16,17,6,5,1,60,Zetkama Doral Nysa Kłodzko,Sezon 2019/2020
2019-12-07 17:00,WKK Wrocław(d),70 : 86P,70,15,36,41.7,9,29,31.0,24,65,36.9,13,17,76.5,6,28,34,21,25,17,11,5,1,9,75,Zetkama Doral Nysa Kłodzko,Sezon 2019/2020
2019-12-14 17:30,Rawlplug Sokół Łańcut(w),93 : 69P,69,16,31,51.6,9,23,39.1,25,54,46.3,10,15,66.7,5,18,23,21,27,20,17,2,1,2,65,Zetkama Doral Nysa Kłodzko,Sezon 2019/2020
2019-12-21 17:00,GKS Tychy(d),68 : 63W,68,13,35,37.1,9,24,37.5,22,59,37.3,15,19,78.9,6,20,26,17,20,25,11,7,3,0,69,Zetkama Doral Nysa Kłodzko,Sezon 2019/2020
2020-01-04 17:00,STK Czarni Słupsk(d),89 : 78W,89,27,49,55.1,2,8,25.0,29,57,50.9,29,39,74.4,4,27,31,16,24,30,9,4,0,2,93,Zetkama Doral Nysa Kłodzko,Sezon 2019/2020
2020-01-11 18:00,Elektrobud-Investment ZB Pruszków(w),88 : 73P,73,19,48,39.6,6,12,50.0,25,60,41.7,17,25,68.0,12,22,34,14,22,25,21,3,2,4,62,Zetkama Doral Nysa Kłodzko,Sezon 2019/2020
2020-01-18 17:00,Timeout Polonia 1912 Leszno(d),97 : 93W,97,18,49,36.7,12,26,46.2,30,75,40.0,25,35,71.4,11,37,48,18,28,30,14,5,1,2,100,Zetkama Doral Nysa Kłodzko,Sezon 2019/2020
2020-01-22 18:00,Górnik Trans.eu Wałbrzych(w),90 : 86P,86,19,41,46.3,8,21,38.1,27,62,43.5,24,34,70.6,8,26,34,23,26,27,11,9,2,5,98,Zetkama Doral Nysa Kłodzko,Sezon 2019/2020
2020-02-09 17:00,Biofarm Basket Poznań(w),81 : 74P,74,18,42,42.9,8,17,47.1,26,59,44.1,14,24,58.3,11,28,39,18,20,23,13,3,2,3,80,Zetkama Doral Nysa Kłodzko,Sezon 2019/2020
2020-02-12 19:30,KS Księżak Łowicz(d),91 : 93P,91,28,50,56.0,7,23,30.4,35,73,47.9,14,22,63.6,14,23,37,21,17,23,10,8,5,2,106,Zetkama Doral Nysa Kłodzko,Sezon 2019/2020
2020-02-15 18:00,Energa Kotwica Kołobrzeg(w),72 : 67P,67,23,51,45.1,5,19,26.3,28,70,40.0,6,10,60.0,12,29,41,15,25,18,13,6,3,4,73,Zetkama Doral Nysa Kłodzko,Sezon 2019/2020
2020-02-22 17:00,Pogoń Prudnik(d),71 : 74P,71,20,38,52.6,5,17,29.4,25,55,45.5,16,22,72.7,5,25,30,16,21,24,10,2,2,1,75,Zetkama Doral Nysa Kłodzko,Sezon 2019/2020
2020-02-29 18:00,Miasto Szkła Krosno(w),95 : 58P,58,17,39,43.6,5,27,18.5,22,66,33.3,9,14,64.3,10,21,31,12,25,18,16,7,1,1,44,Zetkama Doral Nysa Kłodzko,Sezon 2019/2020
2020-03-07 17:00,Weegree AZS Politechnika Opolska(d),100 : 99W,100,24,46,52.2,13,31,41.9,37,77,48.1,13,20,65.0,15,30,45,22,25,20,13,6,2,4,115,Zetkama Doral Nysa Kłodzko,Sezon 2019/2020
2018-09-29 16:00,STK Czarni Słupsk(d),66 : 87P,66,15,39,38.5,8,35,22.9,23,74,31.1,12,16,75.0,17,17,34,17,16,20,14,15,2,2,65,AZS AGH Kraków,Sezon 2018/2019
2018-10-06 17:00,Enea Astoria Bydgoszcz(w),76 : 85W,85,29,45,64.4,3,20,15.0,32,65,49.2,18,32,56.3,14,25,39,22,22,28,14,9,1,3,95,AZS AGH Kraków,Sezon 2018/2019
2018-10-13 18:00,WKK Wrocław(d),93 : 74W,93,24,44,54.5,11,24,45.8,35,68,51.5,12,19,63.2,8,23,31,31,26,21,15,12,5,5,117,AZS AGH Kraków,Sezon 2018/2019
2018-10-17 18:00,Rawlplug Sokół Łańcut(w),75 : 66P,66,20,48,41.7,8,24,33.3,28,72,38.9,2,7,28.6,10,27,37,18,23,16,14,8,1,4,67,AZS AGH Kraków,Sezon 2018/2019
2018-10-20 19:30,Polfarmex Kutno(d),75 : 86P,75,23,42,54.8,4,17,23.5,27,59,45.8,17,30,56.7,13,22,35,20,23,26,18,6,2,1,75,AZS AGH Kraków,Sezon 2018/2019
2018-10-27 18:00,Elektrobud-Investment ZB Pruszków(w),73 : 71P,71,19,44,43.2,5,10,50.0,24,54,44.4,18,23,78.3,11,23,34,19,21,17,19,10,2,1,82,AZS AGH Kraków,Sezon 2018/2019
2018-11-04 19:00,FutureNet Śląsk Wrocław(d),97 : 88W,97,21,44,47.7,9,19,47.4,30,63,47.6,28,47,59.6,13,25,38,17,27,32,16,4,3,2,91,AZS AGH Kraków,Sezon 2018/2019
2018-11-07 19:00,GKS Tychy(w),112 : 102P,102,22,43,51.2,13,33,39.4,35,76,46.1,19,31,61.3,11,21,32,22,23,28,12,4,0,2,95,AZS AGH Kraków,Sezon 2018/2019
2018-11-10 18:00,SKK Siedlce(d),94 : 72W,94,24,39,61.5,11,37,29.7,35,76,46.1,13,15,86.7,14,25,39,34,13,19,11,10,2,6,125,AZS AGH Kraków,Sezon 2018/2019
2018-11-17 18:30,KS Księżak Syntex Łowicz(w),94 : 89P,89,26,47,55.3,8,24,33.3,34,71,47.9,13,19,68.4,13,23,36,21,20,23,8,5,1,0,101,AZS AGH Kraków,Sezon 2018/2019
2018-11-24 18:30,Jamalex Polonia 1912 Leszno(d),95 : 75W,95,26,45,57.8,9,21,42.9,35,66,53.0,16,25,64.0,11,29,40,27,30,21,16,8,2,2,116,AZS AGH Kraków,Sezon 2018/2019
2018-12-02 20:00,Górnik Trans.eu Wałbrzych(d),68 : 73P,68,14,34,41.2,7,25,28.0,21,59,35.6,19,31,61.3,5,24,29,19,27,20,11,3,2,3,60,AZS AGH Kraków,Sezon 2018/2019
2018-12-08 17:00,Biofarm Basket Poznań(w),77 : 67P,67,15,45,33.3,8,23,34.8,23,68,33.8,13,23,56.5,12,25,37,15,28,23,16,8,0,9,56,AZS AGH Kraków,Sezon 2018/2019
2018-12-15 19:30,Energa Kotwica Kołobrzeg(d),79 : 70W,79,13,39,33.3,9,29,31.0,22,68,32.4,26,33,78.8,16,21,37,13,22,29,14,6,3,4,71,AZS AGH Kraków,Sezon 2018/2019
2018-12-22 17:30,Pogoń Prudnik(w),102 : 81P,81,21,35,60.0,8,29,27.6,29,64,45.3,15,21,71.4,11,17,28,17,28,21,20,7,1,0,73,AZS AGH Kraków,Sezon 2018/2019
2019-01-05 17:00,STK Czarni Słupsk(w),85 : 73P,73,21,38,55.3,6,27,22.2,27,65,41.5,13,23,56.5,10,28,38,14,23,18,17,5,0,5,65,AZS AGH Kraków,Sezon 2018/2019
2019-01-13 18:30,Enea Astoria Bydgoszcz(d),64 : 84P,64,12,33,36.4,8,28,28.6,20,61,32.8,16,24,66.7,11,25,36,20,28,22,18,5,5,3,63,AZS AGH Kraków,Sezon 2018/2019
2019-01-19 18:00,WKK Wrocław(w),84 : 81P,81,19,42,45.2,11,24,45.8,30,66,45.5,10,14,71.4,5,25,30,23,24,14,23,12,1,1,84,AZS AGH Kraków,Sezon 2018/2019
2019-01-23 18:00,Rawlplug Sokół Łańcut(d),78 : 82P,78,23,43,53.5,5,30,16.7,28,73,38.4,17,20,85.0,14,27,41,22,28,19,17,9,5,3,90,AZS AGH Kraków,Sezon 2018/2019
2019-01-30 18:00,Polfarmex Kutno(w),80 : 66P,66,21,44,47.7,4,21,19.0,25,65,38.5,12,27,44.4,13,23,36,14,22,24,14,8,4,9,59,AZS AGH Kraków,Sezon 2018/2019
2019-02-02 16:00,Elektrobud-Investment ZB Pruszków(d),64 : 75P,64,15,33,45.5,7,22,31.8,22,55,40.0,13,22,59.1,9,21,30,13,18,22,16,10,4,2,63,AZS AGH Kraków,Sezon 2018/2019
2019-02-13 18:00,GKS Tychy(d),76 : 90P,76,12,21,57.1,11,29,37.9,23,50,46.0,19,24,79.2,5,25,30,21,21,23,18,5,3,1,85,AZS AGH Kraków,Sezon 2018/2019
2019-02-17 17:00,SKK Siedlce(w),73 : 85W,85,15,32,46.9,10,29,34.5,25,61,41.0,25,33,75.8,6,16,22,15,20,29,13,15,1,0,81,AZS AGH Kraków,Sezon 2018/2019
2019-02-23 19:30,KS Księżak Syntex Łowicz(d),84 : 81W,84,21,38,55.3,10,30,33.3,31,68,45.6,12,14,85.7,10,17,27,23,22,20,8,8,6,2,101,AZS AGH Kraków,Sezon 2018/2019
2019-03-06 18:30,FutureNet Śląsk Wrocław(w),72 : 52P,52,15,39,38.5,6,24,25.0,21,63,33.3,4,10,40.0,8,24,32,6,22,17,20,5,1,4,28,AZS AGH Kraków,Sezon 2018/2019
2019-03-09 16:00,Górnik Trans.eu Wałbrzych(w),91 : 56P,56,10,32,31.3,6,33,18.2,16,65,24.6,18,26,69.2,8,15,23,4,23,24,10,8,0,5,24,AZS AGH Kraków,Sezon 2018/2019
2019-03-13 20:00,Jamalex Polonia 1912 Leszno(w),94 : 55P,55,11,27,40.7,6,24,25.0,17,51,33.3,15,24,62.5,8,22,30,8,26,19,20,5,3,1,38,AZS AGH Kraków,Sezon 2018/2019
2019-03-16 18:00,Biofarm Basket Poznań(d),83 : 73W,83,20,38,52.6,8,21,38.1,28,59,47.5,19,27,70.4,5,25,30,14,24,25,17,14,2,6,87,AZS AGH Kraków,Sezon 2018/2019
2019-03-23 18:00,Energa Kotwica Kołobrzeg(w),88 : 71P,71,9,18,50.0,13,40,32.5,22,58,37.9,14,25,56.0,13,22,35,13,21,22,22,6,3,4,59,AZS AGH Kraków,Sezon 2018/2019
2019-03-31 18:00,Pogoń Prudnik(d),76 : 65W,76,19,39,48.7,10,30,33.3,29,69,42.0,8,11,72.7,7,26,33,25,22,19,12,12,2,1,93,AZS AGH Kraków,Sezon 2018/2019
2019-04-06 17:30,Polfarmex Kutno(w),86 : 74P,74,19,35,54.3,9,26,34.6,28,61,45.9,9,13,69.2,9,17,26,14,20,19,18,10,3,0,72,AZS AGH Kraków,Sezon 2018/2019
2019-04-07 17:30,Polfarmex Kutno(w),105 : 69P,69,19,45,42.2,5,21,23.8,24,66,36.4,16,25,64.0,7,19,26,13,29,21,17,8,2,10,50,AZS AGH Kraków,Sezon 2018/2019
2019-04-13 18:00,Polfarmex Kutno(d),86 : 82W,86,23,46,50.0,4,18,22.2,27,64,42.2,28,35,80.0,9,21,30,13,24,33,9,10,2,6,88,AZS AGH Kraków,Sezon 2018/2019
2019-04-14 18:00,Polfarmex Kutno(d),68 : 75P,68,14,39,35.9,9,28,32.1,23,67,34.3,13,21,61.9,13,24,37,14,27,20,14,5,2,5,60,AZS AGH Kraków,Sezon 2018/2019
2018-09-29 17:00,Energa Kotwica Kołobrzeg(d),83 : 82W,83,23,44,52.3,8,23,34.8,31,67,46.3,13,25,52.0,11,25,36,18,18,22,12,4,3,0,84,Biofarm Basket Poznań,Sezon 2018/2019
2018-10-06 17:30,Pogoń Prudnik(w),92 : 80P,80,25,45,55.6,5,21,23.8,30,66,45.5,15,24,62.5,10,25,35,14,20,24,20,8,4,1,76,Biofarm Basket Poznań,Sezon 2018/2019
2018-10-13 17:00,STK Czarni Słupsk(d),76 : 71W,76,20,47,42.6,9,23,39.1,29,70,41.4,9,19,47.4,12,29,41,24,14,17,6,10,6,4,100,Biofarm Basket Poznań,Sezon 2018/2019
2018-10-17 19:00,Enea Astoria Bydgoszcz(w),93 : 62P,62,13,43,30.2,11,28,39.3,24,71,33.8,3,13,23.1,13,19,32,17,17,17,14,6,3,5,49,Biofarm Basket Poznań,Sezon 2018/2019
2018-10-20 17:00,WKK Wrocław(d),62 : 72P,62,18,35,51.4,8,24,33.3,26,59,44.1,2,3,66.7,6,27,33,15,18,14,17,7,1,2,67,Biofarm Basket Poznań,Sezon 2018/2019
2018-10-28 17:30,Rawlplug Sokół Łańcut(w),89 : 88P,88,25,44,56.8,9,23,39.1,34,67,50.7,11,13,84.6,11,25,36,21,17,14,13,5,5,2,107,Biofarm Basket Poznań,Sezon 2018/2019
2018-11-03 17:00,Polfarmex Kutno(d),70 : 73P,70,19,37,51.4,3,19,15.8,22,56,39.3,23,30,76.7,12,24,36,14,18,22,8,2,4,0,77,Biofarm Basket Poznań,Sezon 2018/2019
2018-11-07 19:00,Elektrobud-Investment ZB Pruszków(w),67 : 61P,61,15,39,38.5,8,23,34.8,23,62,37.1,7,10,70.0,9,27,36,16,19,12,11,10,3,2,73,Biofarm Basket Poznań,Sezon 2018/2019
2018-11-10 17:00,FutureNet Śląsk Wrocław(d),70 : 79P,70,18,46,39.1,8,26,30.8,26,72,36.1,10,20,50.0,15,32,47,11,19,14,7,0,2,3,67,Biofarm Basket Poznań,Sezon 2018/2019
2018-11-17 19:00,GKS Tychy(w),94 : 83P,83,17,34,50.0,13,26,50.0,30,60,50.0,10,14,71.4,5,22,27,19,21,19,17,7,4,1,89,Biofarm Basket Poznań,Sezon 2018/2019
2018-11-24 17:00,SKK Siedlce(d),96 : 57W,96,21,36,58.3,11,35,31.4,32,71,45.1,21,30,70.0,13,33,46,21,16,24,6,12,5,0,126,Biofarm Basket Poznań,Sezon 2018/2019
2018-12-01 18:30,KS Księżak Syntex Łowicz(w),85 : 82P,82,17,33,51.5,11,30,36.7,28,63,44.4,15,18,83.3,8,21,29,21,26,21,14,10,1,1,91,Biofarm Basket Poznań,Sezon 2018/2019
2018-12-08 17:00,AZS AGH Kraków(d),77 : 67W,77,22,47,46.8,2,19,10.5,24,66,36.4,27,33,81.8,12,31,43,16,23,28,13,11,9,0,95,Biofarm Basket Poznań,Sezon 2018/2019
2018-12-15 16:00,Górnik Trans.eu Wałbrzych(w),70 : 72W,72,15,35,42.9,11,29,37.9,26,64,40.6,9,15,60.0,8,17,25,16,22,21,11,9,4,4,71,Biofarm Basket Poznań,Sezon 2018/2019
2018-12-22 17:00,Jamalex Polonia 1912 Leszno(d),78 : 65W,78,21,43,48.8,7,26,26.9,28,69,40.6,15,20,75.0,13,28,41,16,13,19,10,8,6,2,93,Biofarm Basket Poznań,Sezon 2018/2019
2019-01-06 17:00,Energa Kotwica Kołobrzeg(w),71 : 86W,86,18,36,50.0,9,27,33.3,27,63,42.9,23,27,85.2,8,29,37,12,20,21,10,5,4,1,94,Biofarm Basket Poznań,Sezon 2018/2019
2019-01-12 17:00,Pogoń Prudnik(d),93 : 86W,93,29,49,59.2,4,27,14.8,33,76,43.4,23,30,76.7,16,32,48,18,22,22,8,7,2,2,110,Biofarm Basket Poznań,Sezon 2018/2019
2019-01-19 18:00,STK Czarni Słupsk(w),87 : 71P,71,21,42,50.0,5,25,20.0,26,67,38.8,14,22,63.6,14,19,33,14,23,21,13,7,1,2,64,Biofarm Basket Poznań,Sezon 2018/2019
2019-01-23 19:00,Enea Astoria Bydgoszcz(d),91 : 84W,91,24,44,54.5,8,26,30.8,32,70,45.7,19,26,73.1,10,20,30,20,19,21,7,8,5,4,102,Biofarm Basket Poznań,Sezon 2018/2019
2019-01-27 17:00,WKK Wrocław(w),93 : 85P,85,18,41,43.9,9,34,26.5,27,75,36.0,22,27,81.5,10,21,31,21,16,18,5,9,1,2,89,Biofarm Basket Poznań,Sezon 2018/2019
2019-02-02 17:00,Rawlplug Sokół Łańcut(d),84 : 78W,84,24,42,57.1,6,19,31.6,30,61,49.2,18,27,66.7,9,30,39,22,24,23,12,8,3,2,104,Biofarm Basket Poznań,Sezon 2018/2019
2019-02-09 17:30,Polfarmex Kutno(w),63 : 64W,64,18,40,45.0,4,20,20.0,22,60,36.7,16,24,66.7,6,27,33,12,14,18,9,11,3,3,68,Biofarm Basket Poznań,Sezon 2018/2019
2019-02-13 18:00,Elektrobud-Investment ZB Pruszków(d),45 : 79P,45,12,26,46.2,5,24,20.8,17,50,34.0,6,9,66.7,7,27,34,13,18,14,24,5,1,1,38,Biofarm Basket Poznań,Sezon 2018/2019
2019-02-17 19:00,FutureNet Śląsk Wrocław(w),86 : 70P,70,24,47,51.1,4,23,17.4,28,70,40.0,10,17,58.8,4,27,31,11,22,21,12,7,5,3,63,Biofarm Basket Poznań,Sezon 2018/2019
2019-02-23 15:30,GKS Tychy(d),82 : 75W,82,16,29,55.2,7,24,29.2,23,53,43.4,29,35,82.9,10,29,39,20,25,24,13,6,4,0,102,Biofarm Basket Poznań,Sezon 2018/2019
2019-03-03 16:00,SKK Siedlce(w),83 : 90W,90,23,46,50.0,7,24,29.2,30,70,42.9,23,31,74.2,13,26,39,19,22,30,7,8,3,2,104,Biofarm Basket Poznań,Sezon 2018/2019
2019-03-09 17:00,KS Księżak Syntex Łowicz(d),81 : 74W,81,17,40,42.5,6,22,27.3,23,62,37.1,29,37,78.4,16,32,48,18,19,24,10,8,7,2,105,Biofarm Basket Poznań,Sezon 2018/2019
2019-03-16 18:00,AZS AGH Kraków(w),83 : 73P,73,20,42,47.6,7,30,23.3,27,72,37.5,12,21,57.1,15,28,43,10,25,23,21,12,6,2,69,Biofarm Basket Poznań,Sezon 2018/2019
2019-03-23 16:30,Górnik Trans.eu Wałbrzych(d),79 : 55W,79,16,42,38.1,11,29,37.9,27,71,38.0,14,21,66.7,12,29,41,20,18,21,8,12,6,7,99,Biofarm Basket Poznań,Sezon 2018/2019
2019-03-31 18:00,Jamalex Polonia 1912 Leszno(w),86 : 96W,96,26,41,63.4,8,24,33.3,34,65,52.3,20,21,95.2,10,29,39,16,22,23,18,11,1,1,113,Biofarm Basket Poznań,Sezon 2018/2019
2019-04-06 17:00,Enea Astoria Bydgoszcz(w),89 : 80P,80,23,37,62.2,6,27,22.2,29,64,45.3,16,23,69.6,12,24,36,16,16,21,17,7,3,2,83,Biofarm Basket Poznań,Sezon 2018/2019
2019-04-07 17:00,Enea Astoria Bydgoszcz(w),87 : 75P,75,22,37,59.5,8,27,29.6,30,64,46.9,7,9,77.8,5,22,27,17,21,17,20,7,0,4,70,Biofarm Basket Poznań,Sezon 2018/2019
2019-04-13 16:00,Enea Astoria Bydgoszcz(d),71 : 80P,71,19,37,51.4,6,25,24.0,25,62,40.3,15,22,68.2,6,24,30,14,20,21,11,6,2,1,68,Biofarm Basket Poznań,Sezon 2018/2019
2018-09-30 17:00,Jamalex Polonia 1912 Leszno(w),70 : 63P,63,18,35,51.4,6,25,24.0,24,60,40.0,9,13,69.2,6,30,36,15,22,18,14,6,5,2,71,Elektrobud-Investment ZB Pruszków,Sezon 2018/2019
2018-10-05 18:00,FutureNet Śląsk Wrocław(d),56 : 81P,56,10,33,30.3,5,22,22.7,15,55,27.3,21,27,77.8,12,21,33,12,20,22,16,7,1,3,47,Elektrobud-Investment ZB Pruszków,Sezon 2018/2019
2018-10-13 19:00,GKS Tychy(w),86 : 70P,70,14,28,50.0,9,28,32.1,23,56,41.1,15,18,83.3,5,26,31,14,20,21,10,4,3,3,76,Elektrobud-Investment ZB Pruszków,Sezon 2018/2019
2018-10-17 19:00,SKK Siedlce(d),75 : 57W,75,13,31,41.9,10,27,37.0,23,58,39.7,19,24,79.2,12,26,38,19,15,22,14,7,2,0,87,Elektrobud-Investment ZB Pruszków,Sezon 2018/2019
2018-10-20 18:30,KS Księżak Syntex Łowicz(w),70 : 56P,56,17,29,58.6,4,27,14.8,21,56,37.5,10,18,55.6,5,25,30,16,16,20,15,10,1,2,55,Elektrobud-Investment ZB Pruszków,Sezon 2018/2019
2018-10-27 18:00,AZS AGH Kraków(d),73 : 71W,73,17,36,47.2,6,15,40.0,23,51,45.1,21,28,75.0,5,20,25,13,17,21,16,7,1,2,68,Elektrobud-Investment ZB Pruszków,Sezon 2018/2019
2018-11-02 19:00,Górnik Trans.eu Wałbrzych(w),62 : 51P,51,14,32,43.8,5,25,20.0,19,57,33.3,8,13,61.5,5,21,26,12,21,19,14,6,1,3,39,Elektrobud-Investment ZB Pruszków,Sezon 2018/2019
2018-11-07 19:00,Biofarm Basket Poznań(d),67 : 61W,67,15,33,45.5,8,23,34.8,23,56,41.1,13,16,81.3,6,23,29,13,13,19,12,7,2,3,70,Elektrobud-Investment ZB Pruszków,Sezon 2018/2019
2018-11-11 16:00,Energa Kotwica Kołobrzeg(d),80 : 74W,80,19,35,54.3,9,28,32.1,28,63,44.4,15,21,71.4,9,20,29,14,18,23,12,15,1,0,86,Elektrobud-Investment ZB Pruszków,Sezon 2018/2019
2018-11-17 18:00,Pogoń Prudnik(d),75 : 88P,75,15,30,50.0,11,29,37.9,26,59,44.1,12,19,63.2,4,20,24,14,16,19,15,9,2,0,69,Elektrobud-Investment ZB Pruszków,Sezon 2018/2019
2018-11-24 18:00,STK Czarni Słupsk(w),80 : 60P,60,15,35,42.9,8,33,24.2,23,68,33.8,6,10,60.0,12,19,31,12,19,14,14,8,0,2,48,Elektrobud-Investment ZB Pruszków,Sezon 2018/2019
2018-12-01 18:00,Enea Astoria Bydgoszcz(d),87 : 88P,87,18,34,52.9,13,26,50.0,31,60,51.7,12,20,60.0,8,22,30,21,18,15,14,6,1,1,94,Elektrobud-Investment ZB Pruszków,Sezon 2018/2019
2018-12-08 19:00,WKK Wrocław(w),71 : 68P,68,14,35,40.0,8,31,25.8,22,66,33.3,16,20,80.0,11,27,38,13,21,16,20,11,2,2,64,Elektrobud-Investment ZB Pruszków,Sezon 2018/2019
2018-12-15 18:00,Rawlplug Sokół Łańcut(d),69 : 52W,69,17,31,54.8,10,38,26.3,27,69,39.1,5,5,100.0,6,27,33,20,22,13,7,8,4,0,85,Elektrobud-Investment ZB Pruszków,Sezon 2018/2019
2018-12-22 17:30,Polfarmex Kutno(w),82 : 87W,87,20,42,47.6,13,23,56.5,33,65,50.8,8,17,47.1,11,24,35,20,21,15,12,6,2,5,97,Elektrobud-Investment ZB Pruszków,Sezon 2018/2019
2019-01-06 17:00,Jamalex Polonia 1912 Leszno(d),65 : 73P,65,15,36,41.7,7,23,30.4,22,59,37.3,14,23,60.9,11,20,31,17,21,19,18,12,4,0,65,Elektrobud-Investment ZB Pruszków,Sezon 2018/2019
2019-01-12 18:00,FutureNet Śląsk Wrocław(w),90 : 76P,76,25,52,48.1,5,19,26.3,30,71,42.3,11,16,68.8,13,17,30,18,20,18,12,8,0,1,74,Elektrobud-Investment ZB Pruszków,Sezon 2018/2019
2019-01-19 18:30,GKS Tychy(d),67 : 65W,67,11,26,42.3,13,30,43.3,24,56,42.9,6,10,60.0,6,19,25,12,21,18,12,6,3,0,65,Elektrobud-Investment ZB Pruszków,Sezon 2018/2019
2019-01-23 18:00,SKK Siedlce(w),80 : 87W,87,14,39,35.9,13,33,39.4,27,72,37.5,20,26,76.9,14,25,39,17,24,20,11,12,3,3,96,Elektrobud-Investment ZB Pruszków,Sezon 2018/2019
2019-01-27 17:00,KS Księżak Syntex Łowicz(d),64 : 58W,64,19,41,46.3,5,19,26.3,24,60,40.0,11,16,68.8,10,26,36,13,19,19,13,9,3,2,71,Elektrobud-Investment ZB Pruszków,Sezon 2018/2019
2019-02-02 16:00,AZS AGH Kraków(w),64 : 75W,75,20,36,55.6,8,23,34.8,28,59,47.5,11,16,68.8,9,25,34,21,22,18,15,11,2,4,92,Elektrobud-Investment ZB Pruszków,Sezon 2018/2019
2019-02-09 16:00,Górnik Trans.eu Wałbrzych(d),73 : 68W,73,10,29,34.5,14,31,45.2,24,60,40.0,11,17,64.7,6,22,28,13,23,15,10,8,4,5,74,Elektrobud-Investment ZB Pruszków,Sezon 2018/2019
2019-02-13 18:00,Biofarm Basket Poznań(w),45 : 79W,79,19,44,43.2,9,19,47.4,28,63,44.4,14,19,73.7,7,25,32,15,14,18,12,18,1,1,93,Elektrobud-Investment ZB Pruszków,Sezon 2018/2019
2019-02-16 18:00,Energa Kotwica Kołobrzeg(w),79 : 61P,61,11,20,55.0,9,33,27.3,20,53,37.7,12,15,80.0,3,19,22,13,21,19,17,14,0,0,57,Elektrobud-Investment ZB Pruszków,Sezon 2018/2019
2019-02-23 17:30,Pogoń Prudnik(w),85 : 83P,83,21,29,72.4,10,32,31.3,31,61,50.8,11,18,61.1,4,27,31,23,24,16,10,5,1,2,96,Elektrobud-Investment ZB Pruszków,Sezon 2018/2019
2019-03-03 17:00,STK Czarni Słupsk(d),60 : 75P,60,19,37,51.4,5,25,20.0,24,62,38.7,7,9,77.8,6,17,23,13,22,18,11,10,3,5,58,Elektrobud-Investment ZB Pruszków,Sezon 2018/2019
2019-03-10 17:00,Enea Astoria Bydgoszcz(w),82 : 78P,78,15,41,36.6,13,40,32.5,28,81,34.6,9,13,69.2,13,15,28,20,20,16,12,16,0,4,73,Elektrobud-Investment ZB Pruszków,Sezon 2018/2019
2019-03-16 17:00,WKK Wrocław(d),78 : 84P,78,19,36,52.8,11,25,44.0,30,61,49.2,7,11,63.6,9,27,36,16,19,13,13,1,0,1,83,Elektrobud-Investment ZB Pruszków,Sezon 2018/2019
2019-03-23 17:30,Rawlplug Sokół Łańcut(w),88 : 84P,84,16,33,48.5,11,30,36.7,27,63,42.9,19,22,86.4,12,27,39,14,21,19,15,7,1,3,91,Elektrobud-Investment ZB Pruszków,Sezon 2018/2019
2019-03-31 18:00,Polfarmex Kutno(d),58 : 80P,58,16,33,48.5,4,19,21.1,20,52,38.5,14,21,66.7,7,21,28,11,24,17,16,7,6,3,55,Elektrobud-Investment ZB Pruszków,Sezon 2018/2019
2019-04-06 18:00,KS Księżak Syntex Łowicz(d),83 : 75W,83,13,31,41.9,13,26,50.0,26,57,45.6,18,28,64.3,12,21,33,14,19,21,10,3,3,2,85,Elektrobud-Investment ZB Pruszków,Sezon 2018/2019
2019-04-07 18:00,KS Księżak Syntex Łowicz(d),77 : 67W,77,15,31,48.4,12,32,37.5,27,63,42.9,11,13,84.6,14,19,33,17,20,18,9,8,2,0,90,Elektrobud-Investment ZB Pruszków,Sezon 2018/2019
2019-04-13 18:00,KS Księżak Syntex Łowicz(w),83 : 77P,77,15,29,51.7,12,36,33.3,27,65,41.5,11,15,73.3,12,20,32,13,25,16,15,10,2,2,77,Elektrobud-Investment ZB Pruszków,Sezon 2018/2019
2019-04-14 18:00,KS Księżak Syntex Łowicz(w),54 : 71W,71,19,42,45.2,7,19,36.8,26,61,42.6,12,15,80.0,5,29,34,12,22,20,9,8,4,2,82,Elektrobud-Investment ZB Pruszków,Sezon 2018/2019
2018-09-29 18:30,KS Księżak Syntex Łowicz(w),73 : 84W,84,27,45,60.0,5,15,33.3,32,60,53.3,15,23,65.2,9,26,35,17,22,23,12,9,1,4,98,Enea Astoria Bydgoszcz,Sezon 2018/2019
2018-10-06 17:00,AZS AGH Kraków(d),76 : 85P,76,25,49,51.0,5,15,33.3,30,64,46.9,11,21,52.4,10,20,30,19,28,22,15,10,3,1,79,Enea Astoria Bydgoszcz,Sezon 2018/2019
2018-10-13 18:30,Górnik Trans.eu Wałbrzych(w),76 : 66P,66,20,38,52.6,4,20,20.0,24,58,41.4,14,22,63.6,9,19,28,15,26,24,21,9,0,4,55,Enea Astoria Bydgoszcz,Sezon 2018/2019
2018-10-17 19:00,Biofarm Basket Poznań(d),93 : 62W,93,27,49,55.1,7,21,33.3,34,70,48.6,18,23,78.3,16,33,49,23,17,17,10,13,5,3,132,Enea Astoria Bydgoszcz,Sezon 2018/2019
2018-10-21 17:00,Energa Kotwica Kołobrzeg(w),73 : 77W,77,19,37,51.4,5,18,27.8,24,55,43.6,24,37,64.9,10,30,40,12,24,29,9,8,2,2,86,Enea Astoria Bydgoszcz,Sezon 2018/2019
2018-10-27 17:00,Pogoń Prudnik(d),89 : 78W,89,33,47,70.2,4,22,18.2,37,69,53.6,11,16,68.8,9,25,34,17,20,21,14,9,5,0,103,Enea Astoria Bydgoszcz,Sezon 2018/2019
2018-11-03 18:00,STK Czarni Słupsk(w),90 : 92W,92,29,51,56.9,7,15,46.7,36,66,54.5,13,25,52.0,4,28,32,29,17,22,6,7,1,1,113,Enea Astoria Bydgoszcz,Sezon 2018/2019
2018-11-07 20:00,Jamalex Polonia 1912 Leszno(w),72 : 58P,58,17,45,37.8,5,23,21.7,22,68,32.4,9,13,69.2,15,25,40,11,22,20,21,8,1,2,47,Enea Astoria Bydgoszcz,Sezon 2018/2019
2018-11-11 17:00,WKK Wrocław(d),62 : 76P,62,14,33,42.4,9,32,28.1,23,65,35.4,7,12,58.3,11,30,41,16,20,14,15,7,0,1,64,Enea Astoria Bydgoszcz,Sezon 2018/2019
2018-11-17 17:30,Rawlplug Sokół Łańcut(w),73 : 95W,95,28,47,59.6,8,17,47.1,36,64,56.3,15,26,57.7,11,31,42,20,24,24,11,4,1,3,112,Enea Astoria Bydgoszcz,Sezon 2018/2019
2018-11-24 17:00,Polfarmex Kutno(d),88 : 69W,88,25,42,59.5,8,16,50.0,33,58,56.9,14,28,50.0,5,26,31,20,16,26,9,8,1,1,100,Enea Astoria Bydgoszcz,Sezon 2018/2019
2018-12-01 18:00,Elektrobud-Investment ZB Pruszków(w),87 : 88W,88,23,37,62.2,10,23,43.5,33,60,55.0,12,18,66.7,3,20,23,25,15,18,12,9,1,1,101,Enea Astoria Bydgoszcz,Sezon 2018/2019
2018-12-08 18:00,FutureNet Śląsk Wrocław(d),86 : 91P,86,27,52,51.9,7,23,30.4,34,75,45.3,11,21,52.4,15,21,36,16,21,26,8,6,4,1,89,Enea Astoria Bydgoszcz,Sezon 2018/2019
2018-12-15 18:00,GKS Tychy(w),76 : 78W,78,23,36,63.9,6,29,20.7,29,65,44.6,14,20,70.0,8,24,32,17,17,24,13,7,3,0,82,Enea Astoria Bydgoszcz,Sezon 2018/2019
2018-12-22 17:00,SKK Siedlce(d),106 : 92W,106,24,46,52.2,14,29,48.3,38,75,50.7,16,19,84.2,10,27,37,27,23,20,14,12,3,1,131,Enea Astoria Bydgoszcz,Sezon 2018/2019
2019-01-05 17:00,KS Księżak Syntex Łowicz(d),100 : 73W,100,30,46,65.2,7,21,33.3,37,67,55.2,19,25,76.0,13,28,41,28,16,23,13,9,3,0,132,Enea Astoria Bydgoszcz,Sezon 2018/2019
2019-01-13 18:30,AZS AGH Kraków(w),64 : 84W,84,33,63,52.4,2,9,22.2,35,72,48.6,12,33,36.4,21,28,49,19,22,28,12,13,3,5,98,Enea Astoria Bydgoszcz,Sezon 2018/2019
2019-01-17 19:00,Górnik Trans.eu Wałbrzych(d),95 : 77W,95,26,37,70.3,7,19,36.8,33,56,58.9,22,29,75.9,2,25,27,23,17,23,14,10,2,2,113,Enea Astoria Bydgoszcz,Sezon 2018/2019
2019-01-23 19:00,Biofarm Basket Poznań(w),91 : 84P,84,27,47,57.4,5,18,27.8,32,65,49.2,15,19,78.9,8,26,34,21,21,19,13,5,4,5,98,Enea Astoria Bydgoszcz,Sezon 2018/2019
2019-01-26 17:00,Energa Kotwica Kołobrzeg(d),95 : 66W,95,25,49,51.0,10,23,43.5,35,72,48.6,15,19,78.9,12,32,44,27,19,23,9,8,4,3,128,Enea Astoria Bydgoszcz,Sezon 2018/2019
2019-02-02 17:30,Pogoń Prudnik(w),103 : 89P,89,25,47,53.2,7,22,31.8,32,69,46.4,18,27,66.7,13,17,30,19,25,22,12,8,2,0,90,Enea Astoria Bydgoszcz,Sezon 2018/2019
2019-02-09 17:00,STK Czarni Słupsk(d),86 : 59W,86,21,43,48.8,8,23,34.8,29,66,43.9,20,30,66.7,8,28,36,20,15,24,8,13,1,4,101,Enea Astoria Bydgoszcz,Sezon 2018/2019
2019-02-13 19:00,Jamalex Polonia 1912 Leszno(d),94 : 84W,94,26,43,60.5,10,23,43.5,36,66,54.5,12,19,63.2,10,25,35,21,16,21,12,5,6,1,112,Enea Astoria Bydgoszcz,Sezon 2018/2019
2019-02-17 16:00,WKK Wrocław(w),70 : 86W,86,27,47,57.4,5,23,21.7,32,70,45.7,17,23,73.9,14,27,41,16,18,21,15,6,2,4,92,Enea Astoria Bydgoszcz,Sezon 2018/2019
2019-02-23 17:00,Rawlplug Sokół Łańcut(d),87 : 96P,87,22,38,57.9,11,30,36.7,33,68,48.5,10,13,76.9,5,28,33,23,22,13,11,2,4,1,100,Enea Astoria Bydgoszcz,Sezon 2018/2019
2019-03-02 17:30,Polfarmex Kutno(w),64 : 94W,94,29,45,64.4,6,20,30.0,35,65,53.8,18,26,69.2,7,31,38,23,20,23,10,10,6,2,123,Enea Astoria Bydgoszcz,Sezon 2018/2019
2019-03-10 17:00,Elektrobud-Investment ZB Pruszków(d),82 : 78W,82,25,37,67.6,7,23,30.4,32,60,53.3,11,17,64.7,9,36,45,20,16,20,28,9,4,0,98,Enea Astoria Bydgoszcz,Sezon 2018/2019
2019-03-17 19:00,FutureNet Śląsk Wrocław(w),101 : 92P,92,24,54,44.4,10,21,47.6,34,75,45.3,14,16,87.5,10,20,30,19,20,17,9,4,0,4,93,Enea Astoria Bydgoszcz,Sezon 2018/2019
2019-03-23 17:00,GKS Tychy(d),92 : 82W,92,20,35,57.1,15,28,53.6,35,63,55.6,7,12,58.3,8,25,33,18,22,20,12,4,6,1,108,Enea Astoria Bydgoszcz,Sezon 2018/2019
2019-03-31 18:00,SKK Siedlce(w),81 : 82W,82,25,47,53.2,7,22,31.8,32,69,46.4,11,19,57.9,13,30,43,25,16,18,10,9,2,2,106,Enea Astoria Bydgoszcz,Sezon 2018/2019
2019-04-06 17:00,Biofarm Basket Poznań(d),89 : 80W,89,31,52,59.6,7,25,28.0,38,77,49.4,6,6,100.0,10,22,32,20,21,16,11,10,2,3,103,Enea Astoria Bydgoszcz,Sezon 2018/2019
2019-04-07 17:00,Biofarm Basket Poznań(d),87 : 75W,87,20,35,57.1,10,25,40.0,30,60,50.0,17,28,60.7,6,24,30,25,17,21,12,12,4,0,105,Enea Astoria Bydgoszcz,Sezon 2018/2019
2019-04-13 16:00,Biofarm Basket Poznań(w),71 : 80W,80,22,42,52.4,10,26,38.5,32,68,47.1,6,13,46.2,9,30,39,23,21,20,11,4,1,2,93,Enea Astoria Bydgoszcz,Sezon 2018/2019
2019-04-27 17:00,Rawlplug Sokół Łańcut(d),95 : 70W,95,31,53,58.5,8,17,47.1,39,70,55.7,9,14,64.3,10,37,47,24,19,15,10,4,0,1,124,Enea Astoria Bydgoszcz,Sezon 2018/2019
2019-04-28 17:00,Rawlplug Sokół Łańcut(d),83 : 87P,83,18,38,47.4,13,32,40.6,31,70,44.3,8,12,66.7,13,28,41,24,22,14,12,6,1,5,100,Enea Astoria Bydgoszcz,Sezon 2018/2019
2019-05-04 17:30,Rawlplug Sokół Łańcut(w),99 : 79P,79,19,37,51.4,10,26,38.5,29,63,46.0,11,21,52.4,11,17,28,18,29,22,15,5,1,1,72,Enea Astoria Bydgoszcz,Sezon 2018/2019
2019-05-05 17:30,Rawlplug Sokół Łańcut(w),68 : 74W,74,24,50,48.0,5,17,29.4,29,67,43.3,11,21,52.4,12,27,39,12,22,24,9,7,2,4,77,Enea Astoria Bydgoszcz,Sezon 2018/2019
2019-05-08 19:00,Rawlplug Sokół Łańcut(d),89 : 66W,89,24,50,48.0,10,25,40.0,34,75,45.3,11,16,68.8,15,31,46,22,19,21,11,6,1,3,107,Enea Astoria Bydgoszcz,Sezon 2018/2019
2019-05-11 19:00,FutureNet Śląsk Wrocław(w),79 : 97W,97,24,45,53.3,8,21,38.1,32,66,48.5,25,31,80.6,8,34,42,19,17,26,8,8,3,0,121,Enea Astoria Bydgoszcz,Sezon 2018/2019
2019-05-12 19:00,FutureNet Śląsk Wrocław(w),85 : 86W,86,32,51,62.7,2,16,12.5,34,67,50.7,16,25,64.0,9,25,34,12,17,23,9,4,2,3,87,Enea Astoria Bydgoszcz,Sezon 2018/2019
2019-05-19 17:00,FutureNet Śląsk Wrocław(d),86 : 77W,86,16,39,41.0,12,25,48.0,28,64,43.8,18,28,64.3,8,25,33,18,23,22,6,5,4,2,94,Enea Astoria Bydgoszcz,Sezon 2018/2019
2018-09-29 17:00,Biofarm Basket Poznań(w),83 : 82P,82,19,33,57.6,11,31,35.5,30,64,46.9,11,14,78.6,7,23,30,22,23,18,10,6,0,3,93,Energa Kotwica Kołobrzeg,Sezon 2018/2019
2018-10-06 16:00,Jamalex Polonia 1912 Leszno(d),56 : 76P,56,16,33,48.5,5,21,23.8,21,54,38.9,9,11,81.8,6,17,23,8,22,20,14,4,3,0,45,Energa Kotwica Kołobrzeg,Sezon 2018/2019
2018-10-13 17:30,Pogoń Prudnik(w),82 : 79P,79,17,37,45.9,10,25,40.0,27,62,43.5,15,16,93.8,9,26,35,14,20,17,12,10,1,6,91,Energa Kotwica Kołobrzeg,Sezon 2018/2019
2018-10-17 18:00,STK Czarni Słupsk(w),84 : 88W,88,17,31,54.8,12,28,42.9,29,59,49.2,18,27,66.7,6,22,28,15,23,24,12,8,2,1,90,Energa Kotwica Kołobrzeg,Sezon 2018/2019
2018-10-21 17:00,Enea Astoria Bydgoszcz(d),73 : 77P,73,13,28,46.4,10,31,32.3,23,59,39.0,17,24,70.8,4,25,29,10,29,24,14,4,2,2,61,Energa Kotwica Kołobrzeg,Sezon 2018/2019
2018-10-28 19:00,WKK Wrocław(w),92 : 78P,78,20,38,52.6,9,26,34.6,29,64,45.3,11,15,73.3,7,26,33,15,18,19,17,6,1,4,77,Energa Kotwica Kołobrzeg,Sezon 2018/2019
2018-10-30 19:30,FutureNet Śląsk Wrocław(w),101 : 80P,80,18,42,42.9,6,20,30.0,24,62,38.7,26,37,70.3,7,23,30,12,18,30,13,9,2,5,71,Energa Kotwica Kołobrzeg,Sezon 2018/2019
2018-11-07 18:00,Polfarmex Kutno(w),87 : 85P,85,20,50,40.0,9,21,42.9,29,71,40.8,18,20,90.0,13,28,41,17,24,20,15,5,5,8,94,Energa Kotwica Kołobrzeg,Sezon 2018/2019
2018-11-11 16:00,Elektrobud-Investment ZB Pruszków(w),80 : 74P,74,20,37,54.1,8,19,42.1,28,56,50.0,10,13,76.9,10,29,39,10,23,18,23,7,0,1,76,Energa Kotwica Kołobrzeg,Sezon 2018/2019
2018-11-13 18:30,Rawlplug Sokół Łańcut(d),68 : 90P,68,17,33,51.5,10,22,45.5,27,55,49.1,4,6,66.7,9,19,28,14,32,16,21,6,2,0,67,Energa Kotwica Kołobrzeg,Sezon 2018/2019
2018-11-24 18:00,GKS Tychy(d),99 : 84W,99,23,29,79.3,13,24,54.2,36,53,67.9,14,22,63.6,4,22,26,24,20,23,12,9,0,0,121,Energa Kotwica Kołobrzeg,Sezon 2018/2019
2018-12-01 18:00,SKK Siedlce(d),98 : 93W,98,23,34,67.6,9,36,25.0,32,70,45.7,25,33,75.8,10,28,38,26,21,25,11,7,3,2,115,Energa Kotwica Kołobrzeg,Sezon 2018/2019
2018-12-08 18:00,KS Księżak Syntex Łowicz(d),98 : 66W,98,26,38,68.4,10,21,47.6,36,59,61.0,16,19,84.2,4,38,42,22,18,24,16,7,3,0,130,Energa Kotwica Kołobrzeg,Sezon 2018/2019
2018-12-13 18:00,Rawlplug Sokół Łańcut(w),104 : 93P,93,25,36,69.4,12,29,41.4,37,65,56.9,7,10,70.0,4,18,22,20,26,15,12,9,0,2,101,Energa Kotwica Kołobrzeg,Sezon 2018/2019
2018-12-15 19:30,AZS AGH Kraków(w),79 : 70P,70,21,37,56.8,3,16,18.8,24,53,45.3,19,31,61.3,10,31,41,14,29,22,20,5,4,3,73,Energa Kotwica Kołobrzeg,Sezon 2018/2019
2018-12-21 18:30,Górnik Trans.eu Wałbrzych(d),95 : 80W,95,17,36,47.2,15,33,45.5,32,69,46.4,16,23,69.6,8,21,29,21,25,20,10,4,3,2,98,Energa Kotwica Kołobrzeg,Sezon 2018/2019
2019-01-06 17:00,Biofarm Basket Poznań(d),71 : 86P,71,12,29,41.4,12,33,36.4,24,62,38.7,11,20,55.0,10,25,35,16,21,20,15,6,1,4,67,Energa Kotwica Kołobrzeg,Sezon 2018/2019
2019-01-12 18:00,Jamalex Polonia 1912 Leszno(w),88 : 77P,77,18,41,43.9,9,27,33.3,27,68,39.7,14,18,77.8,9,20,29,11,22,20,12,5,0,3,65,Energa Kotwica Kołobrzeg,Sezon 2018/2019
2019-01-19 18:00,Pogoń Prudnik(d),87 : 81W,87,23,38,60.5,9,30,30.0,32,68,47.1,14,20,70.0,8,30,38,21,25,23,12,2,2,1,96,Energa Kotwica Kołobrzeg,Sezon 2018/2019
2019-01-23 18:30,STK Czarni Słupsk(d),64 : 84P,64,16,32,50.0,5,21,23.8,21,53,39.6,17,25,68.0,8,23,31,11,21,20,21,8,1,1,54,Energa Kotwica Kołobrzeg,Sezon 2018/2019
2019-01-26 17:00,Enea Astoria Bydgoszcz(w),95 : 66P,66,15,35,42.9,7,28,25.0,22,63,34.9,15,18,83.3,6,19,25,20,23,19,13,5,3,4,62,Energa Kotwica Kołobrzeg,Sezon 2018/2019
2019-02-02 18:00,WKK Wrocław(d),79 : 68W,79,19,42,45.2,6,21,28.6,25,63,39.7,23,26,88.5,12,23,35,14,24,22,9,5,2,2,85,Energa Kotwica Kołobrzeg,Sezon 2018/2019
2019-02-13 18:30,Polfarmex Kutno(d),102 : 80W,102,27,39,69.2,11,20,55.0,38,59,64.4,15,21,71.4,8,23,31,18,20,18,15,8,2,0,119,Energa Kotwica Kołobrzeg,Sezon 2018/2019
2019-02-16 18:00,Elektrobud-Investment ZB Pruszków(d),79 : 61W,79,20,36,55.6,9,22,40.9,29,58,50.0,12,19,63.2,10,27,37,15,19,21,20,10,0,0,85,Energa Kotwica Kołobrzeg,Sezon 2018/2019
2019-02-24 17:00,FutureNet Śląsk Wrocław(d),80 : 76W,80,17,43,39.5,11,24,45.8,28,67,41.8,13,17,76.5,9,29,38,14,20,19,17,8,3,6,83,Energa Kotwica Kołobrzeg,Sezon 2018/2019
2019-03-02 18:00,GKS Tychy(w),94 : 85P,85,25,41,61.0,6,17,35.3,31,58,53.4,17,20,85.0,7,24,31,17,27,22,17,7,1,0,94,Energa Kotwica Kołobrzeg,Sezon 2018/2019
2019-03-09 16:00,SKK Siedlce(w),81 : 86W,86,28,49,57.1,7,22,31.8,35,71,49.3,9,12,75.0,9,24,33,25,23,14,13,11,3,2,106,Energa Kotwica Kołobrzeg,Sezon 2018/2019
2019-03-16 18:30,KS Księżak Syntex Łowicz(w),76 : 86W,86,28,56,50.0,5,14,35.7,33,70,47.1,15,19,78.9,15,20,35,16,18,22,11,8,1,3,94,Energa Kotwica Kołobrzeg,Sezon 2018/2019
2019-03-23 18:00,AZS AGH Kraków(d),88 : 71W,88,33,50,66.0,3,14,21.4,36,64,56.3,13,22,59.1,6,24,30,18,22,21,10,9,4,3,102,Energa Kotwica Kołobrzeg,Sezon 2018/2019
2019-03-31 18:00,Górnik Trans.eu Wałbrzych(w),70 : 68P,68,13,34,38.2,9,27,33.3,22,61,36.1,15,20,75.0,9,19,28,14,22,23,10,7,1,3,64,Energa Kotwica Kołobrzeg,Sezon 2018/2019
2019-04-06 18:00,SKK Siedlce(d),72 : 79P,72,17,39,43.6,6,28,21.4,23,67,34.3,20,24,83.3,11,24,35,12,21,21,13,10,3,3,71,Energa Kotwica Kołobrzeg,Sezon 2018/2019
2019-04-07 17:00,SKK Siedlce(d),82 : 71W,82,21,40,52.5,10,32,31.3,31,72,43.1,10,12,83.3,12,30,42,19,20,14,11,10,0,1,99,Energa Kotwica Kołobrzeg,Sezon 2018/2019
2019-04-13 13:00,SKK Siedlce(w),72 : 80W,80,26,41,63.4,6,20,30.0,32,61,52.5,10,14,71.4,9,25,34,11,17,17,13,5,3,1,87,Energa Kotwica Kołobrzeg,Sezon 2018/2019
2019-04-14 13:00,SKK Siedlce(w),81 : 83W,83,24,58,41.4,7,23,30.4,31,81,38.3,14,17,82.4,14,29,43,20,16,18,11,10,1,7,93,Energa Kotwica Kołobrzeg,Sezon 2018/2019
2018-09-30 19:00,Polfarmex Kutno(d),87 : 77W,87,22,42,52.4,7,21,33.3,29,63,46.0,22,27,81.5,8,24,32,23,21,27,13,4,2,4,96,FutureNet Śląsk Wrocław,Sezon 2018/2019
2018-10-05 18:00,Elektrobud-Investment ZB Pruszków(w),56 : 81W,81,20,39,51.3,11,34,32.4,31,73,42.5,8,12,66.7,17,25,42,15,22,20,13,8,3,1,90,FutureNet Śląsk Wrocław,Sezon 2018/2019
2018-10-13 18:00,Jamalex Polonia 1912 Leszno(d),86 : 82W,86,22,42,52.4,6,22,27.3,28,64,43.8,24,39,61.5,11,25,36,18,26,32,14,3,4,0,82,FutureNet Śląsk Wrocław,Sezon 2018/2019
2018-10-17 19:30,GKS Tychy(d),94 : 61W,94,21,36,58.3,14,41,34.1,35,77,45.5,10,17,58.8,14,27,41,23,15,22,5,8,4,2,116,FutureNet Śląsk Wrocław,Sezon 2018/2019
2018-10-20 18:00,SKK Siedlce(w),102 : 104W,104,15,30,50.0,17,52,32.7,32,82,39.0,23,30,76.7,12,34,46,22,17,23,15,9,8,2,117,FutureNet Śląsk Wrocław,Sezon 2018/2019
2018-10-27 19:30,KS Księżak Syntex Łowicz(w),77 : 100W,100,20,35,57.1,13,24,54.2,33,59,55.9,21,31,67.7,5,25,30,23,16,26,8,10,1,2,120,FutureNet Śląsk Wrocław,Sezon 2018/2019
2018-10-30 19:30,Energa Kotwica Kołobrzeg(d),101 : 80W,101,18,41,43.9,17,33,51.5,35,74,47.3,14,17,82.4,10,32,42,26,30,18,16,4,5,2,120,FutureNet Śląsk Wrocław,Sezon 2018/2019
2018-11-04 19:00,AZS AGH Kraków(w),97 : 88P,88,28,58,48.3,4,17,23.5,32,75,42.7,20,29,69.0,15,25,40,12,32,26,13,7,2,3,84,FutureNet Śląsk Wrocław,Sezon 2018/2019
2018-11-07 19:30,Górnik Trans.eu Wałbrzych(d),91 : 78W,91,15,38,39.5,11,42,26.2,26,80,32.5,28,36,77.8,20,27,47,21,21,26,10,5,1,4,93,FutureNet Śląsk Wrocław,Sezon 2018/2019
2018-11-10 17:00,Biofarm Basket Poznań(w),70 : 79W,79,14,34,41.2,9,32,28.1,23,66,34.8,24,30,80.0,10,32,42,12,14,18,2,2,3,2,87,FutureNet Śląsk Wrocław,Sezon 2018/2019
2018-11-24 17:30,Pogoń Prudnik(w),87 : 80P,80,18,33,54.5,7,30,23.3,25,63,39.7,23,35,65.7,6,31,37,17,23,26,12,4,1,3,77,FutureNet Śląsk Wrocław,Sezon 2018/2019
2018-12-01 19:00,STK Czarni Słupsk(d),96 : 83W,96,19,34,55.9,15,35,42.9,34,69,49.3,13,18,72.2,9,24,33,20,14,20,10,5,4,3,108,FutureNet Śląsk Wrocław,Sezon 2018/2019
2018-12-08 18:00,Enea Astoria Bydgoszcz(w),86 : 91W,91,17,30,56.7,14,33,42.4,31,63,49.2,15,18,83.3,6,22,28,22,26,20,11,3,1,4,99,FutureNet Śląsk Wrocław,Sezon 2018/2019
2018-12-15 18:00,WKK Wrocław(d),91 : 72W,91,19,37,51.4,13,33,39.4,32,70,45.7,14,19,73.7,8,34,42,23,23,17,9,6,4,1,114,FutureNet Śląsk Wrocław,Sezon 2018/2019
2018-12-22 17:30,Rawlplug Sokół Łańcut(w),82 : 79P,79,23,37,62.2,9,36,25.0,32,73,43.8,6,11,54.5,11,26,37,13,25,15,8,5,3,6,83,FutureNet Śląsk Wrocław,Sezon 2018/2019
2019-01-05 17:30,Polfarmex Kutno(w),63 : 90W,90,23,39,59.0,13,34,38.2,36,73,49.3,5,9,55.6,11,36,47,22,17,14,14,9,3,8,116,FutureNet Śląsk Wrocław,Sezon 2018/2019
2019-01-12 18:00,Elektrobud-Investment ZB Pruszków(d),90 : 76W,90,19,28,67.9,15,37,40.5,34,65,52.3,7,11,63.6,11,27,38,22,18,20,17,8,1,0,107,FutureNet Śląsk Wrocław,Sezon 2018/2019
2019-01-19 18:00,Jamalex Polonia 1912 Leszno(w),88 : 102W,102,26,36,72.2,11,25,44.0,37,61,60.7,17,21,81.0,6,26,32,15,25,19,15,4,0,1,110,FutureNet Śląsk Wrocław,Sezon 2018/2019
2019-01-23 19:00,GKS Tychy(w),97 : 84P,84,16,27,59.3,10,42,23.8,26,69,37.7,22,28,78.6,11,23,34,14,25,25,13,6,3,3,79,FutureNet Śląsk Wrocław,Sezon 2018/2019
2019-01-27 20:00,SKK Siedlce(d),121 : 79W,121,29,49,59.2,16,37,43.2,45,86,52.3,15,21,71.4,21,28,49,21,17,19,10,12,1,0,147,FutureNet Śląsk Wrocław,Sezon 2018/2019
2019-02-02 18:00,KS Księżak Syntex Łowicz(d),123 : 88W,123,26,44,59.1,17,32,53.1,43,76,56.6,20,23,87.0,14,27,41,26,20,21,11,7,7,3,157,FutureNet Śląsk Wrocław,Sezon 2018/2019
2019-02-13 19:45,Górnik Trans.eu Wałbrzych(w),75 : 72P,72,12,30,40.0,10,36,27.8,22,66,33.3,18,24,75.0,11,31,42,10,23,21,12,6,3,5,71,FutureNet Śląsk Wrocław,Sezon 2018/2019
2019-02-17 19:00,Biofarm Basket Poznań(d),86 : 70W,86,21,43,48.8,12,36,33.3,33,79,41.8,8,18,44.4,16,40,56,20,21,22,15,8,3,5,102,FutureNet Śląsk Wrocław,Sezon 2018/2019
2019-02-24 17:00,Energa Kotwica Kołobrzeg(w),80 : 76P,76,13,22,59.1,12,44,27.3,25,66,37.9,14,19,73.7,11,25,36,15,19,20,15,9,6,3,81,FutureNet Śląsk Wrocław,Sezon 2018/2019
2019-03-01 20:00,Pogoń Prudnik(d),98 : 75W,98,22,47,46.8,16,38,42.1,38,85,44.7,6,10,60.0,17,28,45,23,25,15,9,10,1,6,117,FutureNet Śląsk Wrocław,Sezon 2018/2019
2019-03-06 18:30,AZS AGH Kraków(d),72 : 52W,72,20,44,45.5,7,22,31.8,27,66,40.9,11,21,52.4,12,30,42,21,17,22,13,8,4,1,85,FutureNet Śląsk Wrocław,Sezon 2018/2019
2019-03-09 18:00,STK Czarni Słupsk(w),80 : 71P,71,20,42,47.6,8,22,36.4,28,64,43.8,7,12,58.3,9,32,41,13,22,19,10,2,1,3,77,FutureNet Śląsk Wrocław,Sezon 2018/2019
2019-03-17 19:00,Enea Astoria Bydgoszcz(d),101 : 92W,101,23,40,57.5,12,35,34.3,35,75,46.7,19,23,82.6,10,29,39,23,17,20,8,6,4,0,121,FutureNet Śląsk Wrocław,Sezon 2018/2019
2019-03-23 18:00,WKK Wrocław(w),80 : 93W,93,24,43,55.8,13,30,43.3,37,73,50.7,6,11,54.5,15,24,39,24,16,12,6,2,1,4,112,FutureNet Śląsk Wrocław,Sezon 2018/2019
2019-03-31 18:00,Rawlplug Sokół Łańcut(d),105 : 71W,105,23,42,54.8,16,32,50.0,39,74,52.7,11,16,68.8,15,27,42,21,20,12,10,4,2,1,124,FutureNet Śląsk Wrocław,Sezon 2018/2019
2019-04-06 15:00,Górnik Trans.eu Wałbrzych(d),94 : 72W,94,15,34,44.1,15,34,44.1,30,68,44.1,19,27,70.4,16,23,39,16,26,25,10,7,4,2,104,FutureNet Śląsk Wrocław,Sezon 2018/2019
2019-04-07 15:00,Górnik Trans.eu Wałbrzych(d),94 : 85W,94,12,27,44.4,11,30,36.7,23,57,40.4,37,45,82.2,10,19,29,14,31,33,9,5,3,0,94,FutureNet Śląsk Wrocław,Sezon 2018/2019
2019-04-13 17:00,Górnik Trans.eu Wałbrzych(w),100 : 91P,91,16,38,42.1,12,38,31.6,28,76,36.8,23,29,79.3,16,17,33,14,23,25,11,8,1,6,82,FutureNet Śląsk Wrocław,Sezon 2018/2019
2019-04-14 17:00,Górnik Trans.eu Wałbrzych(w),65 : 86W,86,11,30,36.7,13,33,39.4,24,63,38.1,25,28,89.3,10,27,37,14,19,21,10,7,0,2,92,FutureNet Śląsk Wrocław,Sezon 2018/2019
2019-04-27 18:00,STK Czarni Słupsk(d),85 : 80W,85,20,37,54.1,8,22,36.4,28,59,47.5,21,32,65.6,11,26,37,17,24,29,14,4,8,0,95,FutureNet Śląsk Wrocław,Sezon 2018/2019
2019-04-28 18:00,STK Czarni Słupsk(d),72 : 86P,72,21,43,48.8,4,21,19.0,25,64,39.1,18,29,62.1,9,24,33,7,23,25,12,6,5,5,61,FutureNet Śląsk Wrocław,Sezon 2018/2019
2019-05-04 19:00,STK Czarni Słupsk(w),76 : 85W,85,15,30,50.0,10,39,25.6,25,69,36.2,25,33,75.8,9,34,43,13,17,27,5,3,2,4,89,FutureNet Śląsk Wrocław,Sezon 2018/2019
2019-05-05 19:00,STK Czarni Słupsk(w),103 : 101P,101,15,23,65.2,18,40,45.0,33,63,52.4,17,24,70.8,5,24,29,19,22,22,12,3,7,0,110,FutureNet Śląsk Wrocław,Sezon 2018/2019
2019-05-08 18:00,STK Czarni Słupsk(d),82 : 81W,82,15,33,45.5,12,30,40.0,27,63,42.9,16,27,59.3,6,23,29,21,20,26,10,8,1,4,84,FutureNet Śląsk Wrocław,Sezon 2018/2019
2019-05-11 19:00,Enea Astoria Bydgoszcz(d),79 : 97P,79,16,37,43.2,12,37,32.4,28,74,37.8,11,17,64.7,13,27,40,20,26,17,11,5,0,3,81,FutureNet Śląsk Wrocław,Sezon 2018/2019
2019-05-12 19:00,Enea Astoria Bydgoszcz(d),85 : 86P,85,13,25,52.0,14,39,35.9,27,64,42.2,17,18,94.4,11,25,36,17,23,17,13,4,3,2,94,FutureNet Śląsk Wrocław,Sezon 2018/2019
2019-05-19 17:00,Enea Astoria Bydgoszcz(w),86 : 77P,77,13,33,39.4,10,28,35.7,23,61,37.7,21,31,67.7,6,31,37,20,22,23,10,2,2,4,80,FutureNet Śląsk Wrocław,Sezon 2018/2019
2018-09-29 19:00,Rawlplug Sokół Łańcut(d),85 : 90P,85,20,41,48.8,9,26,34.6,29,67,43.3,18,20,90.0,11,20,31,24,33,22,13,9,3,1,99,GKS Tychy,Sezon 2018/2019
2018-10-07 17:30,Polfarmex Kutno(w),61 : 75W,75,14,33,42.4,11,24,45.8,25,57,43.9,14,20,70.0,8,30,38,23,17,23,16,6,2,4,90,GKS Tychy,Sezon 2018/2019
2018-10-13 19:00,Elektrobud-Investment ZB Pruszków(d),86 : 70W,86,19,33,57.6,10,30,33.3,29,63,46.0,18,21,85.7,5,29,34,24,21,20,6,7,3,3,111,GKS Tychy,Sezon 2018/2019
2018-10-17 19:30,FutureNet Śląsk Wrocław(w),94 : 61P,61,17,33,51.5,6,27,22.2,23,60,38.3,9,13,69.2,9,19,28,15,22,15,14,1,2,4,52,GKS Tychy,Sezon 2018/2019
2018-10-20 18:00,Jamalex Polonia 1912 Leszno(d),80 : 83P,80,24,45,53.3,6,24,25.0,30,69,43.5,14,19,73.7,12,23,35,18,23,21,10,2,2,0,83,GKS Tychy,Sezon 2018/2019
2018-10-27 19:00,SKK Siedlce(d),91 : 74W,91,22,37,59.5,8,27,29.6,30,64,46.9,23,25,92.0,11,24,35,20,20,29,12,8,0,1,106,GKS Tychy,Sezon 2018/2019
2018-11-03 18:30,KS Księżak Syntex Łowicz(w),75 : 82W,82,22,34,64.7,8,21,38.1,30,55,54.5,14,17,82.4,6,20,26,16,20,20,10,5,0,1,91,GKS Tychy,Sezon 2018/2019
2018-11-07 19:00,AZS AGH Kraków(d),112 : 102W,112,41,59,69.5,4,9,44.4,45,68,66.2,18,23,78.3,4,28,32,31,28,23,11,7,2,0,145,GKS Tychy,Sezon 2018/2019
2018-11-10 18:30,Górnik Trans.eu Wałbrzych(w),73 : 65P,65,8,27,29.6,10,32,31.3,18,59,30.5,19,27,70.4,12,20,32,10,28,25,14,7,0,5,51,GKS Tychy,Sezon 2018/2019
2018-11-17 19:00,Biofarm Basket Poznań(d),94 : 83W,94,23,37,62.2,11,25,44.0,34,62,54.8,15,19,78.9,3,24,27,23,19,21,12,11,1,4,112,GKS Tychy,Sezon 2018/2019
2018-11-24 18:00,Energa Kotwica Kołobrzeg(w),99 : 84P,84,14,27,51.9,16,28,57.1,30,55,54.5,8,18,44.4,8,15,23,19,24,20,16,6,0,0,81,GKS Tychy,Sezon 2018/2019
2018-12-01 18:00,Pogoń Prudnik(d),91 : 68W,91,20,38,52.6,9,24,37.5,29,62,46.8,24,27,88.9,7,26,33,19,28,25,12,12,0,1,107,GKS Tychy,Sezon 2018/2019
2018-12-08 18:00,STK Czarni Słupsk(w),72 : 76W,76,21,40,52.5,8,24,33.3,29,64,45.3,10,26,38.5,8,25,33,12,22,23,7,9,0,3,72,GKS Tychy,Sezon 2018/2019
2018-12-15 18:00,Enea Astoria Bydgoszcz(d),76 : 78P,76,22,36,61.1,9,27,33.3,31,63,49.2,5,6,83.3,6,26,32,18,24,17,17,8,0,3,84,GKS Tychy,Sezon 2018/2019
2018-12-21 18:00,WKK Wrocław(w),74 : 67P,67,18,38,47.4,8,33,24.2,26,71,36.6,7,8,87.5,11,32,43,18,25,19,11,4,0,2,75,GKS Tychy,Sezon 2018/2019
2019-01-05 17:30,Rawlplug Sokół Łańcut(w),89 : 97W,97,21,45,46.7,14,28,50.0,35,73,47.9,13,15,86.7,10,24,34,26,24,17,7,7,0,3,117,GKS Tychy,Sezon 2018/2019
2019-01-12 19:00,Polfarmex Kutno(d),115 : 74W,115,33,48,68.8,10,15,66.7,43,63,68.3,19,25,76.0,8,26,34,25,19,26,12,12,6,0,154,GKS Tychy,Sezon 2018/2019
2019-01-19 18:30,Elektrobud-Investment ZB Pruszków(w),67 : 65P,65,14,29,48.3,9,22,40.9,23,51,45.1,10,17,58.8,4,24,28,15,18,21,12,5,0,3,66,GKS Tychy,Sezon 2018/2019
2019-01-23 19:00,FutureNet Śląsk Wrocław(d),97 : 84W,97,26,46,56.5,9,21,42.9,35,67,52.2,18,25,72.0,5,33,38,19,26,25,9,6,3,3,115,GKS Tychy,Sezon 2018/2019
2019-01-26 18:00,Jamalex Polonia 1912 Leszno(w),101 : 97P,97,21,38,55.3,10,19,52.6,31,57,54.4,25,30,83.3,3,24,27,18,30,26,12,3,1,0,103,GKS Tychy,Sezon 2018/2019
2019-02-02 15:00,SKK Siedlce(w),89 : 71P,71,19,40,47.5,6,30,20.0,25,70,35.7,15,22,68.2,6,23,29,22,20,19,11,10,2,5,71,GKS Tychy,Sezon 2018/2019
2019-02-09 18:00,KS Księżak Syntex Łowicz(d),95 : 77W,95,29,49,59.2,8,21,38.1,37,70,52.9,13,18,72.2,11,27,38,17,23,18,11,5,5,0,111,GKS Tychy,Sezon 2018/2019
2019-02-13 18:00,AZS AGH Kraków(w),76 : 90W,90,24,46,52.2,9,19,47.4,33,65,50.8,15,24,62.5,6,18,24,22,23,21,8,9,1,3,97,GKS Tychy,Sezon 2018/2019
2019-02-16 19:00,Górnik Trans.eu Wałbrzych(d),88 : 87W,88,19,34,55.9,13,31,41.9,32,65,49.2,11,11,100.0,5,20,25,20,24,17,11,6,1,4,96,GKS Tychy,Sezon 2018/2019
2019-02-23 15:30,Biofarm Basket Poznań(w),82 : 75P,75,11,34,32.4,12,35,34.3,23,69,33.3,17,23,73.9,13,21,34,12,24,25,11,4,0,4,62,GKS Tychy,Sezon 2018/2019
2019-03-02 18:00,Energa Kotwica Kołobrzeg(d),94 : 85W,94,20,31,64.5,10,33,30.3,30,64,46.9,24,28,85.7,7,19,26,17,22,27,11,7,0,1,95,GKS Tychy,Sezon 2018/2019
2019-03-10 17:00,Pogoń Prudnik(w),107 : 88P,88,20,41,48.8,11,28,39.3,31,69,44.9,15,24,62.5,11,16,27,21,21,21,8,3,1,1,85,GKS Tychy,Sezon 2018/2019
2019-03-16 18:00,STK Czarni Słupsk(d),102 : 103P,102,19,33,57.6,12,25,48.0,31,58,53.4,28,31,90.3,4,20,24,20,19,25,9,6,0,1,113,GKS Tychy,Sezon 2018/2019
2019-03-23 17:00,Enea Astoria Bydgoszcz(w),92 : 82P,82,17,35,48.6,11,32,34.4,28,67,41.8,15,22,68.2,8,19,27,18,21,22,8,6,1,6,80,GKS Tychy,Sezon 2018/2019
2019-03-30 18:00,WKK Wrocław(d),80 : 58W,80,22,35,62.9,10,29,34.5,32,64,50.0,6,8,75.0,7,33,40,16,21,10,14,4,3,4,95,GKS Tychy,Sezon 2018/2019
2019-04-06 17:30,Rawlplug Sokół Łańcut(w),90 : 81P,81,16,27,59.3,12,33,36.4,28,60,46.7,13,18,72.2,3,22,25,14,24,18,9,7,0,2,81,GKS Tychy,Sezon 2018/2019
2019-04-07 17:30,Rawlplug Sokół Łańcut(w),83 : 79P,79,18,34,52.9,12,29,41.4,30,63,47.6,7,11,63.6,3,19,22,20,21,13,10,8,0,4,82,GKS Tychy,Sezon 2018/2019
2019-04-13 18:00,Rawlplug Sokół Łańcut(d),95 : 91W,95,21,43,48.8,10,29,34.5,31,72,43.1,23,24,95.8,13,23,36,13,26,23,8,5,0,2,99,GKS Tychy,Sezon 2018/2019
2019-04-14 18:00,Rawlplug Sokół Łańcut(d),89 : 103P,89,19,34,55.9,13,29,44.8,32,63,50.8,12,12,100.0,5,19,24,22,28,13,13,4,0,2,95,GKS Tychy,Sezon 2018/2019
2018-09-29 19:00,Pogoń Prudnik(d),82 : 76W,82,27,46,58.7,5,23,21.7,32,69,46.4,13,25,52.0,15,26,41,14,19,24,9,11,1,2,91,Górnik Trans.eu Wałbrzych,Sezon 2018/2019
2018-10-07 18:00,STK Czarni Słupsk(w),77 : 66P,66,24,44,54.5,3,13,23.1,27,57,47.4,9,14,64.3,10,25,35,14,16,18,19,7,5,2,73,Górnik Trans.eu Wałbrzych,Sezon 2018/2019
2018-10-13 18:30,Enea Astoria Bydgoszcz(d),76 : 66W,76,24,42,57.1,4,18,22.2,28,60,46.7,16,25,64.0,12,27,39,21,24,26,18,15,4,0,96,Górnik Trans.eu Wałbrzych,Sezon 2018/2019
2018-10-17 17:00,WKK Wrocław(w),75 : 60P,60,23,46,50.0,2,23,8.7,25,69,36.2,8,11,72.7,10,25,35,15,18,17,13,4,2,4,56,Górnik Trans.eu Wałbrzych,Sezon 2018/2019
2018-10-21 18:00,Rawlplug Sokół Łańcut(d),62 : 82P,62,22,43,51.2,3,25,12.0,25,68,36.8,9,22,40.9,15,26,41,18,16,20,10,6,3,2,64,Górnik Trans.eu Wałbrzych,Sezon 2018/2019
2018-10-27 17:30,Polfarmex Kutno(w),73 : 77W,77,17,32,53.1,8,16,50.0,25,48,52.1,19,32,59.4,7,32,39,19,18,25,20,7,6,3,92,Górnik Trans.eu Wałbrzych,Sezon 2018/2019
2018-11-02 19:00,Elektrobud-Investment ZB Pruszków(d),62 : 51W,62,16,38,42.1,5,17,29.4,21,55,38.2,15,22,68.2,13,30,43,13,19,21,19,8,3,1,69,Górnik Trans.eu Wałbrzych,Sezon 2018/2019
2018-11-07 19:30,FutureNet Śląsk Wrocław(w),91 : 78P,78,16,38,42.1,10,25,40.0,26,63,41.3,16,21,76.2,8,23,31,15,26,21,10,4,4,1,80,Górnik Trans.eu Wałbrzych,Sezon 2018/2019
2018-11-10 18:30,GKS Tychy(d),73 : 65W,73,20,36,55.6,4,22,18.2,24,58,41.4,21,31,67.7,15,28,43,15,25,27,13,7,5,0,86,Górnik Trans.eu Wałbrzych,Sezon 2018/2019
2018-11-17 18:00,SKK Siedlce(w),81 : 95W,95,27,48,56.3,10,21,47.6,37,69,53.6,11,14,78.6,11,28,39,30,27,17,15,7,2,2,123,Górnik Trans.eu Wałbrzych,Sezon 2018/2019
2018-11-24 19:00,KS Księżak Syntex Łowicz(d),68 : 72P,68,20,43,46.5,6,17,35.3,26,60,43.3,10,15,66.7,10,27,37,14,24,22,15,5,4,1,74,Górnik Trans.eu Wałbrzych,Sezon 2018/2019
2018-12-02 20:00,AZS AGH Kraków(w),68 : 73W,73,18,48,37.5,6,18,33.3,24,66,36.4,19,25,76.0,16,30,46,15,24,25,15,6,3,2,80,Górnik Trans.eu Wałbrzych,Sezon 2018/2019
2018-12-07 19:00,Jamalex Polonia 1912 Leszno(d),62 : 78P,62,13,31,41.9,8,26,30.8,21,57,36.8,12,16,75.0,10,26,36,17,18,16,16,2,5,2,66,Górnik Trans.eu Wałbrzych,Sezon 2018/2019
2018-12-15 16:00,Biofarm Basket Poznań(d),70 : 72P,70,15,33,45.5,7,24,29.2,22,57,38.6,19,28,67.9,14,31,45,13,21,22,18,5,4,4,75,Górnik Trans.eu Wałbrzych,Sezon 2018/2019
2018-12-21 18:30,Energa Kotwica Kołobrzeg(w),95 : 80P,80,15,32,46.9,10,25,40.0,25,57,43.9,20,30,66.7,9,27,36,19,22,22,12,3,2,3,86,Górnik Trans.eu Wałbrzych,Sezon 2018/2019
2019-01-05 17:30,Pogoń Prudnik(w),87 : 88W,88,24,45,53.3,8,23,34.8,32,68,47.1,16,23,69.6,11,29,40,14,27,22,12,4,2,1,93,Górnik Trans.eu Wałbrzych,Sezon 2018/2019
2019-01-13 19:00,STK Czarni Słupsk(d),64 : 74P,64,11,31,35.5,10,32,31.3,21,63,33.3,12,22,54.5,13,17,30,12,19,23,6,6,1,1,55,Górnik Trans.eu Wałbrzych,Sezon 2018/2019
2019-01-17 19:00,Enea Astoria Bydgoszcz(w),95 : 77P,77,18,41,43.9,10,26,38.5,28,67,41.8,11,13,84.6,8,20,28,22,23,17,19,8,2,2,77,Górnik Trans.eu Wałbrzych,Sezon 2018/2019
2019-01-23 19:00,WKK Wrocław(d),82 : 51W,82,18,39,46.2,11,24,45.8,29,63,46.0,13,18,72.2,12,43,55,20,17,16,15,5,4,1,112,Górnik Trans.eu Wałbrzych,Sezon 2018/2019
2019-01-26 17:30,Rawlplug Sokół Łańcut(w),68 : 74W,74,21,36,58.3,5,18,27.8,26,54,48.1,17,20,85.0,6,29,35,15,24,16,18,4,5,3,84,Górnik Trans.eu Wałbrzych,Sezon 2018/2019
2019-02-02 16:00,Polfarmex Kutno(d),82 : 63W,82,24,47,51.1,6,13,46.2,30,60,50.0,16,25,64.0,12,33,45,19,25,22,17,5,0,0,95,Górnik Trans.eu Wałbrzych,Sezon 2018/2019
2019-02-09 16:00,Elektrobud-Investment ZB Pruszków(w),73 : 68P,68,12,35,34.3,8,20,40.0,20,55,36.4,20,31,64.5,12,29,41,15,16,23,15,3,5,4,71,Górnik Trans.eu Wałbrzych,Sezon 2018/2019
2019-02-13 19:45,FutureNet Śląsk Wrocław(d),75 : 72W,75,23,57,40.4,5,18,27.8,28,75,37.3,14,24,58.3,17,29,46,16,22,23,8,6,5,3,83,Górnik Trans.eu Wałbrzych,Sezon 2018/2019
2019-02-16 19:00,GKS Tychy(w),88 : 87P,87,24,38,63.2,7,25,28.0,31,63,49.2,18,24,75.0,9,25,34,20,17,24,12,4,4,1,99,Górnik Trans.eu Wałbrzych,Sezon 2018/2019
2019-02-23 17:00,SKK Siedlce(d),80 : 70W,80,22,38,57.9,7,18,38.9,29,56,51.8,15,18,83.3,4,30,34,18,20,20,15,5,4,1,96,Górnik Trans.eu Wałbrzych,Sezon 2018/2019
2019-03-02 18:30,KS Księżak Syntex Łowicz(w),90 : 88P,88,18,31,58.1,12,26,46.2,30,57,52.6,16,22,72.7,8,26,34,22,26,22,15,9,2,2,107,Górnik Trans.eu Wałbrzych,Sezon 2018/2019
2019-03-09 16:00,AZS AGH Kraków(d),91 : 56W,91,26,42,61.9,8,15,53.3,34,57,59.6,15,28,53.6,11,37,48,23,24,23,17,9,5,0,123,Górnik Trans.eu Wałbrzych,Sezon 2018/2019
2019-03-16 17:00,Jamalex Polonia 1912 Leszno(w),76 : 88W,88,24,34,70.6,6,15,40.0,30,49,61.2,22,25,88.0,5,22,27,15,28,23,15,6,2,1,101,Górnik Trans.eu Wałbrzych,Sezon 2018/2019
2019-03-23 16:30,Biofarm Basket Poznań(w),79 : 55P,55,17,43,39.5,3,16,18.8,20,59,33.9,12,19,63.2,11,28,39,15,21,18,15,3,7,6,58,Górnik Trans.eu Wałbrzych,Sezon 2018/2019
2019-03-31 18:00,Energa Kotwica Kołobrzeg(d),70 : 68W,70,23,41,56.1,2,28,7.1,25,69,36.2,18,28,64.3,21,29,50,16,23,22,12,8,3,1,81,Górnik Trans.eu Wałbrzych,Sezon 2018/2019
2019-04-06 15:00,FutureNet Śląsk Wrocław(w),94 : 72P,72,16,39,41.0,7,28,25.0,23,67,34.3,19,26,73.1,16,23,39,8,25,26,11,6,2,4,65,Górnik Trans.eu Wałbrzych,Sezon 2018/2019
2019-04-07 15:00,FutureNet Śląsk Wrocław(w),94 : 85P,85,20,40,50.0,8,22,36.4,28,62,45.2,21,26,80.8,9,20,29,18,33,31,11,4,0,3,86,Górnik Trans.eu Wałbrzych,Sezon 2018/2019
2019-04-13 17:00,FutureNet Śląsk Wrocław(d),100 : 91W,100,26,41,63.4,10,20,50.0,36,61,59.0,18,27,66.7,7,31,38,20,27,23,18,7,6,1,119,Górnik Trans.eu Wałbrzych,Sezon 2018/2019
2019-04-14 17:00,FutureNet Śląsk Wrocław(d),65 : 86P,65,17,40,42.5,6,24,25.0,23,64,35.9,13,18,72.2,10,20,30,20,23,19,16,7,2,0,62,Górnik Trans.eu Wałbrzych,Sezon 2018/2019
2018-09-30 17:00,Elektrobud-Investment ZB Pruszków(d),70 : 63W,70,19,45,42.2,5,18,27.8,24,63,38.1,17,25,68.0,10,31,41,14,18,22,9,10,2,5,81,Jamalex Polonia 1912 Leszno,Sezon 2018/2019
2018-10-06 16:00,Energa Kotwica Kołobrzeg(w),56 : 76W,76,20,39,51.3,7,19,36.8,27,58,46.6,15,24,62.5,9,28,37,9,20,21,10,8,0,3,80,Jamalex Polonia 1912 Leszno,Sezon 2018/2019
2018-10-13 18:00,FutureNet Śląsk Wrocław(w),86 : 82P,82,16,39,41.0,11,27,40.7,27,66,40.9,17,28,60.7,9,23,32,13,34,26,11,7,0,4,73,Jamalex Polonia 1912 Leszno,Sezon 2018/2019
2018-10-17 20:00,Pogoń Prudnik(d),103 : 64W,103,24,36,66.7,15,31,48.4,39,67,58.2,10,14,71.4,9,31,40,27,19,18,9,7,0,3,136,Jamalex Polonia 1912 Leszno,Sezon 2018/2019
2018-10-20 18:00,GKS Tychy(w),80 : 83W,83,21,41,51.2,5,19,26.3,26,60,43.3,26,32,81.3,11,24,35,9,21,22,9,6,0,2,84,Jamalex Polonia 1912 Leszno,Sezon 2018/2019
2018-10-28 19:00,STK Czarni Słupsk(d),79 : 66W,79,18,41,43.9,9,28,32.1,27,69,39.1,16,25,64.0,10,22,32,14,19,22,9,11,1,3,77,Jamalex Polonia 1912 Leszno,Sezon 2018/2019
2018-11-04 18:00,SKK Siedlce(w),85 : 78P,78,10,31,32.3,12,31,38.7,22,62,35.5,22,26,84.6,8,22,30,17,19,24,10,8,1,4,80,Jamalex Polonia 1912 Leszno,Sezon 2018/2019
2018-11-07 20:00,Enea Astoria Bydgoszcz(d),72 : 58W,72,17,38,44.7,8,23,34.8,25,61,41.0,14,23,60.9,10,24,34,21,20,21,12,8,2,1,80,Jamalex Polonia 1912 Leszno,Sezon 2018/2019
2018-11-10 18:30,KS Księżak Syntex Łowicz(w),97 : 80P,80,24,42,57.1,4,16,25.0,28,58,48.3,20,22,90.9,6,17,23,12,24,22,14,7,1,0,77,Jamalex Polonia 1912 Leszno,Sezon 2018/2019
2018-11-17 18:00,WKK Wrocław(d),72 : 64W,72,15,45,33.3,10,30,33.3,25,75,33.3,12,17,70.6,16,29,45,15,19,23,9,9,3,9,80,Jamalex Polonia 1912 Leszno,Sezon 2018/2019
2018-11-24 18:30,AZS AGH Kraków(w),95 : 75P,75,19,44,43.2,5,17,29.4,24,61,39.3,22,38,57.9,9,21,30,14,21,29,14,7,2,2,61,Jamalex Polonia 1912 Leszno,Sezon 2018/2019
2018-12-01 18:00,Rawlplug Sokół Łańcut(d),85 : 74W,85,21,36,58.3,11,23,47.8,32,59,54.2,10,11,90.9,10,22,32,23,23,16,11,5,1,2,107,Jamalex Polonia 1912 Leszno,Sezon 2018/2019
2018-12-07 19:00,Górnik Trans.eu Wałbrzych(w),62 : 78W,78,21,44,47.7,8,21,38.1,29,65,44.6,12,17,70.6,9,24,33,16,17,18,5,7,2,5,90,Jamalex Polonia 1912 Leszno,Sezon 2018/2019
2018-12-15 18:00,Polfarmex Kutno(d),86 : 84W,86,23,41,56.1,7,19,36.8,30,60,50.0,19,21,90.5,5,25,30,15,17,19,10,10,1,0,100,Jamalex Polonia 1912 Leszno,Sezon 2018/2019
2018-12-22 17:00,Biofarm Basket Poznań(w),78 : 65P,65,17,40,42.5,7,23,30.4,24,63,38.1,10,10,100.0,7,23,30,7,19,13,13,5,2,6,57,Jamalex Polonia 1912 Leszno,Sezon 2018/2019
2019-01-06 17:00,Elektrobud-Investment ZB Pruszków(w),65 : 73W,73,15,35,42.9,8,20,40.0,23,55,41.8,19,23,82.6,5,29,34,15,19,21,18,5,0,4,73,Jamalex Polonia 1912 Leszno,Sezon 2018/2019
2019-01-12 18:00,Energa Kotwica Kołobrzeg(d),88 : 77W,88,17,34,50.0,15,28,53.6,32,62,51.6,9,19,47.4,12,28,40,16,20,19,18,9,3,0,98,Jamalex Polonia 1912 Leszno,Sezon 2018/2019
2019-01-19 18:00,FutureNet Śląsk Wrocław(d),88 : 102P,88,16,43,37.2,13,23,56.5,29,66,43.9,17,30,56.7,11,19,30,14,19,25,10,5,1,0,78,Jamalex Polonia 1912 Leszno,Sezon 2018/2019
2019-01-23 18:30,Pogoń Prudnik(w),78 : 72P,72,16,35,45.7,8,21,38.1,24,56,42.9,16,20,80.0,6,22,28,13,28,23,15,7,3,4,72,Jamalex Polonia 1912 Leszno,Sezon 2018/2019
2019-01-26 18:00,GKS Tychy(d),101 : 97W,101,20,35,57.1,11,22,50.0,31,57,54.4,28,36,77.8,8,22,30,22,26,30,11,5,0,1,113,Jamalex Polonia 1912 Leszno,Sezon 2018/2019
2019-02-02 18:00,STK Czarni Słupsk(w),88 : 67P,67,22,45,48.9,5,19,26.3,27,64,42.2,8,19,42.1,15,13,28,14,19,18,11,4,1,5,55,Jamalex Polonia 1912 Leszno,Sezon 2018/2019
2019-02-09 19:00,SKK Siedlce(d),81 : 86P,81,23,46,50.0,6,28,21.4,29,74,39.2,17,25,68.0,17,21,38,15,22,22,7,10,0,2,84,Jamalex Polonia 1912 Leszno,Sezon 2018/2019
2019-02-13 19:00,Enea Astoria Bydgoszcz(w),94 : 84P,84,18,41,43.9,11,21,52.4,29,62,46.8,15,21,71.4,8,20,28,18,21,15,7,7,1,6,92,Jamalex Polonia 1912 Leszno,Sezon 2018/2019
2019-02-16 18:00,KS Księżak Syntex Łowicz(d),88 : 76W,88,26,51,51.0,9,20,45.0,35,71,49.3,9,10,90.0,12,22,34,12,23,18,11,11,0,1,97,Jamalex Polonia 1912 Leszno,Sezon 2018/2019
2019-02-23 18:00,WKK Wrocław(w),81 : 71P,71,19,37,51.4,6,25,24.0,25,62,40.3,15,18,83.3,12,15,27,10,25,20,13,6,1,3,62,Jamalex Polonia 1912 Leszno,Sezon 2018/2019
2019-03-09 17:30,Rawlplug Sokół Łańcut(w),86 : 82P,82,16,28,57.1,14,30,46.7,30,58,51.7,8,14,57.1,8,20,28,9,24,18,13,6,1,1,79,Jamalex Polonia 1912 Leszno,Sezon 2018/2019
2019-03-13 20:00,AZS AGH Kraków(d),94 : 55W,94,30,54,55.6,5,20,25.0,35,74,47.3,19,25,76.0,19,27,46,19,19,26,11,12,1,3,116,Jamalex Polonia 1912 Leszno,Sezon 2018/2019
2019-03-16 17:00,Górnik Trans.eu Wałbrzych(d),76 : 88P,76,16,34,47.1,8,25,32.0,24,59,40.7,20,28,71.4,10,14,24,17,23,27,11,6,1,2,70,Jamalex Polonia 1912 Leszno,Sezon 2018/2019
2019-03-23 17:30,Polfarmex Kutno(w),73 : 71P,71,24,40,60.0,4,22,18.2,28,62,45.2,11,21,52.4,10,29,39,11,20,18,19,10,2,4,70,Jamalex Polonia 1912 Leszno,Sezon 2018/2019
2019-03-31 18:00,Biofarm Basket Poznań(d),86 : 96P,86,18,38,47.4,11,34,32.4,29,72,40.3,17,25,68.0,14,20,34,10,24,22,14,5,1,1,71,Jamalex Polonia 1912 Leszno,Sezon 2018/2019
2018-09-29 18:30,Enea Astoria Bydgoszcz(d),73 : 84P,73,21,39,53.8,5,18,27.8,26,57,45.6,16,20,80.0,5,17,22,10,23,21,13,4,4,1,65,KS Księżak Syntex Łowicz,Sezon 2018/2019
2018-10-06 17:00,WKK Wrocław(w),91 : 76P,76,16,41,39.0,10,26,38.5,26,67,38.8,14,18,77.8,11,25,36,17,20,22,18,2,2,6,70,KS Księżak Syntex Łowicz,Sezon 2018/2019
2018-10-13 18:30,Rawlplug Sokół Łańcut(d),85 : 109P,85,18,31,58.1,11,28,39.3,29,59,49.2,16,18,88.9,5,15,20,24,29,16,13,6,2,0,92,KS Księżak Syntex Łowicz,Sezon 2018/2019
2018-10-17 18:00,Polfarmex Kutno(w),76 : 59P,59,12,35,34.3,7,19,36.8,19,54,35.2,14,18,77.8,4,11,15,12,18,16,17,12,1,4,43,KS Księżak Syntex Łowicz,Sezon 2018/2019
2018-10-20 18:30,Elektrobud-Investment ZB Pruszków(d),70 : 56W,70,22,38,57.9,4,20,20.0,26,58,44.8,14,16,87.5,6,30,36,20,20,15,13,5,2,1,86,KS Księżak Syntex Łowicz,Sezon 2018/2019
2018-10-27 19:30,FutureNet Śląsk Wrocław(d),77 : 100P,77,25,47,53.2,6,19,31.6,31,66,47.0,9,13,69.2,6,18,24,13,26,15,12,5,2,1,70,KS Księżak Syntex Łowicz,Sezon 2018/2019
2018-11-03 18:30,GKS Tychy(d),75 : 82P,75,20,35,57.1,10,23,43.5,30,58,51.7,5,13,38.5,11,16,27,21,20,20,11,6,1,0,83,KS Księżak Syntex Łowicz,Sezon 2018/2019
2018-11-07 18:00,SKK Siedlce(w),104 : 81P,81,12,40,30.0,13,30,43.3,25,70,35.7,18,25,72.0,13,17,30,24,19,23,13,11,0,3,81,KS Księżak Syntex Łowicz,Sezon 2018/2019
2018-11-10 18:30,Jamalex Polonia 1912 Leszno(d),97 : 80W,97,28,40,70.0,8,20,40.0,36,60,60.0,17,22,77.3,8,24,32,18,22,23,12,9,0,1,115,KS Księżak Syntex Łowicz,Sezon 2018/2019
2018-11-17 18:30,AZS AGH Kraków(d),94 : 89W,94,28,43,65.1,9,21,42.9,37,64,57.8,11,17,64.7,8,22,30,19,23,20,11,6,0,1,105,KS Księżak Syntex Łowicz,Sezon 2018/2019
2018-11-24 19:00,Górnik Trans.eu Wałbrzych(w),68 : 72W,72,14,40,35.0,8,22,36.4,22,62,35.5,20,24,83.3,9,21,30,17,22,24,10,9,1,4,75,KS Księżak Syntex Łowicz,Sezon 2018/2019
2018-12-01 18:30,Biofarm Basket Poznań(d),85 : 82W,85,24,38,63.2,5,20,25.0,29,58,50.0,22,25,88.0,8,26,34,13,21,26,16,8,1,1,93,KS Księżak Syntex Łowicz,Sezon 2018/2019
2018-12-08 18:00,Energa Kotwica Kołobrzeg(w),98 : 66P,66,14,42,33.3,9,27,33.3,23,69,33.3,11,16,68.8,6,19,25,9,24,18,11,4,0,3,42,KS Księżak Syntex Łowicz,Sezon 2018/2019
2018-12-15 18:30,Pogoń Prudnik(d),89 : 80W,89,20,31,64.5,9,25,36.0,29,56,51.8,22,30,73.3,9,32,41,16,21,26,18,6,1,0,100,KS Księżak Syntex Łowicz,Sezon 2018/2019
2018-12-22 18:00,STK Czarni Słupsk(w),96 : 73P,73,19,37,51.4,10,27,37.0,29,64,45.3,5,9,55.6,8,18,26,20,18,12,10,6,2,2,78,KS Księżak Syntex Łowicz,Sezon 2018/2019
2019-01-05 17:00,Enea Astoria Bydgoszcz(w),100 : 73P,73,13,37,35.1,12,28,42.9,25,65,38.5,11,16,68.8,9,14,23,18,23,16,11,4,0,3,62,KS Księżak Syntex Łowicz,Sezon 2018/2019
2019-01-12 18:30,WKK Wrocław(d),96 : 84W,96,23,36,63.9,15,33,45.5,38,69,55.1,5,7,71.4,8,16,24,23,18,10,13,12,1,2,110,KS Księżak Syntex Łowicz,Sezon 2018/2019
2019-01-19 17:30,Rawlplug Sokół Łańcut(w),86 : 68P,68,14,35,40.0,7,19,36.8,21,54,38.9,19,27,70.4,7,24,31,12,19,24,13,4,1,2,62,KS Księżak Syntex Łowicz,Sezon 2018/2019
2019-01-23 19:30,Polfarmex Kutno(d),91 : 79W,91,32,51,62.7,6,14,42.9,38,65,58.5,9,13,69.2,11,28,39,17,15,19,15,4,4,2,109,KS Księżak Syntex Łowicz,Sezon 2018/2019
2019-01-27 17:00,Elektrobud-Investment ZB Pruszków(w),64 : 58P,58,16,36,44.4,5,22,22.7,21,58,36.2,11,16,68.8,10,24,34,12,19,19,16,4,2,3,52,KS Księżak Syntex Łowicz,Sezon 2018/2019
2019-02-02 18:00,FutureNet Śląsk Wrocław(w),123 : 88P,88,26,53,49.1,7,19,36.8,33,72,45.8,15,18,83.3,7,12,19,19,22,20,12,7,3,7,82,KS Księżak Syntex Łowicz,Sezon 2018/2019
2019-02-09 18:00,GKS Tychy(w),95 : 77P,77,20,37,54.1,8,27,29.6,28,64,43.8,13,19,68.4,9,16,25,17,18,23,11,5,0,5,71,KS Księżak Syntex Łowicz,Sezon 2018/2019
2019-02-13 18:30,SKK Siedlce(d),103 : 84W,103,26,42,61.9,11,31,35.5,37,73,50.7,18,23,78.3,17,28,45,20,19,24,8,5,3,1,127,KS Księżak Syntex Łowicz,Sezon 2018/2019
2019-02-16 18:00,Jamalex Polonia 1912 Leszno(w),88 : 76P,76,20,43,46.5,7,15,46.7,27,58,46.6,15,21,71.4,9,19,28,10,18,23,18,6,1,0,66,KS Księżak Syntex Łowicz,Sezon 2018/2019
2019-02-23 19:30,AZS AGH Kraków(w),84 : 81P,81,22,39,56.4,7,25,28.0,29,64,45.3,16,21,76.2,13,25,38,16,20,22,15,4,2,6,86,KS Księżak Syntex Łowicz,Sezon 2018/2019
2019-03-02 18:30,Górnik Trans.eu Wałbrzych(d),90 : 88W,90,16,32,50.0,12,31,38.7,28,63,44.4,22,28,78.6,9,20,29,20,22,26,9,7,2,2,98,KS Księżak Syntex Łowicz,Sezon 2018/2019
2019-03-09 17:00,Biofarm Basket Poznań(w),81 : 74P,74,18,36,50.0,7,28,25.0,25,64,39.1,17,22,77.3,4,24,28,13,25,19,9,6,2,7,70,KS Księżak Syntex Łowicz,Sezon 2018/2019
2019-03-16 18:30,Energa Kotwica Kołobrzeg(d),76 : 86P,76,19,31,61.3,9,40,22.5,28,71,39.4,11,12,91.7,19,21,40,15,22,18,16,5,3,1,79,KS Księżak Syntex Łowicz,Sezon 2018/2019
2019-03-23 17:30,Pogoń Prudnik(w),89 : 84P,84,20,35,57.1,8,31,25.8,28,66,42.4,20,22,90.9,5,21,26,13,24,20,10,6,2,1,81,KS Księżak Syntex Łowicz,Sezon 2018/2019
2019-03-31 18:00,STK Czarni Słupsk(d),76 : 91P,76,18,28,64.3,8,20,40.0,26,48,54.2,16,19,84.2,4,16,20,16,17,21,20,8,2,0,77,KS Księżak Syntex Łowicz,Sezon 2018/2019
2019-04-06 18:00,Elektrobud-Investment ZB Pruszków(w),83 : 75P,75,24,44,54.5,5,17,29.4,29,61,47.5,12,20,60.0,10,20,30,12,21,19,10,6,2,3,75,KS Księżak Syntex Łowicz,Sezon 2018/2019
2019-04-07 18:00,Elektrobud-Investment ZB Pruszków(w),77 : 67P,67,16,33,48.5,8,23,34.8,24,56,42.9,11,16,68.8,9,21,30,19,18,20,13,3,0,2,69,KS Księżak Syntex Łowicz,Sezon 2018/2019
2019-04-13 18:00,Elektrobud-Investment ZB Pruszków(d),83 : 77W,83,25,35,71.4,4,15,26.7,29,50,58.0,21,24,87.5,3,23,26,18,16,25,15,10,2,2,100,KS Księżak Syntex Łowicz,Sezon 2018/2019
2019-04-14 18:00,Elektrobud-Investment ZB Pruszków(d),54 : 71P,54,16,38,42.1,3,20,15.0,19,58,32.8,13,14,92.9,8,28,36,11,21,22,16,7,2,4,54,KS Księżak Syntex Łowicz,Sezon 2018/2019
2018-09-29 19:00,Górnik Trans.eu Wałbrzych(w),82 : 76P,76,11,22,50.0,15,33,45.5,26,55,47.3,9,12,75.0,4,28,32,17,25,19,16,5,2,1,84,Pogoń Prudnik,Sezon 2018/2019
2018-10-06 17:30,Biofarm Basket Poznań(d),92 : 80W,92,25,52,48.1,7,20,35.0,32,72,44.4,21,24,87.5,9,26,35,21,24,20,11,16,1,4,111,Pogoń Prudnik,Sezon 2018/2019
2018-10-13 17:30,Energa Kotwica Kołobrzeg(d),82 : 79W,82,19,35,54.3,9,21,42.9,28,56,50.0,17,25,68.0,7,25,32,14,17,20,12,8,6,1,94,Pogoń Prudnik,Sezon 2018/2019
2018-10-17 20:00,Jamalex Polonia 1912 Leszno(w),103 : 64P,64,19,34,55.9,5,30,16.7,24,64,37.5,11,14,78.6,9,16,25,11,18,19,15,5,3,0,50,Pogoń Prudnik,Sezon 2018/2019
2018-10-21 17:00,STK Czarni Słupsk(d),83 : 93P,83,21,39,53.8,7,23,30.4,28,62,45.2,20,23,87.0,8,21,29,14,26,25,14,7,0,1,82,Pogoń Prudnik,Sezon 2018/2019
2018-10-27 17:00,Enea Astoria Bydgoszcz(w),89 : 78P,78,16,41,39.0,11,28,39.3,27,69,39.1,13,18,72.2,9,17,26,21,23,20,16,9,0,5,71,Pogoń Prudnik,Sezon 2018/2019
2018-11-03 17:30,WKK Wrocław(d),87 : 79W,87,19,34,55.9,12,25,48.0,31,59,52.5,13,14,92.9,3,28,31,19,16,19,16,9,2,2,103,Pogoń Prudnik,Sezon 2018/2019
2018-11-07 18:00,Rawlplug Sokół Łańcut(w),98 : 89P,89,21,41,51.2,8,25,32.0,29,66,43.9,23,26,88.5,9,20,29,16,29,21,10,7,0,3,91,Pogoń Prudnik,Sezon 2018/2019
2018-11-11 17:00,Polfarmex Kutno(d),89 : 66W,89,25,40,62.5,5,18,27.8,30,58,51.7,24,27,88.9,8,21,29,18,17,24,13,9,0,1,101,Pogoń Prudnik,Sezon 2018/2019
2018-11-17 18:00,Elektrobud-Investment ZB Pruszków(w),75 : 88W,88,21,35,60.0,12,23,52.2,33,58,56.9,10,13,76.9,3,27,30,18,19,16,14,9,0,2,103,Pogoń Prudnik,Sezon 2018/2019
2018-11-24 17:30,FutureNet Śląsk Wrocław(d),87 : 80W,87,26,52,50.0,6,23,26.1,32,75,42.7,17,22,77.3,11,23,34,10,26,23,7,8,3,1,87,Pogoń Prudnik,Sezon 2018/2019
2018-12-01 18:00,GKS Tychy(w),91 : 68P,68,17,37,45.9,3,23,13.0,20,60,33.3,25,28,89.3,8,25,33,6,25,28,17,9,1,0,57,Pogoń Prudnik,Sezon 2018/2019
2018-12-08 17:30,SKK Siedlce(d),98 : 85W,98,14,29,48.3,14,28,50.0,28,57,49.1,28,35,80.0,7,24,31,21,20,29,13,3,5,3,109,Pogoń Prudnik,Sezon 2018/2019
2018-12-15 18:30,KS Księżak Syntex Łowicz(w),89 : 80P,80,15,33,45.5,10,30,33.3,25,63,39.7,20,24,83.3,5,21,26,14,26,21,9,11,0,1,80,Pogoń Prudnik,Sezon 2018/2019
2018-12-22 17:30,AZS AGH Kraków(d),102 : 81W,102,31,43,72.1,7,25,28.0,38,68,55.9,19,24,79.2,6,24,30,24,21,28,10,14,0,1,125,Pogoń Prudnik,Sezon 2018/2019
2019-01-05 17:30,Górnik Trans.eu Wałbrzych(d),87 : 88P,87,19,35,54.3,10,26,38.5,29,61,47.5,19,24,79.2,2,20,22,22,22,27,8,6,1,2,93,Pogoń Prudnik,Sezon 2018/2019
2019-01-12 17:00,Biofarm Basket Poznań(w),93 : 86P,86,16,36,44.4,12,31,38.7,28,67,41.8,18,24,75.0,5,25,30,14,24,22,9,5,2,2,83,Pogoń Prudnik,Sezon 2018/2019
2019-01-19 18:00,Energa Kotwica Kołobrzeg(w),87 : 81P,81,18,37,48.6,9,26,34.6,27,63,42.9,18,22,81.8,4,28,32,18,23,25,14,7,1,2,85,Pogoń Prudnik,Sezon 2018/2019
2019-01-23 18:30,Jamalex Polonia 1912 Leszno(d),78 : 72W,78,29,55,52.7,3,11,27.3,32,66,48.5,11,17,64.7,11,22,33,15,23,28,11,6,4,3,85,Pogoń Prudnik,Sezon 2018/2019
2019-01-26 18:00,STK Czarni Słupsk(w),67 : 59P,59,18,31,58.1,5,31,16.1,23,62,37.1,8,12,66.7,2,25,27,10,20,17,9,6,2,3,52,Pogoń Prudnik,Sezon 2018/2019
2019-02-02 17:30,Enea Astoria Bydgoszcz(d),103 : 89W,103,22,34,64.7,12,23,52.2,34,57,59.6,23,27,85.2,5,22,27,22,22,23,15,5,0,2,115,Pogoń Prudnik,Sezon 2018/2019
2019-02-10 18:00,WKK Wrocław(w),70 : 67P,67,11,29,37.9,12,33,36.4,23,62,37.1,9,10,90.0,8,33,41,19,22,19,17,2,2,2,74,Pogoń Prudnik,Sezon 2018/2019
2019-02-13 18:30,Rawlplug Sokół Łańcut(d),95 : 88W,95,24,31,77.4,12,24,50.0,36,55,65.5,11,13,84.6,5,24,29,24,29,17,20,8,0,1,115,Pogoń Prudnik,Sezon 2018/2019
2019-02-16 17:30,Polfarmex Kutno(w),82 : 76P,76,23,44,52.3,6,28,21.4,29,72,40.3,12,19,63.2,11,31,42,20,22,18,17,7,1,2,79,Pogoń Prudnik,Sezon 2018/2019
2019-02-23 17:30,Elektrobud-Investment ZB Pruszków(d),85 : 83W,85,21,39,53.8,7,22,31.8,28,61,45.9,22,27,81.5,5,25,30,20,16,24,9,2,2,1,92,Pogoń Prudnik,Sezon 2018/2019
2019-03-01 20:00,FutureNet Śląsk Wrocław(w),98 : 75P,75,27,45,60.0,2,21,9.5,29,66,43.9,15,22,68.2,12,22,34,14,15,24,14,7,6,1,78,Pogoń Prudnik,Sezon 2018/2019
2019-03-10 17:00,GKS Tychy(d),107 : 88W,107,26,35,74.3,12,25,48.0,38,60,63.3,19,24,79.2,6,25,31,26,21,21,11,3,1,1,130,Pogoń Prudnik,Sezon 2018/2019
2019-03-16 13:00,SKK Siedlce(w),74 : 96W,96,30,43,69.8,8,23,34.8,38,66,57.6,12,17,70.6,7,26,33,25,18,19,7,9,4,3,127,Pogoń Prudnik,Sezon 2018/2019
2019-03-23 17:30,KS Księżak Syntex Łowicz(d),89 : 84W,89,24,39,61.5,7,27,25.9,31,66,47.0,20,22,90.9,13,32,45,15,20,24,14,7,1,2,106,Pogoń Prudnik,Sezon 2018/2019
2019-03-31 18:00,AZS AGH Kraków(w),76 : 65P,65,16,33,48.5,5,26,19.2,21,59,35.6,18,23,78.3,9,30,39,20,19,22,16,4,1,2,70,Pogoń Prudnik,Sezon 2018/2019
2018-09-30 19:00,FutureNet Śląsk Wrocław(w),87 : 77P,77,16,44,36.4,7,17,41.2,23,61,37.7,24,28,85.7,11,19,30,20,27,21,14,5,4,2,80,Polfarmex Kutno,Sezon 2018/2019
2018-10-07 17:30,GKS Tychy(d),61 : 75P,61,13,33,39.4,8,23,34.8,21,56,37.5,11,19,57.9,6,20,26,19,23,17,15,11,4,2,63,Polfarmex Kutno,Sezon 2018/2019
2018-10-13 18:00,SKK Siedlce(w),72 : 86W,86,16,32,50.0,10,26,38.5,26,58,44.8,24,28,85.7,7,27,34,23,22,20,17,10,2,2,102,Polfarmex Kutno,Sezon 2018/2019
2018-10-17 18:00,KS Księżak Syntex Łowicz(d),76 : 59W,76,21,32,65.6,7,16,43.8,28,48,58.3,13,16,81.3,5,26,31,22,16,18,18,10,4,1,102,Polfarmex Kutno,Sezon 2018/2019
2018-10-20 19:30,AZS AGH Kraków(w),75 : 86W,86,22,49,44.9,7,15,46.7,29,64,45.3,21,24,87.5,12,23,35,15,26,23,20,11,1,2,90,Polfarmex Kutno,Sezon 2018/2019
2018-10-27 17:30,Górnik Trans.eu Wałbrzych(d),73 : 77P,73,17,44,38.6,9,25,36.0,26,69,37.7,13,20,65.0,8,18,26,21,26,18,10,11,3,6,74,Polfarmex Kutno,Sezon 2018/2019
2018-11-03 17:00,Biofarm Basket Poznań(w),70 : 73W,73,22,45,48.9,6,20,30.0,28,65,43.1,11,20,55.0,11,17,28,16,22,18,6,7,0,4,72,Polfarmex Kutno,Sezon 2018/2019
2018-11-07 18:00,Energa Kotwica Kołobrzeg(d),87 : 85W,87,18,42,42.9,9,22,40.9,27,64,42.2,24,32,75.0,9,20,29,27,20,24,9,9,8,5,106,Polfarmex Kutno,Sezon 2018/2019
2018-11-11 17:00,Pogoń Prudnik(w),89 : 66P,66,17,34,50.0,8,26,30.8,25,60,41.7,8,12,66.7,7,17,24,16,24,17,20,7,1,0,55,Polfarmex Kutno,Sezon 2018/2019
2018-11-17 17:30,STK Czarni Słupsk(d),79 : 81P,79,18,37,48.6,9,31,29.0,27,68,39.7,16,22,72.7,9,27,36,18,21,17,12,12,2,2,88,Polfarmex Kutno,Sezon 2018/2019
2018-11-24 17:00,Enea Astoria Bydgoszcz(w),88 : 69P,69,18,33,54.5,7,29,24.1,25,62,40.3,12,14,85.7,9,19,28,22,26,16,16,5,1,1,70,Polfarmex Kutno,Sezon 2018/2019
2018-12-01 17:30,WKK Wrocław(d),82 : 69W,82,27,57,47.4,6,27,22.2,33,84,39.3,10,17,58.8,15,34,49,24,18,18,5,9,1,6,102,Polfarmex Kutno,Sezon 2018/2019
2018-12-08 17:30,Rawlplug Sokół Łańcut(w),84 : 77P,77,20,45,44.4,9,20,45.0,29,65,44.6,10,17,58.8,7,17,24,17,28,20,12,8,0,3,71,Polfarmex Kutno,Sezon 2018/2019
2018-12-15 18:00,Jamalex Polonia 1912 Leszno(w),86 : 84P,84,20,42,47.6,11,29,37.9,31,71,43.7,11,13,84.6,13,22,35,14,19,17,12,6,0,1,85,Polfarmex Kutno,Sezon 2018/2019
2018-12-22 17:30,Elektrobud-Investment ZB Pruszków(d),82 : 87P,82,21,34,61.8,8,22,36.4,29,56,51.8,16,20,80.0,5,20,25,27,15,21,13,7,5,2,102,Polfarmex Kutno,Sezon 2018/2019
2019-01-05 17:30,FutureNet Śląsk Wrocław(d),63 : 90P,63,14,43,32.6,8,30,26.7,22,73,30.1,11,15,73.3,14,23,37,15,14,17,13,7,8,3,62,Polfarmex Kutno,Sezon 2018/2019
2019-01-12 19:00,GKS Tychy(w),115 : 74P,74,15,37,40.5,10,24,41.7,25,61,41.0,14,20,70.0,9,13,22,15,26,18,17,5,0,6,57,Polfarmex Kutno,Sezon 2018/2019
2019-01-19 17:30,SKK Siedlce(d),100 : 80W,100,17,35,48.6,17,39,43.6,34,74,45.9,15,21,71.4,15,28,43,24,19,19,7,7,4,2,125,Polfarmex Kutno,Sezon 2018/2019
2019-01-23 19:30,KS Księżak Syntex Łowicz(w),91 : 79P,79,24,48,50.0,7,19,36.8,31,67,46.3,10,13,76.9,8,17,25,18,19,15,13,8,2,4,80,Polfarmex Kutno,Sezon 2018/2019
2019-01-30 18:00,AZS AGH Kraków(d),80 : 66W,80,19,38,50.0,6,20,30.0,25,58,43.1,24,33,72.7,9,29,38,18,24,22,13,5,9,4,95,Polfarmex Kutno,Sezon 2018/2019
2019-02-02 16:00,Górnik Trans.eu Wałbrzych(w),82 : 63P,63,12,30,40.0,7,29,24.1,19,59,32.2,18,29,62.1,8,17,25,12,22,25,9,9,0,0,49,Polfarmex Kutno,Sezon 2018/2019
2019-02-09 17:30,Biofarm Basket Poznań(d),63 : 64P,63,18,46,39.1,5,22,22.7,23,68,33.8,12,14,85.7,14,31,45,12,18,13,15,4,3,3,65,Polfarmex Kutno,Sezon 2018/2019
2019-02-13 18:30,Energa Kotwica Kołobrzeg(w),102 : 80P,80,15,29,51.7,14,32,43.8,29,61,47.5,8,12,66.7,7,13,20,16,18,20,17,7,0,2,70,Polfarmex Kutno,Sezon 2018/2019
2019-02-16 17:30,Pogoń Prudnik(d),82 : 76W,82,14,31,45.2,12,33,36.4,26,64,40.6,18,26,69.2,2,25,27,18,18,21,10,6,2,1,79,Polfarmex Kutno,Sezon 2018/2019
2019-02-23 18:00,STK Czarni Słupsk(w),84 : 82P,82,18,42,42.9,11,23,47.8,29,65,44.6,13,15,86.7,6,17,23,18,15,20,10,8,3,9,86,Polfarmex Kutno,Sezon 2018/2019
2019-03-02 17:30,Enea Astoria Bydgoszcz(d),64 : 94P,64,17,40,42.5,7,25,28.0,24,65,36.9,9,13,69.2,7,22,29,12,23,20,16,7,2,6,53,Polfarmex Kutno,Sezon 2018/2019
2019-03-09 18:00,WKK Wrocław(w),85 : 88W,88,27,46,58.7,8,23,34.8,35,69,50.7,10,15,66.7,10,27,37,18,21,16,9,4,3,2,102,Polfarmex Kutno,Sezon 2018/2019
2019-03-16 17:30,Rawlplug Sokół Łańcut(d),84 : 88P,84,18,41,43.9,12,27,44.4,30,68,44.1,12,18,66.7,6,25,31,19,20,19,11,8,4,0,91,Polfarmex Kutno,Sezon 2018/2019
2019-03-23 17:30,Jamalex Polonia 1912 Leszno(d),73 : 71W,73,22,45,48.9,7,28,25.0,29,73,39.7,8,13,61.5,12,19,31,14,19,20,11,10,4,2,72,Polfarmex Kutno,Sezon 2018/2019
2019-03-31 18:00,Elektrobud-Investment ZB Pruszków(w),58 : 80W,80,18,39,46.2,8,23,34.8,26,62,41.9,20,28,71.4,10,26,36,18,17,24,11,11,3,6,93,Polfarmex Kutno,Sezon 2018/2019
2019-04-06 17:30,AZS AGH Kraków(d),86 : 74W,86,27,46,58.7,7,13,53.8,34,59,57.6,11,18,61.1,7,24,31,17,19,20,15,13,0,3,100,Polfarmex Kutno,Sezon 2018/2019
2019-04-07 17:30,AZS AGH Kraków(d),105 : 69W,105,28,43,65.1,9,15,60.0,37,58,63.8,22,39,56.4,7,29,36,26,21,29,14,10,10,2,135,Polfarmex Kutno,Sezon 2018/2019
2019-04-13 18:00,AZS AGH Kraków(w),86 : 82P,82,19,37,51.4,8,17,47.1,27,54,50.0,20,26,76.9,6,21,27,12,33,24,18,3,6,2,79,Polfarmex Kutno,Sezon 2018/2019
2019-04-14 18:00,AZS AGH Kraków(w),68 : 75W,75,22,44,50.0,4,15,26.7,26,59,44.1,19,29,65.5,9,27,36,12,20,27,16,7,5,2,76,Polfarmex Kutno,Sezon 2018/2019
2018-09-29 19:00,GKS Tychy(w),85 : 90W,90,23,38,60.5,6,17,35.3,29,55,52.7,26,36,72.2,9,23,32,18,22,33,17,5,1,3,93,Rawlplug Sokół Łańcut,Sezon 2018/2019
2018-10-06 17:30,SKK Siedlce(d),89 : 63W,89,21,34,61.8,10,25,40.0,31,59,52.5,17,24,70.8,10,32,42,21,14,22,15,11,1,0,114,Rawlplug Sokół Łańcut,Sezon 2018/2019
2018-10-13 18:30,KS Księżak Syntex Łowicz(w),85 : 109W,109,23,40,57.5,12,27,44.4,35,67,52.2,27,32,84.4,17,24,41,20,17,28,12,9,0,2,130,Rawlplug Sokół Łańcut,Sezon 2018/2019
2018-10-17 18:00,AZS AGH Kraków(d),75 : 66W,75,22,52,42.3,5,15,33.3,27,67,40.3,16,24,66.7,11,31,42,16,16,23,13,9,4,1,85,Rawlplug Sokół Łańcut,Sezon 2018/2019
2018-10-21 18:00,Górnik Trans.eu Wałbrzych(w),62 : 82W,82,14,36,38.9,16,28,57.1,30,64,46.9,6,10,60.0,8,35,43,20,20,16,11,4,2,3,102,Rawlplug Sokół Łańcut,Sezon 2018/2019
2018-10-28 17:30,Biofarm Basket Poznań(d),89 : 88W,89,21,45,46.7,10,25,40.0,31,70,44.3,17,23,73.9,15,22,37,20,14,16,7,9,2,5,105,Rawlplug Sokół Łańcut,Sezon 2018/2019
2018-11-07 18:00,Pogoń Prudnik(d),98 : 89W,98,19,32,59.4,11,23,47.8,30,55,54.5,27,36,75.0,6,28,34,18,21,29,13,6,3,0,112,Rawlplug Sokół Łańcut,Sezon 2018/2019
2018-11-11 19:00,STK Czarni Słupsk(w),86 : 94W,94,17,32,53.1,9,24,37.5,26,56,46.4,33,46,71.7,12,22,34,18,18,31,15,6,4,1,98,Rawlplug Sokół Łańcut,Sezon 2018/2019
2018-11-13 18:30,Energa Kotwica Kołobrzeg(w),68 : 90W,90,19,31,61.3,10,21,47.6,29,52,55.8,22,37,59.5,6,19,25,17,16,31,8,9,0,2,95,Rawlplug Sokół Łańcut,Sezon 2018/2019
2018-11-17 17:30,Enea Astoria Bydgoszcz(d),73 : 95P,73,17,33,51.5,7,29,24.1,24,62,38.7,18,28,64.3,5,20,25,12,25,24,10,6,3,1,61,Rawlplug Sokół Łańcut,Sezon 2018/2019
2018-11-24 18:00,WKK Wrocław(w),93 : 90P,90,21,42,50.0,10,30,33.3,31,72,43.1,18,19,94.7,11,19,30,27,15,19,12,15,3,7,111,Rawlplug Sokół Łańcut,Sezon 2018/2019
2018-12-01 18:00,Jamalex Polonia 1912 Leszno(w),85 : 74P,74,18,35,51.4,7,24,29.2,25,59,42.4,17,21,81.0,10,17,27,11,16,23,9,5,2,1,72,Rawlplug Sokół Łańcut,Sezon 2018/2019
2018-12-08 17:30,Polfarmex Kutno(d),84 : 77W,84,22,43,51.2,4,16,25.0,26,59,44.1,28,42,66.7,14,29,43,16,20,28,13,8,3,0,94,Rawlplug Sokół Łańcut,Sezon 2018/2019
2018-12-13 18:00,Energa Kotwica Kołobrzeg(d),104 : 93W,104,17,27,63.0,15,35,42.9,32,62,51.6,25,32,78.1,12,23,35,21,15,26,13,8,2,0,120,Rawlplug Sokół Łańcut,Sezon 2018/2019
2018-12-15 18:00,Elektrobud-Investment ZB Pruszków(w),69 : 52P,52,15,49,30.6,2,13,15.4,17,62,27.4,16,24,66.7,15,32,47,10,13,22,12,5,0,4,49,Rawlplug Sokół Łańcut,Sezon 2018/2019
2018-12-22 17:30,FutureNet Śląsk Wrocław(d),82 : 79W,82,19,41,46.3,9,26,34.6,28,67,41.8,17,30,56.7,12,29,41,19,15,24,11,7,6,3,92,Rawlplug Sokół Łańcut,Sezon 2018/2019
2019-01-05 17:30,GKS Tychy(d),89 : 97P,89,19,35,54.3,11,24,45.8,30,59,50.8,18,28,64.3,8,23,31,26,17,24,11,3,3,0,102,Rawlplug Sokół Łańcut,Sezon 2018/2019
2019-01-13 19:30,SKK Siedlce(w),73 : 91W,91,25,51,49.0,10,26,38.5,35,77,45.5,11,13,84.6,13,26,39,20,17,21,13,11,3,5,107,Rawlplug Sokół Łańcut,Sezon 2018/2019
2019-01-19 17:30,KS Księżak Syntex Łowicz(d),86 : 68W,86,27,48,56.3,8,18,44.4,35,66,53.0,8,17,47.1,10,29,39,26,24,19,12,7,2,1,108,Rawlplug Sokół Łańcut,Sezon 2018/2019
2019-01-23 18:00,AZS AGH Kraków(w),78 : 82W,82,23,49,46.9,6,17,35.3,29,66,43.9,18,36,50.0,13,29,42,18,19,28,14,10,3,5,86,Rawlplug Sokół Łańcut,Sezon 2018/2019
2019-01-26 17:30,Górnik Trans.eu Wałbrzych(d),68 : 74P,68,16,34,47.1,6,25,24.0,22,59,37.3,18,30,60.0,9,22,31,18,16,24,13,7,3,5,65,Rawlplug Sokół Łańcut,Sezon 2018/2019
2019-02-02 17:00,Biofarm Basket Poznań(w),84 : 78P,78,16,39,41.0,10,29,34.5,26,68,38.2,16,28,57.1,13,22,35,17,23,24,11,5,2,3,72,Rawlplug Sokół Łańcut,Sezon 2018/2019
2019-02-13 18:30,Pogoń Prudnik(w),95 : 88P,88,24,34,70.6,4,24,16.7,28,58,48.3,28,37,75.7,8,14,22,16,17,28,11,11,1,0,88,Rawlplug Sokół Łańcut,Sezon 2018/2019
2019-02-16 17:30,STK Czarni Słupsk(d),92 : 71W,92,21,39,53.8,10,19,52.6,31,58,53.4,20,36,55.6,11,26,37,20,20,29,15,11,1,4,103,Rawlplug Sokół Łańcut,Sezon 2018/2019
2019-02-23 17:00,Enea Astoria Bydgoszcz(w),87 : 96W,96,26,43,60.5,9,30,30.0,35,73,47.9,17,21,81.0,7,27,34,25,13,22,3,6,1,4,117,Rawlplug Sokół Łańcut,Sezon 2018/2019
2019-03-02 17:30,WKK Wrocław(d),94 : 60W,94,28,49,57.1,9,26,34.6,37,75,49.3,11,20,55.0,13,35,48,21,15,17,8,7,4,3,119,Rawlplug Sokół Łańcut,Sezon 2018/2019
2019-03-09 17:30,Jamalex Polonia 1912 Leszno(d),86 : 82W,86,27,44,61.4,5,21,23.8,32,65,49.2,17,23,73.9,11,21,32,15,18,24,9,7,1,1,93,Rawlplug Sokół Łańcut,Sezon 2018/2019
2019-03-16 17:30,Polfarmex Kutno(w),84 : 88W,88,25,46,54.3,8,18,44.4,33,64,51.6,14,23,60.9,5,27,32,24,19,20,17,8,0,4,95,Rawlplug Sokół Łańcut,Sezon 2018/2019
2019-03-23 17:30,Elektrobud-Investment ZB Pruszków(d),88 : 84W,88,23,44,52.3,7,17,41.2,30,61,49.2,21,29,72.4,7,23,30,23,19,21,10,14,3,1,109,Rawlplug Sokół Łańcut,Sezon 2018/2019
2019-03-31 18:00,FutureNet Śląsk Wrocław(w),105 : 71P,71,18,39,46.2,7,21,33.3,25,60,41.7,14,20,70.0,8,20,28,15,12,20,10,4,1,2,68,Rawlplug Sokół Łańcut,Sezon 2018/2019
2019-04-06 17:30,GKS Tychy(d),90 : 81W,90,22,39,56.4,9,24,37.5,31,63,49.2,19,26,73.1,11,28,39,22,18,24,11,7,2,0,110,Rawlplug Sokół Łańcut,Sezon 2018/2019
2019-04-07 17:30,GKS Tychy(d),83 : 79W,83,20,34,58.8,7,24,29.2,27,58,46.6,22,30,73.3,13,26,39,15,13,21,12,4,4,0,94,Rawlplug Sokół Łańcut,Sezon 2018/2019
2019-04-13 18:00,GKS Tychy(w),95 : 91P,91,24,38,63.2,5,21,23.8,29,59,49.2,28,34,82.4,5,26,31,12,23,26,11,4,2,0,93,Rawlplug Sokół Łańcut,Sezon 2018/2019
2019-04-14 18:00,GKS Tychy(w),89 : 103W,103,27,38,71.1,7,26,26.9,34,64,53.1,28,35,80.0,11,20,31,20,13,28,9,11,2,0,121,Rawlplug Sokół Łańcut,Sezon 2018/2019
2019-04-27 17:00,Enea Astoria Bydgoszcz(w),95 : 70P,70,10,33,30.3,10,30,33.3,20,63,31.7,20,28,71.4,3,22,25,20,15,19,7,5,1,0,63,Rawlplug Sokół Łańcut,Sezon 2018/2019
2019-04-28 17:00,Enea Astoria Bydgoszcz(w),83 : 87W,87,18,35,51.4,9,24,37.5,27,59,45.8,24,32,75.0,6,23,29,21,14,22,12,3,5,1,93,Rawlplug Sokół Łańcut,Sezon 2018/2019
2019-05-04 17:30,Enea Astoria Bydgoszcz(d),99 : 79W,99,19,31,61.3,10,20,50.0,29,51,56.9,31,39,79.5,6,21,27,20,22,29,12,7,1,1,112,Rawlplug Sokół Łańcut,Sezon 2018/2019
2019-05-05 17:30,Enea Astoria Bydgoszcz(d),68 : 74P,68,13,35,37.1,7,22,31.8,20,57,35.1,21,31,67.7,12,26,38,13,24,22,13,4,4,2,67,Rawlplug Sokół Łańcut,Sezon 2018/2019
2019-05-08 19:00,Enea Astoria Bydgoszcz(w),89 : 66P,66,21,41,51.2,5,22,22.7,26,63,41.3,9,24,37.5,8,24,32,20,21,19,10,7,3,1,66,Rawlplug Sokół Łańcut,Sezon 2018/2019
2019-05-11 19:00,STK Czarni Słupsk(w),79 : 75P,75,23,48,47.9,6,16,37.5,29,64,45.3,11,18,61.1,8,31,39,24,14,18,15,6,1,5,88,Rawlplug Sokół Łańcut,Sezon 2018/2019
2019-05-18 17:30,STK Czarni Słupsk(d),65 : 82P,65,15,37,40.5,7,14,50.0,22,51,43.1,14,24,58.3,7,25,32,12,8,21,16,7,4,1,65,Rawlplug Sokół Łańcut,Sezon 2018/2019
2018-10-06 17:30,Rawlplug Sokół Łańcut(w),89 : 63P,63,17,40,42.5,8,29,27.6,25,69,36.2,5,5,100.0,9,20,29,11,22,14,13,8,0,1,54,SKK Siedlce,Sezon 2018/2019
2018-10-13 18:00,Polfarmex Kutno(d),72 : 86P,72,16,41,39.0,8,24,33.3,24,65,36.9,16,21,76.2,10,21,31,18,20,22,16,7,2,2,68,SKK Siedlce,Sezon 2018/2019
2018-10-17 19:00,Elektrobud-Investment ZB Pruszków(w),75 : 57P,57,16,36,44.4,4,21,19.0,20,57,35.1,13,16,81.3,9,22,31,10,22,15,14,11,0,2,55,SKK Siedlce,Sezon 2018/2019
2018-10-20 18:00,FutureNet Śląsk Wrocław(d),102 : 104P,102,23,50,46.0,16,42,38.1,39,92,42.4,8,15,53.3,15,32,47,17,23,17,13,5,2,8,100,SKK Siedlce,Sezon 2018/2019
2018-10-25 17:00,WKK Wrocław(w),94 : 80P,80,20,32,62.5,12,31,38.7,32,63,50.8,4,8,50.0,8,25,33,19,11,9,18,5,1,2,85,SKK Siedlce,Sezon 2018/2019
2018-10-27 19:00,GKS Tychy(w),91 : 74P,74,14,29,48.3,11,27,40.7,25,56,44.6,13,18,72.2,3,18,21,21,29,20,12,4,1,0,73,SKK Siedlce,Sezon 2018/2019
2018-11-04 18:00,Jamalex Polonia 1912 Leszno(d),85 : 78W,85,22,44,50.0,9,25,36.0,31,69,44.9,14,17,82.4,10,29,39,18,24,19,12,7,4,1,100,SKK Siedlce,Sezon 2018/2019
2018-11-07 18:00,KS Księżak Syntex Łowicz(d),104 : 81W,104,25,41,61.0,14,23,60.9,39,64,60.9,12,19,63.2,6,31,37,27,23,19,17,8,3,0,130,SKK Siedlce,Sezon 2018/2019
2018-11-10 18:00,AZS AGH Kraków(w),94 : 72P,72,26,46,56.5,5,19,26.3,31,65,47.7,5,10,50.0,9,22,31,25,20,14,17,7,6,2,85,SKK Siedlce,Sezon 2018/2019
2018-11-17 18:00,Górnik Trans.eu Wałbrzych(d),81 : 95P,81,16,33,48.5,9,32,28.1,25,65,38.5,22,32,68.8,10,19,29,14,17,26,12,9,2,2,73,SKK Siedlce,Sezon 2018/2019
2018-11-24 17:00,Biofarm Basket Poznań(w),96 : 57P,57,11,41,26.8,9,28,32.1,20,69,29.0,8,12,66.7,9,29,38,12,24,16,15,4,0,5,43,SKK Siedlce,Sezon 2018/2019
2018-12-01 18:00,Energa Kotwica Kołobrzeg(w),98 : 93P,93,19,42,45.2,15,35,42.9,34,77,44.2,10,19,52.6,10,27,37,17,25,21,13,6,2,3,90,SKK Siedlce,Sezon 2018/2019
2018-12-08 17:30,Pogoń Prudnik(w),98 : 85P,85,26,43,60.5,7,28,25.0,33,71,46.5,12,15,80.0,10,19,29,14,30,20,13,8,3,5,85,SKK Siedlce,Sezon 2018/2019
2018-12-15 19:30,STK Czarni Słupsk(d),94 : 88W,94,22,51,43.1,10,22,45.5,32,73,43.8,20,27,74.1,8,26,34,18,21,25,5,3,4,1,100,SKK Siedlce,Sezon 2018/2019
2018-12-22 17:00,Enea Astoria Bydgoszcz(w),106 : 92P,92,20,36,55.6,14,35,40.0,34,71,47.9,10,22,45.5,7,23,30,21,20,23,15,8,1,3,88,SKK Siedlce,Sezon 2018/2019
2019-01-06 19:30,WKK Wrocław(d),98 : 84W,98,24,41,58.5,15,35,42.9,39,76,51.3,5,14,35.7,13,29,42,21,18,16,11,5,4,0,113,SKK Siedlce,Sezon 2018/2019
2019-01-13 19:30,Rawlplug Sokół Łańcut(d),73 : 91P,73,18,36,50.0,7,29,24.1,25,65,38.5,16,17,94.1,5,24,29,24,21,17,17,5,5,3,78,SKK Siedlce,Sezon 2018/2019
2019-01-19 17:30,Polfarmex Kutno(w),100 : 80P,80,18,37,48.6,10,26,38.5,28,63,44.4,14,20,70.0,7,21,28,18,19,20,11,4,2,4,80,SKK Siedlce,Sezon 2018/2019
2019-01-23 18:00,Elektrobud-Investment ZB Pruszków(d),80 : 87P,80,19,37,51.4,10,29,34.5,29,66,43.9,12,17,70.6,9,31,40,14,20,24,19,4,3,3,80,SKK Siedlce,Sezon 2018/2019
2019-01-27 20:00,FutureNet Śląsk Wrocław(w),121 : 79P,79,16,33,48.5,11,38,28.9,27,71,38.0,14,16,87.5,10,22,32,12,19,17,17,5,0,1,65,SKK Siedlce,Sezon 2018/2019
2019-02-02 15:00,GKS Tychy(d),89 : 71W,89,21,39,53.8,12,28,42.9,33,67,49.3,11,18,61.1,10,31,41,22,19,20,14,6,5,2,108,SKK Siedlce,Sezon 2018/2019
2019-02-09 19:00,Jamalex Polonia 1912 Leszno(w),81 : 86W,86,24,35,68.6,7,23,30.4,31,58,53.4,17,26,65.4,5,28,33,12,22,22,12,4,2,0,89,SKK Siedlce,Sezon 2018/2019
2019-02-13 18:30,KS Księżak Syntex Łowicz(w),103 : 84P,84,20,43,46.5,10,24,41.7,30,67,44.8,14,15,93.3,9,17,26,17,24,19,9,1,1,3,82,SKK Siedlce,Sezon 2018/2019
2019-02-17 17:00,AZS AGH Kraków(d),73 : 85P,73,22,38,57.9,6,17,35.3,28,55,50.9,11,16,68.8,6,27,33,15,30,20,26,5,0,1,68,SKK Siedlce,Sezon 2018/2019
2019-02-23 17:00,Górnik Trans.eu Wałbrzych(w),80 : 70P,70,18,33,54.5,8,27,29.6,26,60,43.3,10,15,66.7,6,18,24,14,20,20,11,7,1,4,66,SKK Siedlce,Sezon 2018/2019
2019-03-03 16:00,Biofarm Basket Poznań(d),83 : 90P,83,18,33,54.5,11,29,37.9,29,62,46.8,14,21,66.7,8,27,35,24,30,22,14,4,2,3,94,SKK Siedlce,Sezon 2018/2019
2019-03-09 16:00,Energa Kotwica Kołobrzeg(d),81 : 86P,81,17,36,47.2,9,29,31.0,26,65,40.0,20,25,80.0,8,27,35,21,14,23,16,4,2,3,83,SKK Siedlce,Sezon 2018/2019
2019-03-16 13:00,Pogoń Prudnik(d),74 : 96P,74,21,42,50.0,6,22,27.3,27,64,42.2,14,21,66.7,10,19,29,15,19,18,11,3,3,4,69,SKK Siedlce,Sezon 2018/2019
2019-03-23 18:00,STK Czarni Słupsk(w),91 : 84P,84,21,45,46.7,8,31,25.8,29,76,38.2,18,23,78.3,13,26,39,19,21,23,11,10,1,6,90,SKK Siedlce,Sezon 2018/2019
2019-03-31 18:00,Enea Astoria Bydgoszcz(d),81 : 82P,81,20,45,44.4,13,26,50.0,33,71,46.5,2,7,28.6,6,24,30,18,18,16,11,7,2,2,84,SKK Siedlce,Sezon 2018/2019
2019-04-06 18:00,Energa Kotwica Kołobrzeg(w),72 : 79W,79,14,30,46.7,12,25,48.0,26,55,47.3,15,20,75.0,3,31,34,18,21,21,19,3,3,3,84,SKK Siedlce,Sezon 2018/2019
2019-04-07 17:00,Energa Kotwica Kołobrzeg(w),82 : 71P,71,12,30,40.0,12,29,41.4,24,59,40.7,11,19,57.9,2,26,28,14,15,20,14,5,1,0,62,SKK Siedlce,Sezon 2018/2019
2019-04-13 13:00,Energa Kotwica Kołobrzeg(d),72 : 80P,72,14,28,50.0,12,34,35.3,26,62,41.9,8,12,66.7,6,19,25,20,17,17,12,6,1,3,72,SKK Siedlce,Sezon 2018/2019
2019-04-14 13:00,Energa Kotwica Kołobrzeg(d),81 : 83P,81,13,27,48.1,15,37,40.5,28,64,43.8,10,13,76.9,5,29,34,22,18,16,15,5,7,1,95,SKK Siedlce,Sezon 2018/2019
2018-09-29 16:00,AZS AGH Kraków(w),66 : 87W,87,25,42,59.5,9,20,45.0,34,62,54.8,10,17,58.8,9,34,43,23,20,16,21,12,2,2,111,STK Czarni Słupsk,Sezon 2018/2019
2018-10-07 18:00,Górnik Trans.eu Wałbrzych(d),77 : 66W,77,22,44,50.0,6,23,26.1,28,67,41.8,15,19,78.9,15,19,34,24,18,16,10,9,2,5,93,STK Czarni Słupsk,Sezon 2018/2019
2018-10-13 17:00,Biofarm Basket Poznań(w),76 : 71P,71,15,34,44.1,10,32,31.3,25,66,37.9,11,17,64.7,9,29,38,14,17,14,14,3,4,6,69,STK Czarni Słupsk,Sezon 2018/2019
2018-10-17 18:00,Energa Kotwica Kołobrzeg(d),84 : 88P,84,15,32,46.9,11,25,44.0,26,57,45.6,21,31,67.7,7,23,30,18,25,23,15,7,1,2,84,STK Czarni Słupsk,Sezon 2018/2019
2018-10-21 17:00,Pogoń Prudnik(w),83 : 93W,93,26,42,61.9,8,16,50.0,34,58,58.6,17,22,77.3,4,25,29,21,25,25,14,7,1,0,108,STK Czarni Słupsk,Sezon 2018/2019
2018-10-28 19:00,Jamalex Polonia 1912 Leszno(w),79 : 66P,66,24,46,52.2,2,14,14.3,26,60,43.3,12,19,63.2,10,35,45,14,23,19,22,3,3,1,68,STK Czarni Słupsk,Sezon 2018/2019
2018-11-03 18:00,Enea Astoria Bydgoszcz(d),90 : 92P,90,26,41,63.4,9,28,32.1,35,69,50.7,11,20,55.0,4,30,34,23,22,17,11,4,1,1,98,STK Czarni Słupsk,Sezon 2018/2019
2018-11-07 17:00,WKK Wrocław(w),100 : 76P,76,19,37,51.4,9,23,39.1,28,60,46.7,11,18,61.1,6,19,25,15,17,19,13,8,1,1,73,STK Czarni Słupsk,Sezon 2018/2019
2018-11-11 19:00,Rawlplug Sokół Łańcut(d),86 : 94P,86,28,47,59.6,5,23,21.7,33,70,47.1,15,21,71.4,16,21,37,26,31,18,13,8,1,4,102,STK Czarni Słupsk,Sezon 2018/2019
2018-11-17 17:30,Polfarmex Kutno(w),79 : 81W,81,15,44,34.1,12,23,52.2,27,67,40.3,15,25,60.0,17,28,45,19,17,21,16,6,2,2,87,STK Czarni Słupsk,Sezon 2018/2019
2018-11-24 18:00,Elektrobud-Investment ZB Pruszków(d),80 : 60W,80,24,37,64.9,5,22,22.7,29,59,49.2,17,24,70.8,10,30,40,23,14,18,15,11,2,0,104,STK Czarni Słupsk,Sezon 2018/2019
2018-12-01 19:00,FutureNet Śląsk Wrocław(w),96 : 83P,83,23,52,44.2,11,25,44.0,34,77,44.2,4,8,50.0,12,25,37,14,20,14,11,3,3,4,82,STK Czarni Słupsk,Sezon 2018/2019
2018-12-08 18:00,GKS Tychy(d),72 : 76P,72,16,25,64.0,9,32,28.1,25,57,43.9,13,22,59.1,6,26,32,19,23,22,16,4,3,0,73,STK Czarni Słupsk,Sezon 2018/2019
2018-12-15 19:30,SKK Siedlce(w),94 : 88P,88,19,39,48.7,10,33,30.3,29,72,40.3,20,22,90.9,14,31,45,25,25,21,11,5,1,4,108,STK Czarni Słupsk,Sezon 2018/2019
2018-12-22 18:00,KS Księżak Syntex Łowicz(d),96 : 73W,96,22,40,55.0,13,24,54.2,35,64,54.7,13,22,59.1,12,25,37,32,12,17,8,6,2,2,127,STK Czarni Słupsk,Sezon 2018/2019
2019-01-05 17:00,AZS AGH Kraków(d),85 : 73W,85,17,36,47.2,10,23,43.5,27,59,45.8,21,34,61.8,6,33,39,26,18,22,10,6,5,0,106,STK Czarni Słupsk,Sezon 2018/2019
2019-01-13 19:00,Górnik Trans.eu Wałbrzych(w),64 : 74W,74,17,28,60.7,9,24,37.5,26,52,50.0,13,20,65.0,9,30,39,17,23,19,11,3,1,1,90,STK Czarni Słupsk,Sezon 2018/2019
2019-01-19 18:00,Biofarm Basket Poznań(d),87 : 71W,87,20,38,52.6,9,27,33.3,29,65,44.6,20,31,64.5,12,23,35,20,21,23,11,10,2,1,96,STK Czarni Słupsk,Sezon 2018/2019
2019-01-23 18:30,Energa Kotwica Kołobrzeg(w),64 : 84W,84,20,40,50.0,8,23,34.8,28,63,44.4,20,25,80.0,10,26,36,15,20,21,15,14,1,1,95,STK Czarni Słupsk,Sezon 2018/2019
2019-01-26 18:00,Pogoń Prudnik(d),67 : 59W,67,20,36,55.6,6,31,19.4,26,67,38.8,9,14,64.3,16,36,52,21,17,20,14,4,3,2,87,STK Czarni Słupsk,Sezon 2018/2019
2019-02-02 18:00,Jamalex Polonia 1912 Leszno(d),88 : 67W,88,19,29,65.5,11,23,47.8,30,52,57.7,17,25,68.0,8,21,29,30,18,19,11,5,5,1,116,STK Czarni Słupsk,Sezon 2018/2019
2019-02-09 17:00,Enea Astoria Bydgoszcz(w),86 : 59P,59,17,30,56.7,7,27,25.9,24,57,42.1,4,11,36.4,4,29,33,19,24,15,20,4,4,1,59,STK Czarni Słupsk,Sezon 2018/2019
2019-02-13 18:00,WKK Wrocław(d),71 : 73P,71,20,37,54.1,8,32,25.0,28,69,40.6,7,7,100.0,7,25,32,22,18,9,10,9,6,2,89,STK Czarni Słupsk,Sezon 2018/2019
2019-02-16 17:30,Rawlplug Sokół Łańcut(w),92 : 71P,71,16,29,55.2,8,33,24.2,24,62,38.7,15,23,65.2,11,19,30,11,29,20,17,6,4,1,59,STK Czarni Słupsk,Sezon 2018/2019
2019-02-23 18:00,Polfarmex Kutno(d),84 : 82W,84,23,42,54.8,9,28,32.1,32,70,45.7,11,18,61.1,18,24,42,20,20,15,13,4,9,3,101,STK Czarni Słupsk,Sezon 2018/2019
2019-03-03 17:00,Elektrobud-Investment ZB Pruszków(w),60 : 75W,75,15,32,46.9,9,24,37.5,24,56,42.9,18,19,94.7,11,30,41,16,19,22,18,6,5,3,92,STK Czarni Słupsk,Sezon 2018/2019
2019-03-09 18:00,FutureNet Śląsk Wrocław(d),80 : 71W,80,19,41,46.3,10,32,31.3,29,73,39.7,12,20,60.0,12,22,34,16,19,22,6,6,3,1,81,STK Czarni Słupsk,Sezon 2018/2019
2019-03-16 18:00,GKS Tychy(w),102 : 103W,103,21,37,56.8,16,31,51.6,37,68,54.4,13,15,86.7,8,17,25,26,25,18,8,6,1,0,120,STK Czarni Słupsk,Sezon 2018/2019
2019-03-23 18:00,SKK Siedlce(d),91 : 84W,91,22,38,57.9,12,33,36.4,34,71,47.9,11,22,50.0,13,29,42,27,23,21,16,4,6,1,106,STK Czarni Słupsk,Sezon 2018/2019
2019-03-31 18:00,KS Księżak Syntex Łowicz(w),76 : 91W,91,19,33,57.6,15,29,51.7,34,62,54.8,8,13,61.5,13,17,30,21,21,16,15,14,0,2,108,STK Czarni Słupsk,Sezon 2018/2019
2019-04-06 18:00,WKK Wrocław(d),90 : 92P,90,18,39,46.2,13,33,39.4,31,72,43.1,15,27,55.6,13,27,40,19,18,16,8,2,2,3,92,STK Czarni Słupsk,Sezon 2018/2019
2019-04-07 18:00,WKK Wrocław(d),77 : 71W,77,22,37,59.5,9,24,37.5,31,61,50.8,6,13,46.2,10,34,44,21,21,15,21,8,2,2,94,STK Czarni Słupsk,Sezon 2018/2019
2019-04-13 16:00,WKK Wrocław(w),73 : 99W,99,17,31,54.8,17,28,60.7,34,59,57.6,14,19,73.7,8,32,40,26,19,15,13,5,1,1,128,STK Czarni Słupsk,Sezon 2018/2019
2019-04-14 14:30,WKK Wrocław(w),83 : 87W,87,19,34,55.9,13,32,40.6,32,66,48.5,10,12,83.3,10,25,35,27,23,17,11,5,1,1,108,STK Czarni Słupsk,Sezon 2018/2019
2019-04-27 18:00,FutureNet Śląsk Wrocław(w),85 : 80P,80,20,40,50.0,7,24,29.2,27,64,42.2,19,25,76.0,10,22,32,16,29,24,11,9,0,8,83,STK Czarni Słupsk,Sezon 2018/2019
2019-04-28 18:00,FutureNet Śląsk Wrocław(w),72 : 86W,86,23,41,56.1,9,28,32.1,32,69,46.4,13,23,56.5,13,27,40,13,25,23,14,6,5,5,89,STK Czarni Słupsk,Sezon 2018/2019
2019-05-04 19:00,FutureNet Śląsk Wrocław(d),76 : 85P,76,19,41,46.3,8,28,28.6,27,69,39.1,14,18,77.8,8,31,39,18,28,17,9,4,4,2,86,STK Czarni Słupsk,Sezon 2018/2019
2019-05-05 19:00,FutureNet Śląsk Wrocław(d),103 : 101W,103,24,46,52.2,13,31,41.9,37,77,48.1,16,20,80.0,12,20,32,24,22,21,11,7,0,7,111,STK Czarni Słupsk,Sezon 2018/2019
2019-05-08 18:00,FutureNet Śląsk Wrocław(w),82 : 81P,81,18,35,51.4,11,31,35.5,29,66,43.9,12,20,60.0,10,26,36,15,26,20,18,2,4,1,75,STK Czarni Słupsk,Sezon 2018/2019
2019-05-11 19:00,Rawlplug Sokół Łańcut(d),79 : 75W,79,24,42,57.1,8,27,29.6,32,69,46.4,7,16,43.8,8,27,35,26,18,14,7,10,5,1,102,STK Czarni Słupsk,Sezon 2018/2019
2019-05-18 17:30,Rawlplug Sokół Łańcut(w),65 : 82W,82,18,36,50.0,14,29,48.3,32,65,49.2,4,5,80.0,6,23,29,20,21,7,10,11,1,4,99,STK Czarni Słupsk,Sezon 2018/2019
2018-10-06 17:00,KS Księżak Syntex Łowicz(d),91 : 76W,91,26,43,60.5,8,31,25.8,34,74,45.9,15,19,78.9,8,24,32,23,22,20,5,10,6,2,113,WKK Wrocław,Sezon 2018/2019
2018-10-13 18:00,AZS AGH Kraków(w),93 : 74P,74,16,39,41.0,5,22,22.7,21,61,34.4,27,36,75.0,12,20,32,13,21,26,21,13,5,5,67,WKK Wrocław,Sezon 2018/2019
2018-10-17 17:00,Górnik Trans.eu Wałbrzych(d),75 : 60W,75,18,37,48.6,9,36,25.0,27,73,37.0,12,17,70.6,20,25,45,19,17,18,9,9,4,2,92,WKK Wrocław,Sezon 2018/2019
2018-10-20 17:00,Biofarm Basket Poznań(w),62 : 72W,72,15,33,45.5,10,33,30.3,25,66,37.9,12,13,92.3,11,26,37,11,14,18,9,11,2,1,82,WKK Wrocław,Sezon 2018/2019
2018-10-25 17:00,SKK Siedlce(d),94 : 80W,94,23,36,63.9,14,36,38.9,37,72,51.4,6,6,100.0,8,21,29,27,9,11,8,10,2,1,119,WKK Wrocław,Sezon 2018/2019
2018-10-28 19:00,Energa Kotwica Kołobrzeg(d),92 : 78W,92,21,46,45.7,12,23,52.2,33,69,47.8,14,20,70.0,12,28,40,20,19,18,15,12,4,1,111,WKK Wrocław,Sezon 2018/2019
2018-11-03 17:30,Pogoń Prudnik(w),87 : 79P,79,22,40,55.0,10,26,38.5,32,66,48.5,5,9,55.6,6,24,30,14,19,16,13,9,2,2,83,WKK Wrocław,Sezon 2018/2019
2018-11-07 17:00,STK Czarni Słupsk(d),100 : 76W,100,21,33,63.6,16,26,61.5,37,59,62.7,10,12,83.3,1,26,27,23,19,17,16,11,1,1,122,WKK Wrocław,Sezon 2018/2019
2018-11-11 17:00,Enea Astoria Bydgoszcz(w),62 : 76W,76,20,34,58.8,7,28,25.0,27,62,43.5,15,21,71.4,6,29,35,24,14,19,9,11,1,0,97,WKK Wrocław,Sezon 2018/2019
2018-11-17 18:00,Jamalex Polonia 1912 Leszno(w),72 : 64P,64,18,38,47.4,4,20,20.0,22,58,37.9,16,21,76.2,8,25,33,8,23,19,14,6,9,3,65,WKK Wrocław,Sezon 2018/2019
2018-11-24 18:00,Rawlplug Sokół Łańcut(d),93 : 90W,93,21,31,67.7,14,29,48.3,35,60,58.3,9,9,100.0,4,25,29,22,19,15,20,5,7,3,111,WKK Wrocław,Sezon 2018/2019
2018-12-01 17:30,Polfarmex Kutno(w),82 : 69P,69,17,40,42.5,6,26,23.1,23,66,34.8,17,24,70.8,7,32,39,13,18,18,16,4,6,1,65,WKK Wrocław,Sezon 2018/2019
2018-12-08 19:00,Elektrobud-Investment ZB Pruszków(d),71 : 68W,71,17,34,50.0,8,28,28.6,25,62,40.3,13,19,68.4,6,27,33,15,16,21,15,10,2,2,73,WKK Wrocław,Sezon 2018/2019
2018-12-15 18:00,FutureNet Śląsk Wrocław(w),91 : 72P,72,23,46,50.0,4,22,18.2,27,68,39.7,14,22,63.6,6,30,36,10,17,23,11,6,1,4,65,WKK Wrocław,Sezon 2018/2019
2018-12-21 18:00,GKS Tychy(d),74 : 67W,74,17,36,47.2,7,30,23.3,24,66,36.4,19,24,79.2,11,31,42,15,19,25,7,7,2,0,86,WKK Wrocław,Sezon 2018/2019
2019-01-06 19:30,SKK Siedlce(w),98 : 84P,84,19,37,51.4,12,45,26.7,31,82,37.8,10,13,76.9,13,26,39,21,16,18,10,10,0,4,90,WKK Wrocław,Sezon 2018/2019
2019-01-12 18:30,KS Księżak Syntex Łowicz(w),96 : 84P,84,27,38,71.1,5,22,22.7,32,60,53.3,15,18,83.3,9,22,31,13,10,18,17,8,2,1,90,WKK Wrocław,Sezon 2018/2019
2019-01-19 18:00,AZS AGH Kraków(d),84 : 81W,84,23,45,51.1,3,15,20.0,26,60,43.3,29,35,82.9,6,28,34,17,14,24,15,10,1,1,91,WKK Wrocław,Sezon 2018/2019
2019-01-23 19:00,Górnik Trans.eu Wałbrzych(w),82 : 51P,51,13,35,37.1,7,34,20.6,20,69,29.0,4,11,36.4,7,17,24,8,16,17,10,8,1,4,26,WKK Wrocław,Sezon 2018/2019
2019-01-27 17:00,Biofarm Basket Poznań(d),93 : 85W,93,18,31,58.1,12,27,44.4,30,58,51.7,21,24,87.5,4,36,40,19,18,16,11,3,2,1,115,WKK Wrocław,Sezon 2018/2019
2019-02-02 18:00,Energa Kotwica Kołobrzeg(w),79 : 68P,68,11,28,39.3,9,23,39.1,20,51,39.2,19,28,67.9,6,19,25,10,22,24,14,4,2,2,55,WKK Wrocław,Sezon 2018/2019
2019-02-10 18:00,Pogoń Prudnik(d),70 : 67W,70,16,41,39.0,8,27,29.6,24,68,35.3,14,22,63.6,9,27,36,17,19,22,8,13,2,2,78,WKK Wrocław,Sezon 2018/2019
2019-02-13 18:00,STK Czarni Słupsk(w),71 : 73W,73,17,38,44.7,9,20,45.0,26,58,44.8,12,16,75.0,4,27,31,13,9,18,14,3,2,6,72,WKK Wrocław,Sezon 2018/2019
2019-02-17 16:00,Enea Astoria Bydgoszcz(d),70 : 86P,70,15,34,44.1,10,28,35.7,25,62,40.3,10,18,55.6,8,24,32,19,21,17,14,8,4,2,74,WKK Wrocław,Sezon 2018/2019
2019-02-23 18:00,Jamalex Polonia 1912 Leszno(d),81 : 71W,81,18,32,56.3,7,17,41.2,25,49,51.0,24,27,88.9,5,21,26,18,20,25,12,5,3,1,94,WKK Wrocław,Sezon 2018/2019
2019-03-02 17:30,Rawlplug Sokół Łańcut(w),94 : 60P,60,13,35,37.1,9,26,34.6,22,61,36.1,7,19,36.8,4,28,32,15,17,15,15,4,3,4,48,WKK Wrocław,Sezon 2018/2019
2019-03-09 18:00,Polfarmex Kutno(d),85 : 88P,85,16,34,47.1,13,38,34.2,29,72,40.3,14,17,82.4,12,24,36,23,16,20,9,4,2,3,95,WKK Wrocław,Sezon 2018/2019
2019-03-16 17:00,Elektrobud-Investment ZB Pruszków(w),78 : 84W,84,16,32,50.0,12,29,41.4,28,61,45.9,16,23,69.6,4,21,25,18,13,19,5,12,1,0,95,WKK Wrocław,Sezon 2018/2019
2019-03-23 18:00,FutureNet Śląsk Wrocław(d),80 : 93P,80,13,27,48.1,16,35,45.7,29,62,46.8,6,13,46.2,7,21,28,23,12,16,8,1,4,1,88,WKK Wrocław,Sezon 2018/2019
2019-03-30 18:00,GKS Tychy(w),80 : 58P,58,12,30,40.0,8,28,28.6,20,58,34.5,10,16,62.5,5,19,24,14,10,21,13,9,4,3,52,WKK Wrocław,Sezon 2018/2019
2019-04-06 18:00,STK Czarni Słupsk(w),90 : 92W,92,21,36,58.3,13,31,41.9,34,67,50.7,11,14,78.6,6,27,33,20,16,18,7,4,3,2,109,WKK Wrocław,Sezon 2018/2019
2019-04-07 18:00,STK Czarni Słupsk(w),77 : 71P,71,13,28,46.4,11,35,31.4,24,63,38.1,12,16,75.0,3,17,20,13,15,21,11,14,2,2,66,WKK Wrocław,Sezon 2018/2019
2019-04-13 16:00,STK Czarni Słupsk(d),73 : 99P,73,15,28,53.6,10,31,32.3,25,59,42.4,13,19,68.4,3,17,20,18,15,19,11,7,1,1,68,WKK Wrocław,Sezon 2018/2019
2019-04-14 14:30,STK Czarni Słupsk(d),83 : 87P,83,18,34,52.9,10,25,40.0,28,59,47.5,17,22,77.3,5,21,26,23,17,22,9,6,1,1,94,WKK Wrocław,Sezon 2018/2019
2017-09-23 18:00,Energa Kotwica Kołobrzeg(w),49 : 69W,69,23,40,57.5,7,24,29.2,30,64,46.9,2,6,33.3,11,28,39,21,16,12,19,8,2,0,82,Biofarm Basket Poznań,Sezon 2017/2018
2017-10-08 15:00,SKK Siedlce(d),86 : 72W,86,26,42,61.9,9,22,40.9,35,64,54.7,7,14,50.0,8,26,34,26,17,16,14,13,6,1,115,Biofarm Basket Poznań,Sezon 2017/2018
2017-10-14 19:00,GKS Tychy(w),95 : 91P,91,26,38,68.4,8,19,42.1,34,57,59.6,15,25,60.0,5,20,25,14,28,21,14,5,2,0,90,Biofarm Basket Poznań,Sezon 2017/2018
2017-10-18 17:00,Jamalex Polonia 1912 Leszno(d),71 : 68W,71,18,40,45.0,5,17,29.4,23,57,40.4,20,26,76.9,8,33,41,16,18,25,14,2,3,1,79,Biofarm Basket Poznań,Sezon 2017/2018
2017-10-21 17:00,Elektrobud-Investment ZB Pruszków(d),72 : 82P,72,19,47,40.4,6,17,35.3,25,64,39.1,16,20,80.0,12,22,34,12,22,17,12,7,5,2,75,Biofarm Basket Poznań,Sezon 2017/2018
2017-11-04 17:30,Sokół Łańcut(w),83 : 70P,70,20,35,57.1,9,23,39.1,29,58,50.0,3,4,75.0,8,24,32,17,18,12,19,3,2,5,75,Biofarm Basket Poznań,Sezon 2017/2018
2017-11-08 17:00,WKS Śląsk Wrocław(d),77 : 82P,77,17,40,42.5,8,22,36.4,25,62,40.3,19,23,82.6,7,25,32,16,20,22,11,7,3,1,83,Biofarm Basket Poznań,Sezon 2017/2018
2017-11-12 17:00,Enea Astoria Bydgoszcz(w),69 : 68P,68,17,36,47.2,6,23,26.1,23,59,39.0,16,24,66.7,10,21,31,12,18,21,12,10,2,3,67,Biofarm Basket Poznań,Sezon 2017/2018
2017-11-18 17:00,Polfarmex Kutno(d),72 : 64W,72,20,43,46.5,5,17,29.4,25,60,41.7,17,28,60.7,13,25,38,14,16,26,11,9,3,2,79,Biofarm Basket Poznań,Sezon 2017/2018
2017-11-25 17:00,Zetkama Doral Nysa Kłodzko(w),63 : 71W,71,18,47,38.3,7,21,33.3,25,68,36.8,14,16,87.5,14,28,42,18,22,18,13,7,4,3,84,Biofarm Basket Poznań,Sezon 2017/2018
2017-12-02 17:00,KK Warszawa(d),86 : 82W,86,20,33,60.6,6,24,25.0,26,57,45.6,28,33,84.8,11,27,38,17,19,28,13,3,6,3,101,Biofarm Basket Poznań,Sezon 2017/2018
2017-12-06 18:00,Spójnia Stargard(w),89 : 61P,61,19,45,42.2,2,14,14.3,21,59,35.6,17,31,54.8,10,21,31,9,19,22,19,7,4,2,41,Biofarm Basket Poznań,Sezon 2017/2018
2017-12-09 17:00,KSK Noteć Inowrocław(d),57 : 61P,57,22,51,43.1,2,14,14.3,24,65,36.9,7,12,58.3,14,22,36,14,20,15,14,6,1,3,54,Biofarm Basket Poznań,Sezon 2017/2018
2017-12-16 18:00,Siarka Tarnobrzeg(w),79 : 76P,76,17,35,48.6,6,21,28.6,23,56,41.1,24,35,68.6,7,26,33,12,24,27,18,12,7,4,78,Biofarm Basket Poznań,Sezon 2017/2018
2017-12-23 15:00,Pogoń Prudnik(d),88 : 89P,88,21,38,55.3,10,24,41.7,31,62,50.0,16,22,72.7,10,21,31,19,28,23,13,5,4,2,97,Biofarm Basket Poznań,Sezon 2017/2018
2018-01-06 17:00,Energa Kotwica Kołobrzeg(d),85 : 81W,85,20,41,48.8,11,26,42.3,31,67,46.3,12,18,66.7,9,25,34,21,22,22,18,10,4,1,94,Biofarm Basket Poznań,Sezon 2017/2018
2018-01-14 17:00,R8 Basket AZS Politechnika Kraków(d),77 : 83P,77,20,46,43.5,9,27,33.3,29,73,39.7,10,17,58.8,16,23,39,13,29,20,15,10,3,2,76,Biofarm Basket Poznań,Sezon 2017/2018
2018-01-20 18:00,SKK Siedlce(w),75 : 77W,77,17,38,44.7,8,23,34.8,25,61,41.0,19,23,82.6,17,19,36,12,19,18,13,4,3,2,79,Biofarm Basket Poznań,Sezon 2017/2018
2018-01-27 17:00,GKS Tychy(d),87 : 93P,87,23,37,62.2,8,31,25.8,31,68,45.6,17,23,73.9,9,18,27,16,24,24,15,15,2,1,89,Biofarm Basket Poznań,Sezon 2017/2018
2018-01-31 20:00,Jamalex Polonia 1912 Leszno(w),82 : 63P,63,17,33,51.5,7,20,35.0,24,53,45.3,8,15,53.3,6,19,25,15,25,18,16,5,3,3,59,Biofarm Basket Poznań,Sezon 2017/2018
2018-02-04 17:00,Elektrobud-Investment ZB Pruszków(w),88 : 90W,90,26,44,59.1,6,20,30.0,32,64,50.0,20,26,76.9,12,19,31,22,19,21,13,9,5,3,106,Biofarm Basket Poznań,Sezon 2017/2018
2018-02-12 19:00,R8 Basket AZS Politechnika Kraków(w),90 : 89P,89,27,45,60.0,6,17,35.3,33,62,53.2,17,24,70.8,4,24,28,13,19,21,11,5,2,3,90,Biofarm Basket Poznań,Sezon 2017/2018
2018-02-17 17:00,Sokół Łańcut(d),86 : 75W,86,20,37,54.1,10,22,45.5,30,59,50.8,16,18,88.9,6,30,36,20,18,18,13,6,3,0,107,Biofarm Basket Poznań,Sezon 2017/2018
2018-02-21 18:00,WKS Śląsk Wrocław(w),92 : 87P,87,25,40,62.5,8,24,33.3,33,64,51.6,13,17,76.5,8,22,30,10,21,18,11,5,2,1,88,Biofarm Basket Poznań,Sezon 2017/2018
2018-02-24 17:00,Enea Astoria Bydgoszcz(d),83 : 62W,83,14,31,45.2,14,29,48.3,28,60,46.7,13,19,68.4,10,27,37,15,19,21,14,4,4,3,91,Biofarm Basket Poznań,Sezon 2017/2018
2018-03-07 18:00,Polfarmex Kutno(w),72 : 76W,76,17,39,43.6,8,21,38.1,25,60,41.7,18,23,78.3,12,25,37,11,18,21,13,9,3,2,83,Biofarm Basket Poznań,Sezon 2017/2018
2018-03-10 17:00,Zetkama Doral Nysa Kłodzko(d),73 : 43W,73,16,39,41.0,10,25,40.0,26,64,40.6,11,21,52.4,14,35,49,21,19,16,10,6,2,1,93,Biofarm Basket Poznań,Sezon 2017/2018
2018-03-18 15:00,KK Warszawa(w),74 : 102W,102,23,35,65.7,11,22,50.0,34,57,59.6,23,28,82.1,6,26,32,24,20,22,14,11,0,3,127,Biofarm Basket Poznań,Sezon 2017/2018
2018-03-21 17:00,Spójnia Stargard(d),72 : 74P,72,19,43,44.2,7,27,25.9,26,70,37.1,13,20,65.0,12,26,38,15,15,20,12,6,2,1,70,Biofarm Basket Poznań,Sezon 2017/2018
2018-03-24 18:00,KSK Noteć Inowrocław(w),84 : 88W,88,25,51,49.0,4,12,33.3,29,63,46.0,26,31,83.9,12,22,34,12,17,27,12,11,1,2,95,Biofarm Basket Poznań,Sezon 2017/2018
2018-03-31 15:00,Siarka Tarnobrzeg(d),84 : 71W,84,28,45,62.2,5,27,18.5,33,72,45.8,13,17,76.5,19,32,51,28,17,17,16,8,3,1,115,Biofarm Basket Poznań,Sezon 2017/2018
2018-04-08 18:00,Pogoń Prudnik(w),93 : 97W,97,28,42,66.7,9,24,37.5,37,66,56.1,14,21,66.7,9,19,28,17,22,22,13,9,2,1,104,Biofarm Basket Poznań,Sezon 2017/2018
2018-04-14 18:00,Spójnia Stargard(w),86 : 73P,73,20,51,39.2,7,20,35.0,27,71,38.0,12,15,80.0,11,29,40,17,21,14,19,9,3,4,76,Biofarm Basket Poznań,Sezon 2017/2018
2018-04-15 18:00,Spójnia Stargard(w),77 : 70P,70,15,40,37.5,8,23,34.8,23,63,36.5,16,19,84.2,10,27,37,5,20,20,14,6,3,2,64,Biofarm Basket Poznań,Sezon 2017/2018
2018-04-21 17:00,Spójnia Stargard(d),87 : 76W,87,21,41,51.2,10,31,32.3,31,72,43.1,15,26,57.7,12,22,34,12,16,23,5,7,3,2,86,Biofarm Basket Poznań,Sezon 2017/2018
2018-04-22 17:00,Spójnia Stargard(d),79 : 92P,79,18,33,54.5,10,29,34.5,28,62,45.2,13,15,86.7,8,22,30,17,21,16,14,5,2,2,83,Biofarm Basket Poznań,Sezon 2017/2018
2017-09-23 18:00,Spójnia Stargard(w),85 : 65P,65,18,36,50.0,5,27,18.5,23,63,36.5,14,19,73.7,16,25,41,10,17,18,18,6,3,4,62,Elektrobud-Investment ZB Pruszków,Sezon 2017/2018
2017-09-30 18:00,KSK Noteć Inowrocław(d),89 : 52W,89,25,36,69.4,8,27,29.6,33,63,52.4,15,18,83.3,8,32,40,20,14,20,16,9,0,1,109,Elektrobud-Investment ZB Pruszków,Sezon 2017/2018
2017-10-07 18:30,Siarka Tarnobrzeg(w),85 : 78P,78,19,36,52.8,10,22,45.5,29,58,50.0,10,19,52.6,5,24,29,9,21,19,16,9,3,2,74,Elektrobud-Investment ZB Pruszków,Sezon 2017/2018
2017-10-14 18:00,Pogoń Prudnik(d),71 : 72P,71,23,34,67.6,5,26,19.2,28,60,46.7,10,13,76.9,5,28,33,12,20,17,13,7,4,0,79,Elektrobud-Investment ZB Pruszków,Sezon 2017/2018
2017-10-18 18:00,Energa Kotwica Kołobrzeg(w),67 : 80W,80,21,34,61.8,7,21,33.3,28,55,50.9,17,26,65.4,11,28,39,16,21,22,18,7,2,2,90,Elektrobud-Investment ZB Pruszków,Sezon 2017/2018
2017-10-21 17:00,Biofarm Basket Poznań(w),72 : 82W,82,25,43,58.1,5,19,26.3,30,62,48.4,17,24,70.8,13,23,36,20,17,22,16,6,2,5,91,Elektrobud-Investment ZB Pruszków,Sezon 2017/2018
2017-10-29 18:00,SKK Siedlce(w),71 : 72W,72,21,38,55.3,6,16,37.5,27,54,50.0,12,18,66.7,9,25,34,16,19,22,18,9,2,2,82,Elektrobud-Investment ZB Pruszków,Sezon 2017/2018
2017-11-04 18:00,GKS Tychy(d),92 : 71W,92,19,31,61.3,12,33,36.4,31,64,48.4,18,19,94.7,13,18,31,19,23,21,15,13,2,0,108,Elektrobud-Investment ZB Pruszków,Sezon 2017/2018
2017-11-08 19:00,Jamalex Polonia 1912 Leszno(w),99 : 80P,80,18,44,40.9,6,15,40.0,24,59,40.7,26,36,72.2,10,17,27,14,22,29,15,4,3,1,68,Elektrobud-Investment ZB Pruszków,Sezon 2017/2018
2017-11-19 17:00,R8 Basket AZS Politechnika Kraków(d),62 : 64P,62,17,42,40.5,6,25,24.0,23,67,34.3,10,18,55.6,14,31,45,11,24,17,11,3,4,2,62,Elektrobud-Investment ZB Pruszków,Sezon 2017/2018
2017-11-25 17:30,Sokół Łańcut(w),87 : 81P,81,20,38,52.6,10,22,45.5,30,60,50.0,11,20,55.0,9,26,35,19,14,22,20,11,2,4,89,Elektrobud-Investment ZB Pruszków,Sezon 2017/2018
2017-12-02 18:00,WKS Śląsk Wrocław(d),81 : 82P,81,21,37,56.8,5,14,35.7,26,51,51.0,24,43,55.8,8,24,32,12,17,29,10,9,5,3,85,Elektrobud-Investment ZB Pruszków,Sezon 2017/2018
2017-12-06 18:00,Enea Astoria Bydgoszcz(w),75 : 82W,82,19,41,46.3,8,20,40.0,27,61,44.3,20,26,76.9,7,29,36,27,15,20,14,6,6,5,103,Elektrobud-Investment ZB Pruszków,Sezon 2017/2018
2017-12-10 17:00,Polfarmex Kutno(d),55 : 86P,55,20,35,57.1,3,17,17.6,23,52,44.2,6,10,60.0,3,15,18,7,18,18,17,5,2,3,37,Elektrobud-Investment ZB Pruszków,Sezon 2017/2018
2017-12-16 17:00,Zetkama Doral Nysa Kłodzko(w),76 : 66P,66,19,34,55.9,8,21,38.1,27,55,49.1,4,11,36.4,11,19,30,20,15,10,15,4,3,0,73,Elektrobud-Investment ZB Pruszków,Sezon 2017/2018
2017-12-22 19:00,KK Warszawa(d),80 : 46W,80,22,40,55.0,10,24,41.7,32,64,50.0,6,9,66.7,9,33,42,18,17,13,15,11,8,1,109,Elektrobud-Investment ZB Pruszków,Sezon 2017/2018
2018-01-06 18:00,Spójnia Stargard(d),79 : 103P,79,21,37,56.8,7,22,31.8,28,59,47.5,16,19,84.2,6,19,25,18,23,17,15,6,1,2,80,Elektrobud-Investment ZB Pruszków,Sezon 2017/2018
2018-01-13 18:00,KSK Noteć Inowrocław(w),65 : 91W,91,21,33,63.6,14,26,53.8,35,59,59.3,7,11,63.6,5,25,30,26,19,17,19,8,2,1,110,Elektrobud-Investment ZB Pruszków,Sezon 2017/2018
2018-01-20 18:00,Siarka Tarnobrzeg(d),84 : 75W,84,26,46,56.5,5,22,22.7,31,68,45.6,17,27,63.0,13,36,49,18,20,24,17,9,6,4,102,Elektrobud-Investment ZB Pruszków,Sezon 2017/2018
2018-01-27 17:30,Pogoń Prudnik(w),67 : 83W,83,16,38,42.1,11,20,55.0,27,58,46.6,18,28,64.3,10,26,36,20,22,22,11,7,2,2,96,Elektrobud-Investment ZB Pruszków,Sezon 2017/2018
2018-01-31 19:00,Energa Kotwica Kołobrzeg(d),88 : 81W,88,15,29,51.7,15,35,42.9,30,64,46.9,13,18,72.2,16,27,43,17,20,21,21,9,5,1,102,Elektrobud-Investment ZB Pruszków,Sezon 2017/2018
2018-02-04 17:00,Biofarm Basket Poznań(d),88 : 90P,88,26,45,57.8,7,22,31.8,33,67,49.3,15,17,88.2,14,18,32,22,21,19,14,6,3,5,101,Elektrobud-Investment ZB Pruszków,Sezon 2017/2018
2018-02-10 18:00,SKK Siedlce(d),80 : 71W,80,17,33,51.5,10,25,40.0,27,58,46.6,16,21,76.2,11,30,41,18,20,19,19,8,4,1,96,Elektrobud-Investment ZB Pruszków,Sezon 2017/2018
2018-02-17 18:00,GKS Tychy(w),104 : 97P,97,23,30,76.7,9,21,42.9,32,51,62.7,24,28,85.7,1,26,27,15,31,26,20,6,2,0,104,Elektrobud-Investment ZB Pruszków,Sezon 2017/2018
2018-02-21 19:00,Jamalex Polonia 1912 Leszno(d),76 : 68W,76,18,32,56.3,6,28,21.4,24,60,40.0,22,25,88.0,9,28,37,17,23,23,16,5,2,0,82,Elektrobud-Investment ZB Pruszków,Sezon 2017/2018
2018-03-03 17:00,R8 Basket AZS Politechnika Kraków(w),83 : 58P,58,18,35,51.4,4,16,25.0,22,51,43.1,10,20,50.0,4,24,28,14,14,18,14,4,3,2,54,Elektrobud-Investment ZB Pruszków,Sezon 2017/2018
2018-03-11 17:00,Sokół Łańcut(d),83 : 73W,83,21,33,63.6,10,22,45.5,31,55,56.4,11,13,84.6,5,30,35,19,23,19,21,7,3,1,100,Elektrobud-Investment ZB Pruszków,Sezon 2017/2018
2018-03-18 18:30,WKS Śląsk Wrocław(w),82 : 81P,81,22,46,47.8,5,17,29.4,27,63,42.9,22,27,81.5,6,24,30,8,19,23,14,9,0,7,73,Elektrobud-Investment ZB Pruszków,Sezon 2017/2018
2018-03-21 20:00,Enea Astoria Bydgoszcz(d),85 : 69W,85,21,41,51.2,9,18,50.0,30,59,50.8,16,26,61.5,12,27,39,19,23,22,26,13,2,2,93,Elektrobud-Investment ZB Pruszków,Sezon 2017/2018
2018-03-24 17:30,Polfarmex Kutno(w),95 : 88P,88,25,42,59.5,8,26,30.8,33,68,48.5,14,21,66.7,12,22,34,16,16,20,12,6,1,5,91,Elektrobud-Investment ZB Pruszków,Sezon 2017/2018
2018-03-31 16:00,Zetkama Doral Nysa Kłodzko(d),63 : 61W,63,18,37,48.6,5,18,27.8,23,55,41.8,12,15,80.0,10,23,33,12,16,17,21,9,4,2,65,Elektrobud-Investment ZB Pruszków,Sezon 2017/2018
2018-04-08 18:00,KK Warszawa(w),63 : 75W,75,18,33,54.5,7,23,30.4,25,56,44.6,18,19,94.7,8,29,37,14,21,14,17,6,6,2,89,Elektrobud-Investment ZB Pruszków,Sezon 2017/2018
2018-04-14 18:30,Jamalex Polonia 1912 Leszno(w),81 : 65P,65,13,37,35.1,9,15,60.0,22,52,42.3,12,15,80.0,7,22,29,14,17,16,16,5,3,4,67,Elektrobud-Investment ZB Pruszków,Sezon 2017/2018
2018-04-15 16:00,Jamalex Polonia 1912 Leszno(w),60 : 71W,71,24,44,54.5,2,19,10.5,26,63,41.3,17,23,73.9,8,33,41,11,21,26,23,8,6,1,71,Elektrobud-Investment ZB Pruszków,Sezon 2017/2018
2018-04-21 18:00,Jamalex Polonia 1912 Leszno(d),65 : 73P,65,12,28,42.9,5,22,22.7,17,50,34.0,26,33,78.8,10,28,38,13,23,22,17,8,1,1,68,Elektrobud-Investment ZB Pruszków,Sezon 2017/2018
2018-04-22 17:00,Jamalex Polonia 1912 Leszno(d),60 : 66P,60,18,32,56.3,6,25,24.0,24,57,42.1,6,10,60.0,6,25,31,10,17,17,13,1,3,0,55,Elektrobud-Investment ZB Pruszków,Sezon 2017/2018
2017-10-01 17:00,Polfarmex Kutno(d),62 : 73P,62,19,38,50.0,5,19,26.3,24,57,42.1,9,10,90.0,8,32,40,14,26,16,20,6,3,1,71,Enea Astoria Bydgoszcz,Sezon 2017/2018
2017-10-07 17:00,Zetkama Doral Nysa Kłodzko(w),79 : 98W,98,30,48,62.5,8,17,47.1,38,65,58.5,14,20,70.0,9,27,36,21,22,26,13,5,1,3,115,Enea Astoria Bydgoszcz,Sezon 2017/2018
2017-10-15 19:00,KK Warszawa(w),76 : 86W,86,26,47,55.3,5,11,45.5,31,58,53.4,19,27,70.4,9,24,33,16,15,24,15,13,1,3,99,Enea Astoria Bydgoszcz,Sezon 2017/2018
2017-10-18 18:00,Spójnia Stargard(w),89 : 84P,84,28,54,51.9,6,18,33.3,34,72,47.2,10,17,58.8,11,26,37,13,16,18,14,9,2,6,86,Enea Astoria Bydgoszcz,Sezon 2017/2018
2017-10-21 17:00,KSK Noteć Inowrocław(d),118 : 61W,118,36,53,67.9,7,21,33.3,43,74,58.1,25,31,80.6,13,29,42,20,22,28,9,17,3,1,154,Enea Astoria Bydgoszcz,Sezon 2017/2018
2017-10-28 18:30,Siarka Tarnobrzeg(w),77 : 68P,68,20,55,36.4,3,13,23.1,23,68,33.8,19,30,63.3,14,29,43,8,22,23,16,10,1,6,58,Enea Astoria Bydgoszcz,Sezon 2017/2018
2017-11-04 18:00,Pogoń Prudnik(d),101 : 69W,101,33,56,58.9,5,14,35.7,38,70,54.3,20,24,83.3,9,29,38,28,19,26,10,9,4,3,134,Enea Astoria Bydgoszcz,Sezon 2017/2018
2017-11-08 19:00,Energa Kotwica Kołobrzeg(w),83 : 80P,80,21,49,42.9,6,14,42.9,27,63,42.9,20,31,64.5,17,28,45,12,23,24,21,9,0,3,78,Enea Astoria Bydgoszcz,Sezon 2017/2018
2017-11-12 17:00,Biofarm Basket Poznań(d),69 : 68W,69,20,44,45.5,6,22,27.3,26,66,39.4,11,19,57.9,15,23,38,17,21,18,14,7,3,2,72,Enea Astoria Bydgoszcz,Sezon 2017/2018
2017-11-18 18:00,SKK Siedlce(w),85 : 79P,79,24,53,45.3,4,20,20.0,28,73,38.4,19,28,67.9,18,23,41,15,17,23,14,11,2,3,80,Enea Astoria Bydgoszcz,Sezon 2017/2018
2017-11-25 19:00,GKS Tychy(w),103 : 94P,94,27,45,60.0,10,20,50.0,37,65,56.9,10,14,71.4,7,14,21,11,16,17,18,9,2,5,87,Enea Astoria Bydgoszcz,Sezon 2017/2018
2017-12-02 19:00,Jamalex Polonia 1912 Leszno(w),82 : 67P,67,21,53,39.6,4,18,22.2,25,71,35.2,13,19,68.4,14,22,36,6,20,20,18,6,2,8,47,Enea Astoria Bydgoszcz,Sezon 2017/2018
2017-12-06 18:00,Elektrobud-Investment ZB Pruszków(d),75 : 82P,75,24,46,52.2,6,29,20.7,30,75,40.0,9,11,81.8,12,25,37,18,20,15,11,9,5,6,86,Enea Astoria Bydgoszcz,Sezon 2017/2018
2017-12-09 18:00,R8 Basket AZS Politechnika Kraków(w),75 : 59P,59,23,51,45.1,2,21,9.5,25,72,34.7,7,14,50.0,14,27,41,15,16,20,12,3,1,3,53,Enea Astoria Bydgoszcz,Sezon 2017/2018
2017-12-16 17:00,Sokół Łańcut(d),80 : 75W,80,32,57,56.1,1,7,14.3,33,64,51.6,13,24,54.2,11,26,37,16,22,26,14,1,0,3,78,Enea Astoria Bydgoszcz,Sezon 2017/2018
2017-12-20 19:00,WKS Śląsk Wrocław(w),89 : 71P,71,19,44,43.2,5,11,45.5,24,55,43.6,18,30,60.0,7,22,29,17,16,25,18,6,3,5,65,Enea Astoria Bydgoszcz,Sezon 2017/2018
2018-01-13 16:30,Polfarmex Kutno(w),65 : 63P,63,24,53,45.3,0,6,0.0,24,59,40.7,15,16,93.8,10,23,33,4,24,18,13,4,1,3,56,Enea Astoria Bydgoszcz,Sezon 2017/2018
2018-01-20 17:00,Zetkama Doral Nysa Kłodzko(d),89 : 90P,89,24,48,50.0,6,15,40.0,30,63,47.6,23,37,62.2,11,22,33,20,23,28,18,10,1,1,88,Enea Astoria Bydgoszcz,Sezon 2017/2018
2018-01-27 17:00,KK Warszawa(d),96 : 55W,96,24,43,55.8,8,21,38.1,32,64,50.0,24,28,85.7,8,38,46,28,25,23,15,17,0,1,136,Enea Astoria Bydgoszcz,Sezon 2017/2018
2018-01-31 18:30,Spójnia Stargard(d),76 : 88P,76,24,45,53.3,4,13,30.8,28,58,48.3,16,23,69.6,9,21,30,18,17,20,22,9,3,4,77,Enea Astoria Bydgoszcz,Sezon 2017/2018
2018-02-03 18:00,KSK Noteć Inowrocław(w),61 : 98W,98,31,44,70.5,7,18,38.9,38,62,61.3,15,20,75.0,9,26,35,25,21,21,12,10,3,2,130,Enea Astoria Bydgoszcz,Sezon 2017/2018
2018-02-10 17:00,Siarka Tarnobrzeg(d),87 : 74W,87,26,44,59.1,5,11,45.5,31,55,56.4,20,38,52.6,6,28,34,18,18,29,15,9,2,6,93,Enea Astoria Bydgoszcz,Sezon 2017/2018
2018-02-17 17:30,Pogoń Prudnik(w),83 : 90W,90,26,47,55.3,7,13,53.8,33,60,55.0,17,22,77.3,5,24,29,22,23,22,10,7,3,3,109,Enea Astoria Bydgoszcz,Sezon 2017/2018
2018-02-21 18:30,Energa Kotwica Kołobrzeg(d),96 : 80W,96,28,45,62.2,8,22,36.4,36,67,53.7,16,20,80.0,6,27,33,21,21,24,11,10,5,2,119,Enea Astoria Bydgoszcz,Sezon 2017/2018
2018-02-24 17:00,Biofarm Basket Poznań(w),83 : 62P,62,20,41,48.8,3,15,20.0,23,56,41.1,13,20,65.0,6,23,29,14,21,19,15,8,3,4,61,Enea Astoria Bydgoszcz,Sezon 2017/2018
2018-03-03 17:00,SKK Siedlce(d),87 : 75W,87,19,42,45.2,7,22,31.8,26,64,40.6,28,38,73.7,14,31,45,18,17,31,23,10,2,3,91,Enea Astoria Bydgoszcz,Sezon 2017/2018
2018-03-11 17:00,GKS Tychy(d),99 : 75W,99,32,49,65.3,8,23,34.8,40,72,55.6,11,15,73.3,12,26,38,27,19,17,18,12,3,1,125,Enea Astoria Bydgoszcz,Sezon 2017/2018
2018-03-17 17:00,Jamalex Polonia 1912 Leszno(d),89 : 79W,89,26,37,70.3,5,15,33.3,31,52,59.6,22,29,75.9,5,20,25,22,19,21,21,14,1,1,102,Enea Astoria Bydgoszcz,Sezon 2017/2018
2018-03-21 20:00,Elektrobud-Investment ZB Pruszków(w),85 : 69P,69,19,44,43.2,6,21,28.6,25,65,38.5,13,21,61.9,12,16,28,17,23,23,20,21,2,2,69,Enea Astoria Bydgoszcz,Sezon 2017/2018
2018-03-24 17:00,R8 Basket AZS Politechnika Kraków(d),81 : 86P,81,23,39,59.0,9,22,40.9,32,61,52.5,8,12,66.7,7,19,26,22,20,15,15,7,2,1,90,Enea Astoria Bydgoszcz,Sezon 2017/2018
2018-03-29 15:30,Sokół Łańcut(w),81 : 71P,71,21,51,41.2,8,14,57.1,29,65,44.6,5,9,55.6,15,21,36,17,25,16,21,3,1,5,67,Enea Astoria Bydgoszcz,Sezon 2017/2018
2018-04-08 18:00,WKS Śląsk Wrocław(d),73 : 71W,73,27,56,48.2,3,9,33.3,30,65,46.2,10,14,71.4,2,30,32,17,18,19,12,9,2,4,82,Enea Astoria Bydgoszcz,Sezon 2017/2018
2017-09-23 18:00,Biofarm Basket Poznań(d),49 : 69P,49,14,34,41.2,5,20,25.0,19,54,35.2,6,8,75.0,4,21,25,10,13,16,13,8,0,2,42,Energa Kotwica Kołobrzeg,Sezon 2017/2018
2017-09-30 16:00,SKK Siedlce(w),63 : 69W,69,23,44,52.3,5,19,26.3,28,63,44.4,8,9,88.9,5,30,35,19,19,15,13,6,0,6,80,Energa Kotwica Kołobrzeg,Sezon 2017/2018
2017-10-07 19:00,GKS Tychy(d),89 : 81W,89,18,25,72.0,11,29,37.9,29,54,53.7,20,30,66.7,10,34,44,21,25,24,13,3,3,2,112,Energa Kotwica Kołobrzeg,Sezon 2017/2018
2017-10-09 19:00,Sokół Łańcut(d),77 : 85P,77,23,45,51.1,9,22,40.9,32,67,47.8,4,5,80.0,5,26,31,24,21,15,12,4,0,3,88,Energa Kotwica Kołobrzeg,Sezon 2017/2018
2017-10-13 20:00,Jamalex Polonia 1912 Leszno(w),92 : 75P,75,20,33,60.6,8,19,42.1,28,52,53.8,11,13,84.6,3,21,24,14,16,18,17,2,0,0,72,Energa Kotwica Kołobrzeg,Sezon 2017/2018
2017-10-18 18:00,Elektrobud-Investment ZB Pruszków(d),67 : 80P,67,14,36,38.9,8,23,34.8,22,59,37.3,15,21,71.4,9,21,30,16,23,20,15,7,2,2,64,Energa Kotwica Kołobrzeg,Sezon 2017/2018
2017-10-21 17:00,R8 Basket AZS Politechnika Kraków(w),87 : 62P,62,23,41,56.1,3,15,20.0,26,56,46.4,7,11,63.6,9,23,32,23,11,17,19,4,0,2,68,Energa Kotwica Kołobrzeg,Sezon 2017/2018
2017-11-04 18:00,WKS Śląsk Wrocław(w),73 : 74W,74,21,49,42.9,7,23,30.4,28,72,38.9,11,15,73.3,9,26,35,15,15,16,9,9,0,7,76,Energa Kotwica Kołobrzeg,Sezon 2017/2018
2017-11-08 19:00,Enea Astoria Bydgoszcz(d),83 : 80W,83,20,38,52.6,10,23,43.5,30,61,49.2,13,17,76.5,4,20,24,20,25,23,14,11,3,0,92,Energa Kotwica Kołobrzeg,Sezon 2017/2018
2017-11-11 17:30,Polfarmex Kutno(w),100 : 84P,84,16,31,51.6,9,23,39.1,25,54,46.3,25,29,86.2,4,24,28,17,16,25,16,4,4,1,88,Energa Kotwica Kołobrzeg,Sezon 2017/2018
2017-11-19 17:00,Zetkama Doral Nysa Kłodzko(d),60 : 63P,60,17,33,51.5,7,22,31.8,24,55,43.6,5,14,35.7,4,20,24,15,18,19,14,16,1,3,62,Energa Kotwica Kołobrzeg,Sezon 2017/2018
2017-11-26 18:00,KK Warszawa(w),71 : 76W,76,19,32,59.4,7,18,38.9,26,50,52.0,17,20,85.0,6,26,32,11,17,17,24,6,1,2,75,Energa Kotwica Kołobrzeg,Sezon 2017/2018
2017-12-02 18:00,Spójnia Stargard(d),82 : 89P,82,23,48,47.9,9,21,42.9,32,69,46.4,9,21,42.9,15,20,35,18,15,18,9,7,0,3,84,Energa Kotwica Kołobrzeg,Sezon 2017/2018
2017-12-06 18:00,KSK Noteć Inowrocław(w),73 : 89W,89,25,45,55.6,8,23,34.8,33,68,48.5,15,26,57.7,17,24,41,16,18,20,19,13,3,3,97,Energa Kotwica Kołobrzeg,Sezon 2017/2018
2017-12-09 18:00,Siarka Tarnobrzeg(d),85 : 76W,85,25,49,51.0,10,27,37.0,35,76,46.1,5,7,71.4,10,29,39,22,21,10,12,9,6,2,106,Energa Kotwica Kołobrzeg,Sezon 2017/2018
2017-12-16 17:30,Pogoń Prudnik(w),92 : 65P,65,19,40,47.5,5,20,25.0,24,60,40.0,12,17,70.6,3,25,28,13,19,18,11,2,2,3,58,Energa Kotwica Kołobrzeg,Sezon 2017/2018
2018-01-06 17:00,Biofarm Basket Poznań(w),85 : 81P,81,18,40,45.0,9,22,40.9,27,62,43.5,18,20,90.0,6,28,34,18,22,22,16,9,1,4,90,Energa Kotwica Kołobrzeg,Sezon 2017/2018
2018-01-14 17:00,SKK Siedlce(d),81 : 68W,81,12,26,46.2,14,31,45.2,26,57,45.6,15,23,65.2,4,32,36,20,18,19,14,8,0,1,92,Energa Kotwica Kołobrzeg,Sezon 2017/2018
2018-01-20 19:00,GKS Tychy(w),99 : 75P,75,21,46,45.7,7,24,29.2,28,70,40.0,12,14,85.7,13,17,30,13,13,18,18,6,2,3,64,Energa Kotwica Kołobrzeg,Sezon 2017/2018
2018-01-26 18:00,Jamalex Polonia 1912 Leszno(d),72 : 87P,72,24,39,61.5,5,15,33.3,29,54,53.7,9,14,64.3,8,24,32,18,18,22,20,7,1,0,80,Energa Kotwica Kołobrzeg,Sezon 2017/2018
2018-01-31 19:00,Elektrobud-Investment ZB Pruszków(w),88 : 81P,81,20,40,50.0,8,25,32.0,28,65,43.1,17,24,70.8,9,23,32,17,21,20,14,11,1,5,84,Energa Kotwica Kołobrzeg,Sezon 2017/2018
2018-02-03 17:00,R8 Basket AZS Politechnika Kraków(d),83 : 82W,83,19,35,54.3,12,33,36.4,31,68,45.6,9,18,50.0,7,28,35,19,17,17,12,4,2,2,85,Energa Kotwica Kołobrzeg,Sezon 2017/2018
2018-02-17 18:00,WKS Śląsk Wrocław(d),77 : 82P,77,22,45,48.9,5,16,31.3,27,61,44.3,18,26,69.2,9,25,34,14,23,23,10,7,2,2,82,Energa Kotwica Kołobrzeg,Sezon 2017/2018
2018-02-21 18:30,Enea Astoria Bydgoszcz(w),96 : 80P,80,17,38,44.7,10,26,38.5,27,64,42.2,16,19,84.2,6,21,27,18,24,21,16,6,2,5,77,Energa Kotwica Kołobrzeg,Sezon 2017/2018
2018-02-24 18:00,Polfarmex Kutno(d),58 : 77P,58,18,37,48.6,4,17,23.5,22,54,40.7,10,15,66.7,4,29,33,15,20,12,20,7,1,0,57,Energa Kotwica Kołobrzeg,Sezon 2017/2018
2018-03-07 19:30,Zetkama Doral Nysa Kłodzko(w),79 : 57P,57,14,41,34.1,5,18,27.8,19,59,32.2,14,21,66.7,9,17,26,15,13,22,10,7,1,4,49,Energa Kotwica Kołobrzeg,Sezon 2017/2018
2018-03-11 17:00,KK Warszawa(d),72 : 70W,72,24,42,57.1,3,26,11.5,27,68,39.7,15,32,46.9,9,41,50,17,29,29,13,11,2,1,81,Energa Kotwica Kołobrzeg,Sezon 2017/2018
2018-03-17 18:30,Spójnia Stargard(w),92 : 76P,76,29,52,55.8,3,23,13.0,32,75,42.7,9,10,90.0,14,15,29,13,24,17,12,15,0,3,77,Energa Kotwica Kołobrzeg,Sezon 2017/2018
2018-03-21 18:00,KSK Noteć Inowrocław(d),76 : 56W,76,31,40,77.5,3,21,14.3,34,61,55.7,5,11,45.5,4,27,31,24,14,15,10,11,0,2,99,Energa Kotwica Kołobrzeg,Sezon 2017/2018
2018-03-24 18:30,Siarka Tarnobrzeg(w),75 : 86W,86,25,42,59.5,9,18,50.0,34,60,56.7,9,13,69.2,7,29,36,21,15,16,15,7,0,3,105,Energa Kotwica Kołobrzeg,Sezon 2017/2018
2018-03-26 17:00,Sokół Łańcut(w),76 : 62P,62,18,36,50.0,4,21,19.0,22,57,38.6,14,23,60.9,7,27,34,15,25,18,14,6,0,0,59,Energa Kotwica Kołobrzeg,Sezon 2017/2018
2018-03-30 18:30,Pogoń Prudnik(d),88 : 67W,88,20,40,50.0,13,28,46.4,33,68,48.5,9,14,64.3,8,23,31,29,23,17,12,20,0,5,116,Energa Kotwica Kołobrzeg,Sezon 2017/2018
2018-04-13 18:00,KK Warszawa(d),76 : 64W,76,25,38,65.8,6,28,21.4,31,66,47.0,8,14,57.1,8,15,23,20,16,17,4,8,1,1,83,Energa Kotwica Kołobrzeg,Sezon 2017/2018
2018-04-14 20:00,KK Warszawa(d),66 : 72P,66,15,29,51.7,8,27,29.6,23,56,41.1,12,15,80.0,8,25,33,17,23,19,12,10,1,1,79,Energa Kotwica Kołobrzeg,Sezon 2017/2018
2018-04-21 14:30,KK Warszawa(w),68 : 80W,80,20,39,51.3,10,22,45.5,30,61,49.2,10,16,62.5,9,26,35,15,24,16,19,5,2,1,81,Energa Kotwica Kołobrzeg,Sezon 2017/2018
2018-04-22 18:00,KK Warszawa(w),90 : 92W,92,25,47,53.2,12,32,37.5,37,79,46.8,6,10,60.0,13,28,41,25,19,16,17,10,5,3,110,Energa Kotwica Kołobrzeg,Sezon 2017/2018
2017-09-23 18:00,Siarka Tarnobrzeg(w),72 : 81W,81,25,40,62.5,4,16,25.0,29,56,51.8,19,23,82.6,7,25,32,11,18,25,14,13,2,1,94,GKS Tychy,Sezon 2017/2018
2017-09-30 19:00,Pogoń Prudnik(d),103 : 76W,103,25,42,59.5,11,25,44.0,36,67,53.7,20,25,80.0,8,32,40,27,19,20,10,7,4,2,135,GKS Tychy,Sezon 2017/2018
2017-10-07 19:00,Energa Kotwica Kołobrzeg(w),89 : 81P,81,20,37,54.1,10,32,31.3,30,69,43.5,11,19,57.9,11,19,30,12,24,24,7,7,2,3,78,GKS Tychy,Sezon 2017/2018
2017-10-14 19:00,Biofarm Basket Poznań(d),95 : 91W,95,24,47,51.1,7,19,36.8,31,66,47.0,26,33,78.8,13,22,35,16,21,28,8,9,0,2,105,GKS Tychy,Sezon 2017/2018
2017-10-18 18:00,SKK Siedlce(w),90 : 97W,97,22,40,55.0,8,21,38.1,30,61,49.2,29,33,87.9,8,18,26,23,20,26,9,10,4,1,116,GKS Tychy,Sezon 2017/2018
2017-10-28 18:00,Jamalex Polonia 1912 Leszno(d),85 : 108P,85,16,28,57.1,11,27,40.7,27,55,49.1,20,26,76.9,4,19,23,18,26,24,17,6,2,3,83,GKS Tychy,Sezon 2017/2018
2017-11-04 18:00,Elektrobud-Investment ZB Pruszków(w),92 : 71P,71,16,30,53.3,8,20,40.0,24,50,48.0,17,27,63.0,5,14,19,14,22,23,22,10,0,2,56,GKS Tychy,Sezon 2017/2018
2017-11-08 19:00,R8 Basket AZS Politechnika Kraków(d),91 : 96P,91,20,36,55.6,11,31,35.5,31,67,46.3,18,21,85.7,14,20,34,13,23,23,14,5,0,4,90,GKS Tychy,Sezon 2017/2018
2017-11-11 17:30,Sokół Łańcut(w),81 : 74P,74,17,51,33.3,9,19,47.4,26,70,37.1,13,16,81.3,13,21,34,13,25,19,10,7,1,7,72,GKS Tychy,Sezon 2017/2018
2017-11-18 19:00,WKS Śląsk Wrocław(d),96 : 88W,96,26,45,57.8,8,26,30.8,34,71,47.9,20,22,90.9,13,24,37,21,19,19,9,7,2,3,115,GKS Tychy,Sezon 2017/2018
2017-11-25 19:00,Enea Astoria Bydgoszcz(d),103 : 94W,103,29,40,72.5,12,27,44.4,41,67,61.2,9,13,69.2,9,18,27,20,17,16,19,12,5,2,118,GKS Tychy,Sezon 2017/2018
2017-12-02 18:00,Polfarmex Kutno(d),80 : 93P,80,14,24,58.3,9,28,32.1,23,52,44.2,25,27,92.6,5,22,27,14,21,21,13,8,2,0,87,GKS Tychy,Sezon 2017/2018
2017-12-06 19:30,Zetkama Doral Nysa Kłodzko(w),59 : 56P,56,12,30,40.0,8,30,26.7,20,60,33.3,8,16,50.0,11,26,37,14,19,14,13,2,0,8,48,GKS Tychy,Sezon 2017/2018
2017-12-09 18:00,KK Warszawa(d),83 : 73W,83,17,25,68.0,12,25,48.0,29,50,58.0,13,16,81.3,4,27,31,21,19,15,21,9,2,0,101,GKS Tychy,Sezon 2017/2018
2017-12-16 18:00,Spójnia Stargard(w),102 : 74P,74,20,32,62.5,5,26,19.2,25,58,43.1,19,27,70.4,9,13,22,13,23,24,14,7,2,0,63,GKS Tychy,Sezon 2017/2018
2017-12-22 18:00,KSK Noteć Inowrocław(d),104 : 62W,104,29,46,63.0,12,21,57.1,41,67,61.2,10,13,76.9,8,26,34,26,17,14,9,7,1,2,134,GKS Tychy,Sezon 2017/2018
2018-01-06 18:00,Siarka Tarnobrzeg(d),91 : 70W,91,24,37,64.9,9,28,32.1,33,65,50.8,16,19,84.2,8,21,29,24,21,21,12,8,1,4,106,GKS Tychy,Sezon 2017/2018
2018-01-13 17:30,Pogoń Prudnik(w),86 : 91W,91,23,40,57.5,7,24,29.2,30,64,46.9,24,27,88.9,11,24,35,12,25,24,13,5,1,2,94,GKS Tychy,Sezon 2017/2018
2018-01-20 19:00,Energa Kotwica Kołobrzeg(d),99 : 75W,99,31,44,70.5,11,29,37.9,42,73,57.5,4,6,66.7,9,27,36,21,19,13,13,13,3,2,126,GKS Tychy,Sezon 2017/2018
2018-01-27 17:00,Biofarm Basket Poznań(w),87 : 93W,93,18,33,54.5,9,23,39.1,27,56,48.2,30,34,88.2,12,27,39,10,24,24,26,9,1,2,93,GKS Tychy,Sezon 2017/2018
2018-01-31 19:00,SKK Siedlce(d),96 : 76W,96,22,34,64.7,12,36,33.3,34,70,48.6,16,20,80.0,9,26,35,21,22,22,15,11,2,1,110,GKS Tychy,Sezon 2017/2018
2018-02-11 19:30,Jamalex Polonia 1912 Leszno(w),90 : 83P,83,17,33,51.5,11,29,37.9,28,62,45.2,16,19,84.2,6,18,24,14,23,21,13,10,1,1,82,GKS Tychy,Sezon 2017/2018
2018-02-17 18:00,Elektrobud-Investment ZB Pruszków(d),104 : 97W,104,19,39,48.7,9,25,36.0,28,64,43.8,39,41,95.1,8,17,25,17,26,31,11,9,0,2,106,GKS Tychy,Sezon 2017/2018
2018-02-21 19:00,R8 Basket AZS Politechnika Kraków(w),81 : 83W,83,25,39,64.1,6,21,28.6,31,60,51.7,15,22,68.2,7,28,35,18,18,22,10,5,0,1,95,GKS Tychy,Sezon 2017/2018
2018-02-24 19:00,Sokół Łańcut(d),104 : 83W,104,22,33,66.7,17,34,50.0,39,67,58.2,9,9,100.0,7,23,30,25,20,11,13,9,0,2,127,GKS Tychy,Sezon 2017/2018
2018-03-04 20:30,WKS Śląsk Wrocław(w),94 : 86P,86,16,33,48.5,8,18,44.4,24,51,47.1,30,45,66.7,4,19,23,10,24,32,11,4,2,3,72,GKS Tychy,Sezon 2017/2018
2018-03-11 17:00,Enea Astoria Bydgoszcz(w),99 : 75P,75,21,38,55.3,5,24,20.8,26,62,41.9,18,21,85.7,5,17,22,23,19,18,18,11,1,3,75,GKS Tychy,Sezon 2017/2018
2018-03-17 17:30,Polfarmex Kutno(w),64 : 79W,79,16,37,43.2,8,23,34.8,24,60,40.0,23,30,76.7,12,23,35,15,17,26,13,4,3,3,80,GKS Tychy,Sezon 2017/2018
2018-03-21 19:00,Zetkama Doral Nysa Kłodzko(d),102 : 79W,102,17,24,70.8,18,31,58.1,35,55,63.6,14,16,87.5,5,18,23,15,21,22,14,8,1,3,113,GKS Tychy,Sezon 2017/2018
2018-03-25 15:00,KK Warszawa(w),78 : 100W,100,29,39,74.4,6,22,27.3,35,61,57.4,24,27,88.9,6,28,34,22,17,21,15,9,1,2,122,GKS Tychy,Sezon 2017/2018
2018-03-29 18:00,Spójnia Stargard(d),100 : 91W,100,28,44,63.6,10,26,38.5,38,70,54.3,14,16,87.5,11,18,29,23,22,16,10,5,2,3,115,GKS Tychy,Sezon 2017/2018
2018-04-08 18:00,KSK Noteć Inowrocław(w),72 : 78W,78,20,29,69.0,7,24,29.2,27,53,50.9,17,23,73.9,12,32,44,12,25,24,26,6,3,2,85,GKS Tychy,Sezon 2017/2018
2018-04-14 17:00,R8 Basket AZS Politechnika Kraków(w),91 : 85P,85,21,41,51.2,10,34,29.4,31,75,41.3,13,20,65.0,15,21,36,22,24,24,13,7,2,3,88,GKS Tychy,Sezon 2017/2018
2018-04-15 17:00,R8 Basket AZS Politechnika Kraków(w),90 : 94W,94,14,27,51.9,17,31,54.8,31,58,53.4,15,18,83.3,6,18,24,22,23,21,15,5,1,2,101,GKS Tychy,Sezon 2017/2018
2018-04-21 18:00,R8 Basket AZS Politechnika Kraków(d),103 : 93W,103,23,35,65.7,15,30,50.0,38,65,58.5,12,14,85.7,12,16,28,15,26,17,13,4,1,1,109,GKS Tychy,Sezon 2017/2018
2018-04-22 18:00,R8 Basket AZS Politechnika Kraków(d),113 : 105W,113,21,42,50.0,16,28,57.1,37,70,52.9,23,25,92.0,12,14,26,18,23,23,12,8,1,3,119,GKS Tychy,Sezon 2017/2018
2018-04-28 18:00,Spójnia Stargard(w),85 : 61P,61,17,33,51.5,5,29,17.2,22,62,35.5,12,20,60.0,11,16,27,14,17,22,11,11,0,3,54,GKS Tychy,Sezon 2017/2018
2018-04-29 18:00,Spójnia Stargard(w),93 : 77P,77,22,38,57.9,7,20,35.0,29,58,50.0,12,19,63.2,4,17,21,13,18,21,12,8,0,1,71,GKS Tychy,Sezon 2017/2018
2018-05-05 18:00,Spójnia Stargard(d),122 : 126P,122,23,38,60.5,19,36,52.8,42,74,56.8,19,21,90.5,6,23,29,27,24,23,18,5,3,2,134,GKS Tychy,Sezon 2017/2018
2018-05-12 18:00,Jamalex Polonia 1912 Leszno(d),105 : 94W,105,28,44,63.6,9,20,45.0,37,64,57.8,22,23,95.7,9,26,35,28,23,23,13,6,5,2,138,GKS Tychy,Sezon 2017/2018
2018-05-19 16:00,Jamalex Polonia 1912 Leszno(w),85 : 67P,67,17,37,45.9,6,26,23.1,23,63,36.5,15,27,55.6,11,21,32,11,24,25,12,8,0,2,54,GKS Tychy,Sezon 2017/2018
2017-09-24 18:00,KSK Noteć Inowrocław(w),58 : 102W,102,26,35,74.3,7,19,36.8,33,54,61.1,29,40,72.5,3,24,27,15,21,32,10,17,3,0,122,Jamalex Polonia 1912 Leszno,Sezon 2017/2018
2017-09-30 19:00,Siarka Tarnobrzeg(d),97 : 61W,97,27,37,73.0,10,26,38.5,37,63,58.7,13,19,68.4,6,24,30,23,26,24,7,6,2,1,119,Jamalex Polonia 1912 Leszno,Sezon 2017/2018
2017-10-07 17:30,Pogoń Prudnik(w),63 : 75W,75,15,36,41.7,7,27,25.9,22,63,34.9,24,31,77.4,12,28,40,10,18,23,13,7,1,2,72,Jamalex Polonia 1912 Leszno,Sezon 2017/2018
2017-10-13 20:00,Energa Kotwica Kołobrzeg(d),92 : 75W,92,21,36,58.3,13,34,38.2,34,70,48.6,11,14,78.6,11,19,30,22,19,15,9,9,0,0,105,Jamalex Polonia 1912 Leszno,Sezon 2017/2018
2017-10-18 17:00,Biofarm Basket Poznań(w),71 : 68P,68,18,46,39.1,8,27,29.6,26,73,35.6,8,12,66.7,14,23,37,9,26,17,8,7,1,3,63,Jamalex Polonia 1912 Leszno,Sezon 2017/2018
2017-10-21 18:00,SKK Siedlce(d),94 : 87W,94,20,43,46.5,12,31,38.7,32,74,43.2,18,29,62.1,13,24,37,16,21,25,16,13,2,5,93,Jamalex Polonia 1912 Leszno,Sezon 2017/2018
2017-10-28 18:00,GKS Tychy(w),85 : 108W,108,28,42,66.7,12,23,52.2,40,65,61.5,16,26,61.5,5,22,27,18,24,26,11,12,3,2,122,Jamalex Polonia 1912 Leszno,Sezon 2017/2018
2017-11-08 19:00,Elektrobud-Investment ZB Pruszków(d),99 : 80W,99,30,45,66.7,7,20,35.0,37,65,56.9,18,27,66.7,10,26,36,26,30,22,13,9,1,3,121,Jamalex Polonia 1912 Leszno,Sezon 2017/2018
2017-11-11 19:30,R8 Basket AZS Politechnika Kraków(d),79 : 68W,79,22,45,48.9,8,22,36.4,30,67,44.8,11,15,73.3,6,28,34,13,17,19,10,9,1,5,85,Jamalex Polonia 1912 Leszno,Sezon 2017/2018
2017-11-18 17:00,Sokół Łańcut(d),79 : 49W,79,19,49,38.8,9,26,34.6,28,75,37.3,14,19,73.7,19,28,47,20,24,19,12,15,2,7,99,Jamalex Polonia 1912 Leszno,Sezon 2017/2018
2017-11-24 20:00,WKS Śląsk Wrocław(w),86 : 96W,96,23,54,42.6,12,32,37.5,35,86,40.7,14,20,70.0,14,32,46,12,25,23,7,6,1,4,97,Jamalex Polonia 1912 Leszno,Sezon 2017/2018
2017-12-02 19:00,Enea Astoria Bydgoszcz(d),82 : 67W,82,17,28,60.7,11,35,31.4,28,63,44.4,15,20,75.0,5,35,40,18,20,20,16,7,8,2,99,Jamalex Polonia 1912 Leszno,Sezon 2017/2018
2017-12-06 18:00,Polfarmex Kutno(w),73 : 69P,69,17,39,43.6,7,23,30.4,24,62,38.7,14,26,53.8,7,22,29,14,23,27,12,7,3,6,60,Jamalex Polonia 1912 Leszno,Sezon 2017/2018
2017-12-09 18:00,Zetkama Doral Nysa Kłodzko(d),79 : 57W,79,22,41,53.7,7,19,36.8,29,60,48.3,14,21,66.7,9,25,34,18,21,22,12,10,1,0,92,Jamalex Polonia 1912 Leszno,Sezon 2017/2018
2017-12-17 13:00,KK Warszawa(w),65 : 78W,78,22,43,51.2,6,21,28.6,28,64,43.8,16,21,76.2,8,23,31,13,17,21,9,6,4,3,82,Jamalex Polonia 1912 Leszno,Sezon 2017/2018
2017-12-21 20:00,Spójnia Stargard(d),76 : 67W,76,21,37,56.8,7,19,36.8,28,56,50.0,13,19,68.4,5,24,29,16,28,22,15,7,2,0,81,Jamalex Polonia 1912 Leszno,Sezon 2017/2018
2018-01-06 18:00,KSK Noteć Inowrocław(d),84 : 67W,84,29,47,61.7,8,20,40.0,37,67,55.2,2,6,33.3,7,16,23,23,19,16,8,4,2,3,94,Jamalex Polonia 1912 Leszno,Sezon 2017/2018
2018-01-13 18:00,Siarka Tarnobrzeg(w),74 : 94W,94,19,35,54.3,10,23,43.5,29,58,50.0,26,34,76.5,8,26,34,21,20,24,14,12,0,4,110,Jamalex Polonia 1912 Leszno,Sezon 2017/2018
2018-01-20 18:00,Pogoń Prudnik(d),81 : 65W,81,17,34,50.0,9,25,36.0,26,59,44.1,20,28,71.4,5,21,26,16,14,24,7,7,1,0,83,Jamalex Polonia 1912 Leszno,Sezon 2017/2018
2018-01-26 18:00,Energa Kotwica Kołobrzeg(w),72 : 87W,87,23,46,50.0,12,24,50.0,35,70,50.0,5,18,27.8,11,18,29,18,22,17,11,11,0,1,86,Jamalex Polonia 1912 Leszno,Sezon 2017/2018
2018-01-31 20:00,Biofarm Basket Poznań(d),82 : 63W,82,20,42,47.6,8,17,47.1,28,59,47.5,18,30,60.0,9,23,32,17,19,25,6,5,3,3,90,Jamalex Polonia 1912 Leszno,Sezon 2017/2018
2018-02-03 18:00,SKK Siedlce(w),77 : 97W,97,22,48,45.8,12,20,60.0,34,68,50.0,17,27,63.0,13,22,35,22,19,24,7,7,3,3,113,Jamalex Polonia 1912 Leszno,Sezon 2017/2018
2018-02-11 19:30,GKS Tychy(d),90 : 83W,90,27,38,71.1,7,18,38.9,34,56,60.7,15,21,71.4,6,29,35,23,21,23,17,6,1,1,110,Jamalex Polonia 1912 Leszno,Sezon 2017/2018
2018-02-21 19:00,Elektrobud-Investment ZB Pruszków(w),76 : 68P,68,18,43,41.9,5,29,17.2,23,72,31.9,17,24,70.8,14,20,34,8,23,23,12,12,0,2,54,Jamalex Polonia 1912 Leszno,Sezon 2017/2018
2018-02-24 17:00,R8 Basket AZS Politechnika Kraków(w),79 : 66P,66,24,48,50.0,3,14,21.4,27,62,43.5,9,12,75.0,9,25,34,15,19,17,15,6,1,2,69,Jamalex Polonia 1912 Leszno,Sezon 2017/2018
2018-03-03 18:00,Sokół Łańcut(w),81 : 77P,77,18,38,47.4,9,24,37.5,27,62,43.5,14,19,73.7,9,23,32,15,20,18,7,4,6,5,87,Jamalex Polonia 1912 Leszno,Sezon 2017/2018
2018-03-10 18:00,WKS Śląsk Wrocław(d),61 : 79P,61,15,38,39.5,6,24,25.0,21,62,33.9,13,26,50.0,9,20,29,10,21,24,9,8,3,4,48,Jamalex Polonia 1912 Leszno,Sezon 2017/2018
2018-03-17 17:00,Enea Astoria Bydgoszcz(w),89 : 79P,79,22,37,59.5,8,23,34.8,30,60,50.0,11,14,78.6,4,15,19,15,23,18,19,13,1,1,75,Jamalex Polonia 1912 Leszno,Sezon 2017/2018
2018-03-21 20:00,Polfarmex Kutno(d),73 : 62W,73,20,33,60.6,7,20,35.0,27,53,50.9,12,18,66.7,8,23,31,20,27,19,14,8,0,2,86,Jamalex Polonia 1912 Leszno,Sezon 2017/2018
2018-03-24 17:00,Zetkama Doral Nysa Kłodzko(w),70 : 81W,81,20,37,54.1,9,21,42.9,29,58,50.0,14,17,82.4,7,23,30,15,22,18,10,7,2,4,93,Jamalex Polonia 1912 Leszno,Sezon 2017/2018
2018-03-31 16:00,KK Warszawa(d),96 : 65W,96,26,42,61.9,7,25,28.0,33,67,49.3,23,30,76.7,14,25,39,28,27,24,9,13,0,0,126,Jamalex Polonia 1912 Leszno,Sezon 2017/2018
2018-04-08 18:00,Spójnia Stargard(w),78 : 85W,85,22,36,61.1,10,33,30.3,32,69,46.4,11,21,52.4,12,17,29,17,21,22,11,11,0,1,84,Jamalex Polonia 1912 Leszno,Sezon 2017/2018
2018-04-14 18:30,Elektrobud-Investment ZB Pruszków(d),81 : 65W,81,29,47,61.7,5,20,25.0,34,67,50.7,8,13,61.5,9,22,31,23,16,16,10,9,4,3,100,Jamalex Polonia 1912 Leszno,Sezon 2017/2018
2018-04-15 16:00,Elektrobud-Investment ZB Pruszków(d),60 : 71P,60,15,39,38.5,6,26,23.1,21,65,32.3,12,19,63.2,7,21,28,18,26,21,16,14,1,6,54,Jamalex Polonia 1912 Leszno,Sezon 2017/2018
2018-04-21 18:00,Elektrobud-Investment ZB Pruszków(w),65 : 73W,73,18,37,48.6,6,26,23.1,24,63,38.1,19,24,79.2,13,23,36,10,22,23,11,11,1,1,76,Jamalex Polonia 1912 Leszno,Sezon 2017/2018
2018-04-22 17:00,Elektrobud-Investment ZB Pruszków(w),60 : 66W,66,21,49,42.9,5,17,29.4,26,66,39.4,9,15,60.0,14,24,38,10,17,16,8,8,0,3,68,Jamalex Polonia 1912 Leszno,Sezon 2017/2018
2018-04-28 19:00,Sokół Łańcut(d),66 : 73P,66,17,37,45.9,6,27,22.2,23,64,35.9,14,17,82.4,10,27,37,21,23,17,13,4,0,3,71,Jamalex Polonia 1912 Leszno,Sezon 2017/2018
2018-04-29 17:00,Sokół Łańcut(d),63 : 83P,63,17,31,54.8,7,29,24.1,24,60,40.0,8,14,57.1,9,22,31,19,21,16,14,3,2,0,62,Jamalex Polonia 1912 Leszno,Sezon 2017/2018
2018-05-05 17:30,Sokół Łańcut(w),75 : 82W,82,21,44,47.7,12,24,50.0,33,68,48.5,4,9,44.4,12,26,38,17,20,16,14,4,0,4,87,Jamalex Polonia 1912 Leszno,Sezon 2017/2018
2018-05-06 17:30,Sokół Łańcut(w),87 : 83P,83,22,45,48.9,11,21,52.4,33,66,50.0,6,9,66.7,10,18,28,19,29,15,15,4,0,7,83,Jamalex Polonia 1912 Leszno,Sezon 2017/2018
2018-05-12 18:00,GKS Tychy(w),105 : 94P,94,21,45,46.7,11,22,50.0,32,67,47.8,19,23,82.6,9,17,26,23,24,22,12,6,2,5,100,Jamalex Polonia 1912 Leszno,Sezon 2017/2018
2018-05-19 16:00,GKS Tychy(d),85 : 67W,85,17,34,50.0,9,18,50.0,26,52,50.0,24,33,72.7,6,29,35,21,25,24,15,8,2,0,101,Jamalex Polonia 1912 Leszno,Sezon 2017/2018
2017-09-23 18:00,R8 Basket AZS Politechnika Kraków(w),84 : 58P,58,16,28,57.1,6,22,27.3,22,50,44.0,8,16,50.0,8,16,24,18,22,20,26,13,0,2,51,KK Warszawa,Sezon 2017/2018
2017-09-30 17:30,Sokół Łańcut(w),85 : 71P,71,16,26,61.5,6,21,28.6,22,47,46.8,21,24,87.5,7,24,31,9,29,19,18,4,0,0,69,KK Warszawa,Sezon 2017/2018
2017-10-08 15:00,WKS Śląsk Wrocław(d),56 : 72P,56,20,44,45.5,3,20,15.0,23,64,35.9,7,13,53.8,5,23,28,14,25,17,14,9,1,2,47,KK Warszawa,Sezon 2017/2018
2017-10-15 19:00,Enea Astoria Bydgoszcz(d),76 : 86P,76,15,30,50.0,13,29,44.8,28,59,47.5,7,9,77.8,6,18,24,18,24,15,20,9,3,1,77,KK Warszawa,Sezon 2017/2018
2017-10-18 18:00,Polfarmex Kutno(w),62 : 25P,25,4,30,13.3,4,21,19.0,8,51,15.7,5,8,62.5,5,19,24,4,28,19,24,7,5,4,-5,KK Warszawa,Sezon 2017/2018
2017-10-21 17:00,Zetkama Doral Nysa Kłodzko(w),70 : 90W,90,21,34,61.8,12,28,42.9,33,62,53.2,12,18,66.7,5,31,36,16,23,21,11,5,4,1,105,KK Warszawa,Sezon 2017/2018
2017-11-05 15:00,Spójnia Stargard(d),83 : 95P,83,23,46,50.0,7,23,30.4,30,69,43.5,16,21,76.2,10,16,26,11,22,15,15,14,1,5,76,KK Warszawa,Sezon 2017/2018
2017-11-08 18:00,KSK Noteć Inowrocław(w),65 : 63P,63,22,51,43.1,4,16,25.0,26,67,38.8,7,10,70.0,9,30,39,13,27,18,17,6,6,4,66,KK Warszawa,Sezon 2017/2018
2017-11-11 13:00,Siarka Tarnobrzeg(d),72 : 91P,72,19,28,67.9,7,29,24.1,26,57,45.6,13,19,68.4,6,25,31,13,23,17,21,7,4,2,69,KK Warszawa,Sezon 2017/2018
2017-11-19 17:00,Pogoń Prudnik(w),77 : 63P,63,20,43,46.5,6,29,20.7,26,72,36.1,5,5,100.0,9,23,32,9,28,15,12,13,1,1,60,KK Warszawa,Sezon 2017/2018
2017-11-26 18:00,Energa Kotwica Kołobrzeg(d),71 : 76P,71,20,38,52.6,7,27,25.9,27,65,41.5,10,16,62.5,7,15,22,12,17,17,14,15,2,1,64,KK Warszawa,Sezon 2017/2018
2017-12-02 17:00,Biofarm Basket Poznań(w),86 : 82P,82,16,31,51.6,13,28,46.4,29,59,49.2,11,20,55.0,5,18,23,18,28,19,7,10,3,6,90,KK Warszawa,Sezon 2017/2018
2017-12-06 20:00,SKK Siedlce(d),69 : 79P,69,13,23,56.5,10,29,34.5,23,52,44.2,13,21,61.9,3,19,22,16,30,19,13,3,2,0,62,KK Warszawa,Sezon 2017/2018
2017-12-09 18:00,GKS Tychy(w),83 : 73P,73,22,39,56.4,7,16,43.8,29,55,52.7,8,14,57.1,3,16,19,12,15,19,14,9,0,2,67,KK Warszawa,Sezon 2017/2018
2017-12-17 13:00,Jamalex Polonia 1912 Leszno(d),65 : 78P,65,18,34,52.9,7,22,31.8,25,56,44.6,8,12,66.7,2,21,23,11,21,16,14,3,3,4,56,KK Warszawa,Sezon 2017/2018
2017-12-22 19:00,Elektrobud-Investment ZB Pruszków(w),80 : 46P,46,12,39,30.8,5,27,18.5,17,66,25.8,7,9,77.8,7,20,27,7,12,17,14,9,1,8,25,KK Warszawa,Sezon 2017/2018
2018-01-07 14:30,R8 Basket AZS Politechnika Kraków(d),72 : 103P,72,24,43,55.8,6,26,23.1,30,69,43.5,6,15,40.0,12,17,29,10,24,16,12,7,0,0,58,KK Warszawa,Sezon 2017/2018
2018-01-14 17:30,Sokół Łańcut(d),78 : 71W,78,22,38,57.9,7,21,33.3,29,59,49.2,13,20,65.0,4,28,32,17,21,17,14,5,1,2,82,KK Warszawa,Sezon 2017/2018
2018-01-17 20:00,Polfarmex Kutno(d),66 : 80P,66,19,35,54.3,5,22,22.7,24,57,42.1,13,16,81.3,4,19,23,9,14,21,15,6,3,2,56,KK Warszawa,Sezon 2017/2018
2018-01-20 18:00,WKS Śląsk Wrocław(w),89 : 53P,53,12,42,28.6,4,15,26.7,16,57,28.1,17,22,77.3,6,25,31,9,14,23,18,6,1,7,36,KK Warszawa,Sezon 2017/2018
2018-01-27 17:00,Enea Astoria Bydgoszcz(w),96 : 55P,55,7,23,30.4,7,27,25.9,14,50,28.0,20,29,69.0,0,19,19,10,23,25,19,6,1,0,27,KK Warszawa,Sezon 2017/2018
2018-02-04 15:00,Zetkama Doral Nysa Kłodzko(d),79 : 67W,79,16,32,50.0,10,23,43.5,26,55,47.3,17,28,60.7,9,23,32,15,26,26,17,6,2,3,77,KK Warszawa,Sezon 2017/2018
2018-02-18 17:30,Spójnia Stargard(w),75 : 79W,79,19,33,57.6,8,25,32.0,27,58,46.6,17,27,63.0,7,30,37,16,18,20,24,11,2,2,80,KK Warszawa,Sezon 2017/2018
2018-02-21 20:00,KSK Noteć Inowrocław(d),73 : 85P,73,26,40,65.0,3,21,14.3,29,61,47.5,12,18,66.7,6,24,30,14,24,20,14,10,5,0,80,KK Warszawa,Sezon 2017/2018
2018-02-24 18:00,Siarka Tarnobrzeg(w),66 : 80W,80,23,43,53.5,6,19,31.6,29,62,46.8,16,23,69.6,9,27,36,13,19,23,12,12,3,6,92,KK Warszawa,Sezon 2017/2018
2018-03-04 17:30,Pogoń Prudnik(d),94 : 76W,94,26,44,59.1,8,24,33.3,34,68,50.0,18,24,75.0,7,22,29,19,16,24,9,15,2,3,110,KK Warszawa,Sezon 2017/2018
2018-03-11 17:00,Energa Kotwica Kołobrzeg(w),72 : 70P,70,15,35,42.9,9,43,20.9,24,78,30.8,13,32,40.6,17,35,52,15,29,29,13,6,1,2,58,KK Warszawa,Sezon 2017/2018
2018-03-18 15:00,Biofarm Basket Poznań(d),74 : 102P,74,21,42,50.0,5,21,23.8,26,63,41.3,17,24,70.8,10,17,27,15,22,20,18,6,3,0,63,KK Warszawa,Sezon 2017/2018
2018-03-21 20:00,SKK Siedlce(w),75 : 80W,80,16,35,45.7,10,23,43.5,26,58,44.8,18,21,85.7,4,19,23,12,20,22,15,14,1,4,80,KK Warszawa,Sezon 2017/2018
2018-03-25 15:00,GKS Tychy(d),78 : 100P,78,19,40,47.5,10,32,31.3,29,72,40.3,10,11,90.9,11,13,24,15,21,17,13,6,2,1,68,KK Warszawa,Sezon 2017/2018
2018-03-31 16:00,Jamalex Polonia 1912 Leszno(w),96 : 65P,65,14,27,51.9,7,21,33.3,21,48,43.8,16,22,72.7,5,19,24,13,25,27,21,4,0,0,52,KK Warszawa,Sezon 2017/2018
2018-04-08 18:00,Elektrobud-Investment ZB Pruszków(d),63 : 75P,63,17,35,48.6,6,26,23.1,23,61,37.7,11,19,57.9,5,18,23,11,15,20,13,7,2,6,47,KK Warszawa,Sezon 2017/2018
2018-04-13 18:00,Energa Kotwica Kołobrzeg(w),76 : 64P,64,16,26,61.5,7,19,36.8,23,45,51.1,11,14,78.6,2,24,26,11,17,16,16,3,1,1,64,KK Warszawa,Sezon 2017/2018
2018-04-14 20:00,Energa Kotwica Kołobrzeg(w),66 : 72W,72,11,21,52.4,12,32,37.5,23,53,43.4,14,24,58.3,8,24,32,12,19,23,14,6,1,1,69,KK Warszawa,Sezon 2017/2018
2018-04-21 14:30,Energa Kotwica Kołobrzeg(d),68 : 80P,68,18,35,51.4,4,25,16.0,22,60,36.7,20,24,83.3,7,19,26,11,16,24,14,8,1,2,58,KK Warszawa,Sezon 2017/2018
2018-04-22 18:00,Energa Kotwica Kołobrzeg(d),90 : 92P,90,26,53,49.1,9,22,40.9,35,75,46.7,11,15,73.3,10,29,39,10,16,19,16,10,3,5,92,KK Warszawa,Sezon 2017/2018
2017-09-24 18:00,Jamalex Polonia 1912 Leszno(d),58 : 102P,58,14,37,37.8,5,21,23.8,19,58,32.8,15,17,88.2,16,16,32,7,32,21,25,5,0,3,36,KSK Noteć Inowrocław,Sezon 2017/2018
2017-09-30 18:00,Elektrobud-Investment ZB Pruszków(w),89 : 52P,52,14,37,37.8,6,25,24.0,20,62,32.3,6,15,40.0,9,15,24,13,20,14,16,11,1,0,34,KSK Noteć Inowrocław,Sezon 2017/2018
2017-10-08 17:00,R8 Basket AZS Politechnika Kraków(d),71 : 94P,71,17,36,47.2,8,25,32.0,25,61,41.0,13,24,54.2,10,24,34,19,25,29,19,8,2,1,68,KSK Noteć Inowrocław,Sezon 2017/2018
2017-10-14 17:30,Sokół Łańcut(w),92 : 77P,77,25,39,64.1,8,27,29.6,33,66,50.0,3,4,75.0,14,21,35,18,23,11,17,1,1,1,81,KSK Noteć Inowrocław,Sezon 2017/2018
2017-10-18 18:00,WKS Śląsk Wrocław(d),74 : 66W,74,20,43,46.5,6,26,23.1,26,69,37.7,16,22,72.7,15,22,37,12,18,19,7,9,2,1,78,KSK Noteć Inowrocław,Sezon 2017/2018
2017-10-21 17:00,Enea Astoria Bydgoszcz(w),118 : 61P,61,12,29,41.4,8,28,28.6,20,57,35.1,13,21,61.9,5,19,24,14,29,22,20,3,1,3,38,KSK Noteć Inowrocław,Sezon 2017/2018
2017-10-29 17:00,Polfarmex Kutno(d),56 : 70P,56,14,32,43.8,6,19,31.6,20,51,39.2,10,15,66.7,4,19,23,15,19,20,20,8,1,2,47,KSK Noteć Inowrocław,Sezon 2017/2018
2017-11-04 17:00,Zetkama Doral Nysa Kłodzko(w),90 : 84P,84,22,33,66.7,7,19,36.8,29,52,55.8,19,36,52.8,9,24,33,16,29,30,14,1,1,1,81,KSK Noteć Inowrocław,Sezon 2017/2018
2017-11-08 18:00,KK Warszawa(d),65 : 63W,65,15,34,44.1,3,21,14.3,18,55,32.7,26,38,68.4,9,27,36,13,18,28,13,9,4,6,65,KSK Noteć Inowrocław,Sezon 2017/2018
2017-11-11 18:00,Spójnia Stargard(w),94 : 71P,71,22,45,48.9,4,20,20.0,26,65,40.0,15,20,75.0,9,15,24,16,16,15,7,8,3,0,71,KSK Noteć Inowrocław,Sezon 2017/2018
2017-11-25 18:00,Siarka Tarnobrzeg(d),60 : 78P,60,16,42,38.1,3,22,13.6,19,64,29.7,19,26,73.1,15,24,39,12,18,26,25,10,2,7,46,KSK Noteć Inowrocław,Sezon 2017/2018
2017-12-02 17:30,Pogoń Prudnik(w),81 : 74P,74,20,38,52.6,8,32,25.0,28,70,40.0,10,18,55.6,12,21,33,14,21,19,11,9,0,2,69,KSK Noteć Inowrocław,Sezon 2017/2018
2017-12-06 18:00,Energa Kotwica Kołobrzeg(d),73 : 89P,73,18,37,48.6,8,23,34.8,26,60,43.3,13,17,76.5,5,21,26,20,20,18,19,11,3,3,76,KSK Noteć Inowrocław,Sezon 2017/2018
2017-12-09 17:00,Biofarm Basket Poznań(w),57 : 61W,61,13,22,59.1,5,23,21.7,18,45,40.0,20,24,83.3,4,24,28,11,16,20,16,10,3,1,66,KSK Noteć Inowrocław,Sezon 2017/2018
2017-12-16 18:00,SKK Siedlce(d),69 : 56W,69,19,35,54.3,4,22,18.2,23,57,40.4,19,29,65.5,8,19,27,15,20,26,13,13,4,1,71,KSK Noteć Inowrocław,Sezon 2017/2018
2017-12-22 18:00,GKS Tychy(w),104 : 62P,62,20,36,55.6,3,25,12.0,23,61,37.7,13,16,81.3,12,18,30,10,14,17,18,7,2,1,52,KSK Noteć Inowrocław,Sezon 2017/2018
2018-01-06 18:00,Jamalex Polonia 1912 Leszno(w),84 : 67P,67,21,36,58.3,4,13,30.8,25,49,51.0,13,22,59.1,5,23,28,9,16,19,14,6,3,2,66,KSK Noteć Inowrocław,Sezon 2017/2018
2018-01-13 18:00,Elektrobud-Investment ZB Pruszków(d),65 : 91P,65,20,39,51.3,6,23,26.1,26,62,41.9,7,12,58.3,9,17,26,23,17,19,18,10,1,2,66,KSK Noteć Inowrocław,Sezon 2017/2018
2018-01-20 18:00,R8 Basket AZS Politechnika Kraków(w),96 : 73P,73,18,35,51.4,7,22,31.8,25,57,43.9,16,22,72.7,6,18,24,13,18,19,12,10,1,2,71,KSK Noteć Inowrocław,Sezon 2017/2018
2018-01-27 18:00,Sokół Łańcut(d),72 : 91P,72,21,42,50.0,6,18,33.3,27,60,45.0,12,14,85.7,7,21,28,19,24,17,19,6,0,4,71,KSK Noteć Inowrocław,Sezon 2017/2018
2018-01-31 19:00,WKS Śląsk Wrocław(w),89 : 76P,76,20,40,50.0,7,22,31.8,27,62,43.5,15,22,68.2,10,26,36,18,18,23,16,8,2,4,82,KSK Noteć Inowrocław,Sezon 2017/2018
2018-02-03 18:00,Enea Astoria Bydgoszcz(d),61 : 98P,61,17,36,47.2,5,23,21.7,22,59,37.3,12,23,52.2,11,17,28,17,21,21,15,7,2,3,52,KSK Noteć Inowrocław,Sezon 2017/2018
2018-02-10 17:30,Polfarmex Kutno(w),76 : 61P,61,19,45,42.2,5,20,25.0,24,65,36.9,8,15,53.3,11,22,33,13,11,16,14,9,1,5,55,KSK Noteć Inowrocław,Sezon 2017/2018
2018-02-17 16:00,Zetkama Doral Nysa Kłodzko(d),74 : 69W,74,16,34,47.1,10,25,40.0,26,59,44.1,12,22,54.5,5,24,29,20,16,16,6,5,1,1,80,KSK Noteć Inowrocław,Sezon 2017/2018
2018-02-21 20:00,KK Warszawa(w),73 : 85W,85,17,31,54.8,10,23,43.5,27,54,50.0,21,27,77.8,3,24,27,18,20,24,13,7,0,5,91,KSK Noteć Inowrocław,Sezon 2017/2018
2018-02-24 18:00,Spójnia Stargard(d),68 : 81P,68,17,38,44.7,5,20,25.0,22,58,37.9,19,26,73.1,4,20,24,13,19,19,13,9,4,3,62,KSK Noteć Inowrocław,Sezon 2017/2018
2018-03-10 18:00,Siarka Tarnobrzeg(w),77 : 70P,70,22,43,51.2,4,20,20.0,26,63,41.3,14,22,63.6,5,28,33,13,19,21,14,13,1,5,71,KSK Noteć Inowrocław,Sezon 2017/2018
2018-03-17 18:00,Pogoń Prudnik(d),68 : 90P,68,12,26,46.2,9,31,29.0,21,57,36.8,17,21,81.0,8,17,25,12,22,18,13,7,2,4,61,KSK Noteć Inowrocław,Sezon 2017/2018
2018-03-21 18:00,Energa Kotwica Kołobrzeg(w),76 : 56P,56,18,32,56.3,3,28,10.7,21,60,35.0,11,16,68.8,5,21,26,13,15,14,14,7,2,0,46,KSK Noteć Inowrocław,Sezon 2017/2018
2018-03-24 18:00,Biofarm Basket Poznań(d),84 : 88P,84,22,34,64.7,12,34,35.3,34,68,50.0,4,6,66.7,9,23,32,23,27,17,15,8,2,1,98,KSK Noteć Inowrocław,Sezon 2017/2018
2018-03-30 18:00,SKK Siedlce(w),86 : 68P,68,9,37,24.3,12,31,38.7,21,68,30.9,14,21,66.7,9,24,33,19,24,21,10,6,3,5,65,KSK Noteć Inowrocław,Sezon 2017/2018
2018-04-08 18:00,GKS Tychy(d),72 : 78P,72,18,41,43.9,8,32,25.0,26,73,35.6,12,26,46.2,18,17,35,22,24,24,12,14,2,3,72,KSK Noteć Inowrocław,Sezon 2017/2018
2017-09-23 17:30,SKK Siedlce(d),76 : 64W,76,20,40,50.0,6,22,27.3,26,62,41.9,18,20,90.0,5,20,25,12,12,23,11,10,0,1,74,Pogoń Prudnik,Sezon 2017/2018
2017-09-30 19:00,GKS Tychy(w),103 : 76P,76,21,45,46.7,7,29,24.1,28,74,37.8,13,18,72.2,12,24,36,15,20,19,9,6,2,4,75,Pogoń Prudnik,Sezon 2017/2018
2017-10-07 17:30,Jamalex Polonia 1912 Leszno(d),63 : 75P,63,20,43,46.5,5,18,27.8,25,61,41.0,8,18,44.4,7,23,30,17,24,18,16,9,2,1,59,Pogoń Prudnik,Sezon 2017/2018
2017-10-14 18:00,Elektrobud-Investment ZB Pruszków(w),71 : 72W,72,19,34,55.9,6,25,24.0,25,59,42.4,16,25,64.0,9,26,35,18,17,20,10,10,0,4,82,Pogoń Prudnik,Sezon 2017/2018
2017-10-18 18:30,R8 Basket AZS Politechnika Kraków(d),67 : 84P,67,18,38,47.4,5,28,17.9,23,66,34.8,16,20,80.0,9,27,36,15,18,25,20,4,2,3,57,Pogoń Prudnik,Sezon 2017/2018
2017-10-22 17:00,Sokół Łańcut(d),75 : 88P,75,21,46,45.7,6,16,37.5,27,62,43.5,15,19,78.9,9,22,31,15,14,19,17,9,2,3,76,Pogoń Prudnik,Sezon 2017/2018
2017-10-28 17:30,WKS Śląsk Wrocław(d),69 : 74P,69,15,36,41.7,5,25,20.0,20,61,32.8,24,30,80.0,11,29,40,9,21,30,16,6,4,3,65,Pogoń Prudnik,Sezon 2017/2018
2017-11-04 18:00,Enea Astoria Bydgoszcz(w),101 : 69P,69,13,32,40.6,11,27,40.7,24,59,40.7,10,20,50.0,8,21,29,17,27,19,16,6,3,4,63,Pogoń Prudnik,Sezon 2017/2018
2017-11-08 18:30,Polfarmex Kutno(d),55 : 85P,55,15,32,46.9,2,22,9.1,17,54,31.5,19,20,95.0,9,21,30,7,15,21,22,14,2,2,48,Pogoń Prudnik,Sezon 2017/2018
2017-11-11 17:00,Zetkama Doral Nysa Kłodzko(w),62 : 70W,70,19,41,46.3,8,17,47.1,27,58,46.6,8,10,80.0,2,23,25,17,20,16,8,4,1,0,76,Pogoń Prudnik,Sezon 2017/2018
2017-11-19 17:00,KK Warszawa(d),77 : 63W,77,9,23,39.1,11,25,44.0,20,48,41.7,26,29,89.7,5,34,39,15,15,28,20,6,1,1,87,Pogoń Prudnik,Sezon 2017/2018
2017-11-25 18:00,Spójnia Stargard(w),82 : 65P,65,16,31,51.6,9,24,37.5,25,55,45.5,6,12,50.0,6,21,27,7,12,14,12,5,4,3,60,Pogoń Prudnik,Sezon 2017/2018
2017-12-02 17:30,KSK Noteć Inowrocław(d),81 : 74W,81,26,39,66.7,4,19,21.1,30,58,51.7,17,26,65.4,9,25,34,16,19,21,13,4,2,0,87,Pogoń Prudnik,Sezon 2017/2018
2017-12-06 19:00,Siarka Tarnobrzeg(w),84 : 78P,78,19,37,51.4,9,21,42.9,28,58,48.3,13,22,59.1,3,24,27,10,17,25,12,7,0,3,71,Pogoń Prudnik,Sezon 2017/2018
2017-12-16 17:30,Energa Kotwica Kołobrzeg(d),92 : 65W,92,26,51,51.0,9,23,39.1,35,74,47.3,13,16,81.3,8,29,37,23,18,19,3,9,3,2,119,Pogoń Prudnik,Sezon 2017/2018
2017-12-23 15:00,Biofarm Basket Poznań(w),88 : 89W,89,20,36,55.6,9,18,50.0,29,54,53.7,22,30,73.3,6,20,26,22,23,28,13,9,2,4,102,Pogoń Prudnik,Sezon 2017/2018
2018-01-06 18:00,SKK Siedlce(w),97 : 67P,67,17,35,48.6,8,35,22.9,25,70,35.7,9,16,56.3,10,8,18,18,20,21,5,5,1,7,52,Pogoń Prudnik,Sezon 2017/2018
2018-01-13 17:30,GKS Tychy(d),86 : 91P,86,20,39,51.3,8,30,26.7,28,69,40.6,22,29,75.9,8,21,29,17,24,25,9,6,2,1,83,Pogoń Prudnik,Sezon 2017/2018
2018-01-20 18:00,Jamalex Polonia 1912 Leszno(w),81 : 65P,65,19,36,52.8,6,19,31.6,25,55,45.5,9,13,69.2,6,29,35,17,24,14,17,3,0,1,69,Pogoń Prudnik,Sezon 2017/2018
2018-01-27 17:30,Elektrobud-Investment ZB Pruszków(d),67 : 83P,67,17,38,44.7,5,25,20.0,22,63,34.9,18,19,94.7,11,23,34,12,22,22,14,8,2,2,67,Pogoń Prudnik,Sezon 2017/2018
2018-01-31 19:00,R8 Basket AZS Politechnika Kraków(w),84 : 59P,59,19,50,38.0,5,19,26.3,24,69,34.8,6,14,42.9,8,14,22,19,18,17,9,6,3,3,47,Pogoń Prudnik,Sezon 2017/2018
2018-02-03 17:30,Sokół Łańcut(w),79 : 71P,71,16,25,64.0,10,22,45.5,26,47,55.3,9,20,45.0,1,26,27,17,22,19,21,7,2,4,71,Pogoń Prudnik,Sezon 2017/2018
2018-02-14 18:00,WKS Śląsk Wrocław(w),98 : 100W,100,21,38,55.3,13,25,52.0,34,63,54.0,19,25,76.0,5,23,28,22,23,22,11,10,1,5,115,Pogoń Prudnik,Sezon 2017/2018
2018-02-17 17:30,Enea Astoria Bydgoszcz(d),83 : 90P,83,19,29,65.5,9,32,28.1,28,61,45.9,18,21,85.7,5,23,28,18,22,23,15,6,3,3,87,Pogoń Prudnik,Sezon 2017/2018
2018-02-21 18:00,Polfarmex Kutno(w),74 : 59P,59,14,37,37.8,6,19,31.6,20,56,35.7,13,27,48.1,10,23,33,10,15,24,19,6,5,1,44,Pogoń Prudnik,Sezon 2017/2018
2018-02-24 17:30,Zetkama Doral Nysa Kłodzko(d),94 : 87W,94,22,37,59.5,9,22,40.9,31,59,52.5,23,32,71.9,8,23,31,19,21,28,8,2,2,0,103,Pogoń Prudnik,Sezon 2017/2018
2018-03-04 17:30,KK Warszawa(w),94 : 76P,76,15,28,53.6,11,27,40.7,26,55,47.3,13,17,76.5,6,22,28,17,24,16,21,8,3,2,78,Pogoń Prudnik,Sezon 2017/2018
2018-03-10 17:30,Spójnia Stargard(d),77 : 80P,77,21,44,47.7,9,24,37.5,30,68,44.1,8,9,88.9,10,17,27,20,20,19,12,5,2,3,80,Pogoń Prudnik,Sezon 2017/2018
2018-03-17 18:00,KSK Noteć Inowrocław(w),68 : 90W,90,19,33,57.6,15,22,68.2,34,55,61.8,7,15,46.7,4,28,32,19,18,21,17,8,4,2,107,Pogoń Prudnik,Sezon 2017/2018
2018-03-21 18:30,Siarka Tarnobrzeg(d),81 : 70W,81,27,34,79.4,5,19,26.3,32,53,60.4,12,16,75.0,7,29,36,23,14,18,19,7,5,3,108,Pogoń Prudnik,Sezon 2017/2018
2018-03-30 18:30,Energa Kotwica Kołobrzeg(w),88 : 67P,67,18,36,50.0,6,18,33.3,24,54,44.4,13,21,61.9,5,26,31,16,18,21,23,3,5,0,61,Pogoń Prudnik,Sezon 2017/2018
2018-04-08 18:00,Biofarm Basket Poznań(d),93 : 97P,93,21,37,56.8,11,23,47.8,32,60,53.3,18,23,78.3,8,21,29,14,22,22,16,6,1,2,94,Pogoń Prudnik,Sezon 2017/2018
2018-04-14 17:30,Zetkama Doral Nysa Kłodzko(d),56 : 58P,56,17,39,43.6,5,19,26.3,22,58,37.9,7,10,70.0,3,19,22,14,19,19,9,4,5,5,53,Pogoń Prudnik,Sezon 2017/2018
2018-04-15 17:30,Zetkama Doral Nysa Kłodzko(d),77 : 54W,77,19,27,70.4,8,22,36.4,27,49,55.1,15,18,83.3,6,24,30,15,18,21,14,7,3,0,93,Pogoń Prudnik,Sezon 2017/2018
2018-04-21 19:00,Zetkama Doral Nysa Kłodzko(w),63 : 65W,65,15,33,45.5,6,25,24.0,21,58,36.2,17,27,63.0,5,40,45,12,26,24,17,6,3,2,67,Pogoń Prudnik,Sezon 2017/2018
2018-04-22 17:00,Zetkama Doral Nysa Kłodzko(w),68 : 81W,81,20,34,58.8,7,24,29.2,27,58,46.6,20,25,80.0,11,28,39,20,21,21,12,5,3,2,100,Pogoń Prudnik,Sezon 2017/2018
2017-09-23 17:30,WKS Śląsk Wrocław(d),86 : 74W,86,19,43,44.2,13,24,54.2,32,67,47.8,9,16,56.3,9,26,35,22,22,15,13,13,1,3,102,Polfarmex Kutno,Sezon 2017/2018
2017-10-01 17:00,Enea Astoria Bydgoszcz(w),62 : 73W,73,17,42,40.5,7,27,25.9,24,69,34.8,18,31,58.1,15,23,38,14,16,26,10,12,1,3,70,Polfarmex Kutno,Sezon 2017/2018
2017-10-14 17:30,Zetkama Doral Nysa Kłodzko(d),57 : 43W,57,13,38,34.2,5,27,18.5,18,65,27.7,16,21,76.2,16,26,42,11,21,23,10,8,2,1,58,Polfarmex Kutno,Sezon 2017/2018
2017-10-18 18:00,KK Warszawa(d),62 : 25W,62,15,35,42.9,5,21,23.8,20,56,35.7,17,27,63.0,10,34,44,11,19,29,21,18,4,5,72,Polfarmex Kutno,Sezon 2017/2018
2017-10-21 17:30,Spójnia Stargard(d),75 : 79P,75,20,50,40.0,6,28,21.4,26,78,33.3,17,26,65.4,19,21,40,15,20,19,9,13,3,5,76,Polfarmex Kutno,Sezon 2017/2018
2017-10-29 17:00,KSK Noteć Inowrocław(w),56 : 70W,70,18,44,40.9,8,22,36.4,26,66,39.4,10,13,76.9,15,22,37,9,20,20,17,14,2,1,72,Polfarmex Kutno,Sezon 2017/2018
2017-11-04 17:30,Siarka Tarnobrzeg(d),82 : 76W,82,18,37,48.6,10,25,40.0,28,62,45.2,16,27,59.3,9,28,37,19,22,25,21,12,2,3,86,Polfarmex Kutno,Sezon 2017/2018
2017-11-08 18:30,Pogoń Prudnik(w),55 : 85W,85,22,36,61.1,10,28,35.7,32,64,50.0,11,11,100.0,8,25,33,27,21,15,18,17,2,2,114,Polfarmex Kutno,Sezon 2017/2018
2017-11-11 17:30,Energa Kotwica Kołobrzeg(d),100 : 84W,100,30,57,52.6,8,27,29.6,38,84,45.2,16,20,80.0,16,24,40,19,25,16,6,8,1,4,112,Polfarmex Kutno,Sezon 2017/2018
2017-11-18 17:00,Biofarm Basket Poznań(w),72 : 64P,64,15,28,53.6,8,25,32.0,23,53,43.4,10,15,66.7,4,25,29,18,23,16,15,6,2,3,69,Polfarmex Kutno,Sezon 2017/2018
2017-11-25 17:30,SKK Siedlce(d),65 : 67P,65,16,34,47.1,7,27,25.9,23,61,37.7,12,15,80.0,11,18,29,16,25,17,19,19,5,2,74,Polfarmex Kutno,Sezon 2017/2018
2017-12-02 18:00,GKS Tychy(w),80 : 93W,93,22,42,52.4,12,23,52.2,34,65,52.3,13,23,56.5,12,20,32,20,21,21,10,9,0,2,103,Polfarmex Kutno,Sezon 2017/2018
2017-12-06 18:00,Jamalex Polonia 1912 Leszno(d),73 : 69W,73,20,41,48.8,5,20,25.0,25,61,41.0,18,27,66.7,12,31,43,17,27,23,14,5,6,3,85,Polfarmex Kutno,Sezon 2017/2018
2017-12-10 17:00,Elektrobud-Investment ZB Pruszków(w),55 : 86W,86,19,42,45.2,12,22,54.5,31,64,48.4,12,15,80.0,14,26,40,19,18,17,15,10,3,2,107,Polfarmex Kutno,Sezon 2017/2018
2017-12-16 17:30,R8 Basket AZS Politechnika Kraków(d),59 : 57W,59,17,36,47.2,6,21,28.6,23,57,40.4,7,15,46.7,12,23,35,11,14,19,18,8,3,2,56,Polfarmex Kutno,Sezon 2017/2018
2017-12-21 18:00,Sokół Łańcut(w),78 : 57P,57,20,52,38.5,4,19,21.1,24,71,33.8,5,10,50.0,14,25,39,11,20,12,11,11,1,7,56,Polfarmex Kutno,Sezon 2017/2018
2018-01-07 18:00,WKS Śląsk Wrocław(w),57 : 79W,79,20,45,44.4,6,18,33.3,26,63,41.3,21,33,63.6,11,26,37,11,20,28,9,11,2,1,82,Polfarmex Kutno,Sezon 2017/2018
2018-01-13 16:30,Enea Astoria Bydgoszcz(d),65 : 63W,65,24,47,51.1,2,16,12.5,26,63,41.3,11,16,68.8,9,17,26,17,19,24,9,7,3,1,67,Polfarmex Kutno,Sezon 2017/2018
2018-01-17 20:00,KK Warszawa(w),66 : 80W,80,25,43,58.1,7,25,28.0,32,68,47.1,9,13,69.2,10,24,34,23,21,14,14,9,2,3,94,Polfarmex Kutno,Sezon 2017/2018
2018-01-24 19:30,Zetkama Doral Nysa Kłodzko(w),83 : 75P,75,22,47,46.8,7,19,36.8,29,66,43.9,10,12,83.3,3,20,23,15,28,18,7,8,4,2,79,Polfarmex Kutno,Sezon 2017/2018
2018-02-04 17:00,Spójnia Stargard(w),98 : 75P,75,19,40,47.5,9,27,33.3,28,67,41.8,10,20,50.0,13,21,34,15,24,19,15,8,2,5,70,Polfarmex Kutno,Sezon 2017/2018
2018-02-10 17:30,KSK Noteć Inowrocław(d),76 : 61W,76,27,50,54.0,5,26,19.2,32,76,42.1,7,7,100.0,18,30,48,20,16,11,14,13,5,1,104,Polfarmex Kutno,Sezon 2017/2018
2018-02-17 18:00,Siarka Tarnobrzeg(w),61 : 86W,86,28,48,58.3,4,16,25.0,32,64,50.0,18,23,78.3,9,23,32,16,21,21,11,11,2,2,99,Polfarmex Kutno,Sezon 2017/2018
2018-02-21 18:00,Pogoń Prudnik(d),74 : 59W,74,18,39,46.2,10,24,41.7,28,63,44.4,8,11,72.7,8,27,35,14,24,15,14,12,1,5,84,Polfarmex Kutno,Sezon 2017/2018
2018-02-24 18:00,Energa Kotwica Kołobrzeg(w),58 : 77W,77,19,38,50.0,6,23,26.1,25,61,41.0,21,26,80.8,3,27,30,19,12,19,11,13,0,1,87,Polfarmex Kutno,Sezon 2017/2018
2018-03-07 18:00,Biofarm Basket Poznań(d),72 : 76P,72,20,36,55.6,9,26,34.6,29,62,46.8,5,19,26.3,10,19,29,19,21,17,13,8,2,3,70,Polfarmex Kutno,Sezon 2017/2018
2018-03-10 19:30,SKK Siedlce(w),57 : 75W,75,21,38,55.3,9,24,37.5,30,62,48.4,6,13,46.2,9,24,33,31,19,17,12,13,0,1,101,Polfarmex Kutno,Sezon 2017/2018
2018-03-17 17:30,GKS Tychy(d),64 : 79P,64,14,37,37.8,9,35,25.7,23,72,31.9,9,13,69.2,20,22,42,19,26,17,14,7,3,3,68,Polfarmex Kutno,Sezon 2017/2018
2018-03-21 20:00,Jamalex Polonia 1912 Leszno(w),73 : 62P,62,14,32,43.8,6,18,33.3,20,50,40.0,16,26,61.5,6,17,23,12,20,27,13,10,2,0,56,Polfarmex Kutno,Sezon 2017/2018
2018-03-24 17:30,Elektrobud-Investment ZB Pruszków(d),95 : 88W,95,26,42,61.9,13,30,43.3,39,72,54.2,4,14,28.6,11,24,35,34,20,15,9,8,5,1,125,Polfarmex Kutno,Sezon 2017/2018
2018-03-30 18:00,R8 Basket AZS Politechnika Kraków(w),86 : 74P,74,22,42,52.4,7,21,33.3,29,63,46.0,9,16,56.3,13,21,34,19,15,17,9,8,2,3,87,Polfarmex Kutno,Sezon 2017/2018
2018-04-08 18:00,Sokół Łańcut(d),58 : 78P,58,24,46,52.2,2,16,12.5,26,62,41.9,4,7,57.1,11,24,35,19,16,8,15,5,3,3,66,Polfarmex Kutno,Sezon 2017/2018
2018-04-14 17:30,Sokół Łańcut(w),73 : 66P,66,19,47,40.4,7,30,23.3,26,77,33.8,7,11,63.6,18,21,39,17,20,14,15,13,0,4,65,Polfarmex Kutno,Sezon 2017/2018
2018-04-15 17:30,Sokół Łańcut(w),71 : 65P,65,14,38,36.8,9,31,29.0,23,69,33.3,10,13,76.9,19,20,39,11,19,16,14,6,2,3,60,Polfarmex Kutno,Sezon 2017/2018
2018-04-21 17:30,Sokół Łańcut(d),73 : 66W,73,25,43,58.1,3,16,18.8,28,59,47.5,14,22,63.6,11,27,38,16,19,17,18,9,2,0,81,Polfarmex Kutno,Sezon 2017/2018
2018-04-22 17:30,Sokół Łańcut(d),76 : 82P,76,18,47,38.3,10,31,32.3,28,78,35.9,10,12,83.3,17,29,46,15,25,14,14,8,2,4,81,Polfarmex Kutno,Sezon 2017/2018
2017-09-23 18:00,KK Warszawa(d),84 : 58W,84,18,27,66.7,10,30,33.3,28,57,49.1,18,26,69.2,16,24,40,20,20,23,23,17,2,0,103,R8 Basket AZS Politechnika Kraków,Sezon 2017/2018
2017-09-30 18:30,Spójnia Stargard(d),71 : 88P,71,16,31,51.6,7,33,21.2,23,64,35.9,18,27,66.7,12,24,36,19,21,23,13,8,2,0,73,R8 Basket AZS Politechnika Kraków,Sezon 2017/2018
2017-10-08 17:00,KSK Noteć Inowrocław(w),71 : 94W,94,17,31,54.8,13,37,35.1,30,68,44.1,21,31,67.7,12,28,40,18,25,25,11,12,1,2,106,R8 Basket AZS Politechnika Kraków,Sezon 2017/2018
2017-10-14 18:30,Siarka Tarnobrzeg(d),72 : 88P,72,13,27,48.1,13,45,28.9,26,72,36.1,7,10,70.0,10,22,32,20,22,13,10,9,4,4,78,R8 Basket AZS Politechnika Kraków,Sezon 2017/2018
2017-10-18 18:30,Pogoń Prudnik(w),67 : 84W,84,13,26,50.0,15,36,41.7,28,62,45.2,13,13,100.0,3,30,33,15,25,18,15,12,3,2,98,R8 Basket AZS Politechnika Kraków,Sezon 2017/2018
2017-10-21 17:00,Energa Kotwica Kołobrzeg(d),87 : 62W,87,23,35,65.7,13,36,36.1,36,71,50.7,2,5,40.0,9,21,30,24,17,11,10,14,2,0,109,R8 Basket AZS Politechnika Kraków,Sezon 2017/2018
2017-11-05 16:00,SKK Siedlce(d),76 : 62W,76,10,30,33.3,16,35,45.7,26,65,40.0,8,16,50.0,9,20,29,19,16,21,7,9,1,1,80,R8 Basket AZS Politechnika Kraków,Sezon 2017/2018
2017-11-08 19:00,GKS Tychy(w),91 : 96W,96,15,28,53.6,16,34,47.1,31,62,50.0,18,18,100.0,4,20,24,14,23,23,12,6,4,0,101,R8 Basket AZS Politechnika Kraków,Sezon 2017/2018
2017-11-11 19:30,Jamalex Polonia 1912 Leszno(w),79 : 68P,68,15,26,57.7,10,37,27.0,25,63,39.7,8,10,80.0,7,27,34,13,20,17,13,5,5,1,72,R8 Basket AZS Politechnika Kraków,Sezon 2017/2018
2017-11-19 17:00,Elektrobud-Investment ZB Pruszków(w),62 : 64W,64,12,32,37.5,7,33,21.2,19,65,29.2,19,26,73.1,11,28,39,16,18,24,8,8,2,4,68,R8 Basket AZS Politechnika Kraków,Sezon 2017/2018
2017-11-29 19:00,WKS Śląsk Wrocław(w),77 : 89W,89,21,42,50.0,11,25,44.0,32,67,47.8,14,16,87.5,6,28,34,16,17,22,7,10,1,2,106,R8 Basket AZS Politechnika Kraków,Sezon 2017/2018
2017-12-02 18:00,Sokół Łańcut(d),66 : 86P,66,14,32,43.8,10,31,32.3,24,63,38.1,8,10,80.0,14,21,35,17,19,14,17,8,1,3,69,R8 Basket AZS Politechnika Kraków,Sezon 2017/2018
2017-12-09 18:00,Enea Astoria Bydgoszcz(d),75 : 59W,75,21,40,52.5,8,22,36.4,29,62,46.8,9,14,64.3,7,30,37,24,20,16,10,6,3,1,97,R8 Basket AZS Politechnika Kraków,Sezon 2017/2018
2017-12-16 17:30,Polfarmex Kutno(w),59 : 57P,57,14,32,43.8,7,22,31.8,21,54,38.9,8,10,80.0,6,22,28,17,18,14,21,9,2,3,57,R8 Basket AZS Politechnika Kraków,Sezon 2017/2018
2017-12-22 18:00,Zetkama Doral Nysa Kłodzko(d),103 : 86W,103,19,36,52.8,13,25,52.0,32,61,52.5,26,32,81.3,14,19,33,25,22,24,11,7,1,5,123,R8 Basket AZS Politechnika Kraków,Sezon 2017/2018
2018-01-07 14:30,KK Warszawa(w),72 : 103W,103,22,34,64.7,12,24,50.0,34,58,58.6,23,28,82.1,4,27,31,26,16,24,12,7,0,0,126,R8 Basket AZS Politechnika Kraków,Sezon 2017/2018
2018-01-13 18:00,Spójnia Stargard(w),81 : 78P,78,16,33,48.5,11,33,33.3,27,66,40.9,13,17,76.5,9,26,35,18,16,18,14,4,1,2,79,R8 Basket AZS Politechnika Kraków,Sezon 2017/2018
2018-01-14 17:00,Biofarm Basket Poznań(w),77 : 83W,83,19,36,52.8,7,18,38.9,26,54,48.1,24,37,64.9,6,28,34,14,20,29,14,10,2,3,88,R8 Basket AZS Politechnika Kraków,Sezon 2017/2018
2018-01-20 18:00,KSK Noteć Inowrocław(d),96 : 73W,96,22,30,73.3,14,31,45.2,36,61,59.0,10,14,71.4,7,28,35,24,19,18,11,7,2,1,124,R8 Basket AZS Politechnika Kraków,Sezon 2017/2018
2018-01-27 18:00,Siarka Tarnobrzeg(w),77 : 87W,87,22,39,56.4,11,22,50.0,33,61,54.1,10,15,66.7,9,24,33,23,24,19,14,8,0,2,104,R8 Basket AZS Politechnika Kraków,Sezon 2017/2018
2018-01-31 19:00,Pogoń Prudnik(d),84 : 59W,84,23,40,57.5,9,23,39.1,32,63,50.8,11,20,55.0,14,36,50,21,17,17,15,7,3,3,110,R8 Basket AZS Politechnika Kraków,Sezon 2017/2018
2018-02-03 17:00,Energa Kotwica Kołobrzeg(w),83 : 82P,82,20,36,55.6,9,35,25.7,29,71,40.8,15,22,68.2,12,29,41,17,18,17,11,6,2,2,88,R8 Basket AZS Politechnika Kraków,Sezon 2017/2018
2018-02-12 19:00,Biofarm Basket Poznań(d),90 : 89W,90,20,35,57.1,12,29,41.4,32,64,50.0,14,20,70.0,7,22,29,26,21,19,8,8,3,2,110,R8 Basket AZS Politechnika Kraków,Sezon 2017/2018
2018-02-18 19:00,SKK Siedlce(w),79 : 84W,84,17,35,48.6,14,31,45.2,31,66,47.0,8,10,80.0,8,23,31,23,14,15,12,8,0,2,97,R8 Basket AZS Politechnika Kraków,Sezon 2017/2018
2018-02-21 19:00,GKS Tychy(d),81 : 83P,81,21,39,53.8,9,36,25.0,30,75,40.0,12,23,52.2,16,23,39,20,23,17,10,5,1,0,80,R8 Basket AZS Politechnika Kraków,Sezon 2017/2018
2018-02-24 17:00,Jamalex Polonia 1912 Leszno(d),79 : 66W,79,21,38,55.3,8,31,25.8,29,69,42.0,13,18,72.2,15,20,35,24,17,19,13,9,2,1,91,R8 Basket AZS Politechnika Kraków,Sezon 2017/2018
2018-03-03 17:00,Elektrobud-Investment ZB Pruszków(d),83 : 58W,83,21,42,50.0,11,31,35.5,32,73,43.8,8,15,53.3,16,28,44,22,18,14,8,8,2,3,103,R8 Basket AZS Politechnika Kraków,Sezon 2017/2018
2018-03-17 17:30,Sokół Łańcut(w),84 : 66P,66,16,35,45.7,8,30,26.7,24,65,36.9,10,13,76.9,11,26,37,14,18,15,12,4,0,3,65,R8 Basket AZS Politechnika Kraków,Sezon 2017/2018
2018-03-21 19:00,WKS Śląsk Wrocław(d),93 : 75W,93,20,43,46.5,13,22,59.1,33,65,50.8,14,21,66.7,9,20,29,21,22,19,10,9,2,5,105,R8 Basket AZS Politechnika Kraków,Sezon 2017/2018
2018-03-24 17:00,Enea Astoria Bydgoszcz(w),81 : 86W,86,11,21,52.4,17,39,43.6,28,60,46.7,13,18,72.2,6,17,23,24,15,20,12,8,1,2,93,R8 Basket AZS Politechnika Kraków,Sezon 2017/2018
2018-03-30 18:00,Polfarmex Kutno(d),86 : 74W,86,15,24,62.5,17,35,48.6,32,59,54.2,5,11,45.5,9,23,32,24,17,14,14,3,3,2,101,R8 Basket AZS Politechnika Kraków,Sezon 2017/2018
2018-04-08 18:00,Zetkama Doral Nysa Kłodzko(w),92 : 90P,90,16,27,59.3,12,37,32.4,28,64,43.8,22,25,88.0,9,25,34,17,30,25,14,4,0,1,92,R8 Basket AZS Politechnika Kraków,Sezon 2017/2018
2018-04-14 17:00,GKS Tychy(d),91 : 85W,91,14,27,51.9,16,34,47.1,30,61,49.2,15,25,60.0,8,26,34,26,24,24,13,7,3,2,107,R8 Basket AZS Politechnika Kraków,Sezon 2017/2018
2018-04-15 17:00,GKS Tychy(d),90 : 94P,90,21,28,75.0,11,32,34.4,32,60,53.3,15,23,65.2,8,21,29,16,22,23,14,9,2,1,96,R8 Basket AZS Politechnika Kraków,Sezon 2017/2018
2018-04-21 18:00,GKS Tychy(w),103 : 93P,93,20,32,62.5,11,33,33.3,31,65,47.7,20,28,71.4,16,13,29,16,20,25,13,4,1,1,88,R8 Basket AZS Politechnika Kraków,Sezon 2017/2018
2018-04-22 18:00,GKS Tychy(w),113 : 105P,105,27,36,75.0,11,22,50.0,38,58,65.5,18,21,85.7,3,20,23,11,24,22,12,5,3,1,112,R8 Basket AZS Politechnika Kraków,Sezon 2017/2018
2017-09-23 18:00,GKS Tychy(d),72 : 81P,72,19,37,51.4,10,27,37.0,29,64,45.3,6,8,75.0,10,19,29,17,25,17,16,9,1,2,75,Siarka Tarnobrzeg,Sezon 2017/2018
2017-09-30 19:00,Jamalex Polonia 1912 Leszno(w),97 : 61P,61,13,29,44.8,5,16,31.3,18,45,40.0,20,32,62.5,4,19,23,9,25,26,11,0,1,2,44,Siarka Tarnobrzeg,Sezon 2017/2018
2017-10-07 18:30,Elektrobud-Investment ZB Pruszków(d),85 : 78W,85,18,33,54.5,12,25,48.0,30,58,51.7,13,18,72.2,5,20,25,18,19,20,11,8,2,3,94,Siarka Tarnobrzeg,Sezon 2017/2018
2017-10-14 18:30,R8 Basket AZS Politechnika Kraków(w),72 : 88W,88,24,44,54.5,8,18,44.4,32,62,51.6,16,21,76.2,8,32,40,22,13,21,15,8,4,4,112,Siarka Tarnobrzeg,Sezon 2017/2018
2017-10-18 19:00,Sokół Łańcut(d),63 : 82P,63,19,43,44.2,6,22,27.3,25,65,38.5,7,14,50.0,8,22,30,13,21,17,18,10,1,3,52,Siarka Tarnobrzeg,Sezon 2017/2018
2017-10-21 20:00,WKS Śląsk Wrocław(w),73 : 100W,100,21,47,44.7,16,29,55.2,37,76,48.7,10,13,76.9,9,23,32,19,18,18,6,9,4,2,116,Siarka Tarnobrzeg,Sezon 2017/2018
2017-10-28 18:30,Enea Astoria Bydgoszcz(d),77 : 68W,77,26,47,55.3,6,23,26.1,32,70,45.7,7,16,43.8,9,32,41,17,23,20,13,7,6,1,88,Siarka Tarnobrzeg,Sezon 2017/2018
2017-11-04 17:30,Polfarmex Kutno(w),82 : 76P,76,23,46,50.0,7,21,33.3,30,67,44.8,9,17,52.9,8,23,31,14,26,22,19,12,3,2,72,Siarka Tarnobrzeg,Sezon 2017/2018
2017-11-08 19:00,Zetkama Doral Nysa Kłodzko(d),75 : 70W,75,16,31,51.6,8,28,28.6,24,59,40.7,19,29,65.5,12,27,39,17,23,24,15,4,1,2,76,Siarka Tarnobrzeg,Sezon 2017/2018
2017-11-11 13:00,KK Warszawa(w),72 : 91W,91,29,61,47.5,6,17,35.3,35,78,44.9,15,25,60.0,16,23,39,23,18,23,13,16,2,4,105,Siarka Tarnobrzeg,Sezon 2017/2018
2017-11-18 18:00,Spójnia Stargard(d),80 : 86P,80,25,41,61.0,5,28,17.9,30,69,43.5,15,17,88.2,9,16,25,17,26,18,14,13,1,0,81,Siarka Tarnobrzeg,Sezon 2017/2018
2017-11-25 18:00,KSK Noteć Inowrocław(w),60 : 78W,78,28,52,53.8,4,24,16.7,32,76,42.1,10,15,66.7,15,28,43,18,26,18,18,13,7,2,92,Siarka Tarnobrzeg,Sezon 2017/2018
2017-12-06 19:00,Pogoń Prudnik(d),84 : 78W,84,20,48,41.7,8,22,36.4,28,70,40.0,20,23,87.0,18,23,41,14,25,17,11,8,3,0,94,Siarka Tarnobrzeg,Sezon 2017/2018
2017-12-09 18:00,Energa Kotwica Kołobrzeg(w),85 : 76P,76,19,43,44.2,6,22,27.3,25,65,38.5,20,26,76.9,12,24,36,11,10,21,14,8,2,6,73,Siarka Tarnobrzeg,Sezon 2017/2018
2017-12-16 18:00,Biofarm Basket Poznań(d),79 : 76W,79,17,42,40.5,9,22,40.9,26,64,40.6,18,24,75.0,10,24,34,11,28,24,16,10,4,7,78,Siarka Tarnobrzeg,Sezon 2017/2018
2017-12-23 16:00,SKK Siedlce(w),86 : 77P,77,20,48,41.7,4,17,23.5,24,65,36.9,25,37,67.6,14,23,37,17,16,30,23,10,3,4,68,Siarka Tarnobrzeg,Sezon 2017/2018
2018-01-06 18:00,GKS Tychy(w),91 : 70P,70,24,40,60.0,3,19,15.8,27,59,45.8,13,23,56.5,11,19,30,14,21,20,15,6,4,1,67,Siarka Tarnobrzeg,Sezon 2017/2018
2018-01-13 18:00,Jamalex Polonia 1912 Leszno(d),74 : 94P,74,24,43,55.8,4,20,20.0,28,63,44.4,14,19,73.7,6,20,26,14,24,20,15,6,4,0,69,Siarka Tarnobrzeg,Sezon 2017/2018
2018-01-20 18:00,Elektrobud-Investment ZB Pruszków(w),84 : 75P,75,21,44,47.7,8,31,25.8,29,75,38.7,9,22,40.9,11,23,34,19,25,20,12,9,4,6,70,Siarka Tarnobrzeg,Sezon 2017/2018
2018-01-27 18:00,R8 Basket AZS Politechnika Kraków(d),77 : 87P,77,20,41,48.8,8,19,42.1,28,60,46.7,13,18,72.2,6,21,27,15,19,24,14,4,2,0,74,Siarka Tarnobrzeg,Sezon 2017/2018
2018-01-31 18:00,Sokół Łańcut(w),85 : 81P,81,22,41,53.7,9,24,37.5,31,65,47.7,10,17,58.8,12,26,38,22,26,16,17,2,5,2,90,Siarka Tarnobrzeg,Sezon 2017/2018
2018-02-03 18:00,WKS Śląsk Wrocław(d),73 : 71W,73,21,42,50.0,4,15,26.7,25,57,43.9,19,26,73.1,8,22,30,11,18,22,19,4,3,0,63,Siarka Tarnobrzeg,Sezon 2017/2018
2018-02-10 17:00,Enea Astoria Bydgoszcz(w),87 : 74P,74,17,38,44.7,9,28,32.1,26,66,39.4,13,19,68.4,10,21,31,14,29,18,16,8,6,2,71,Siarka Tarnobrzeg,Sezon 2017/2018
2018-02-17 18:00,Polfarmex Kutno(d),61 : 86P,61,20,40,50.0,3,17,17.6,23,57,40.4,12,20,60.0,9,22,31,15,21,20,21,7,2,2,53,Siarka Tarnobrzeg,Sezon 2017/2018
2018-02-21 19:30,Zetkama Doral Nysa Kłodzko(w),71 : 80W,80,14,26,53.8,7,20,35.0,21,46,45.7,31,44,70.5,8,19,27,12,24,29,19,9,1,0,72,Siarka Tarnobrzeg,Sezon 2017/2018
2018-02-24 18:00,KK Warszawa(d),66 : 80P,66,17,34,50.0,7,22,31.8,24,56,42.9,11,18,61.1,8,19,27,13,23,19,15,8,6,3,66,Siarka Tarnobrzeg,Sezon 2017/2018
2018-03-03 18:00,Spójnia Stargard(w),74 : 73P,73,23,35,65.7,7,20,35.0,30,55,54.5,6,11,54.5,5,23,28,13,17,14,18,7,0,0,73,Siarka Tarnobrzeg,Sezon 2017/2018
2018-03-10 18:00,KSK Noteć Inowrocław(d),77 : 70W,77,20,46,43.5,6,24,25.0,26,70,37.1,19,25,76.0,17,29,46,18,21,19,19,7,5,1,84,Siarka Tarnobrzeg,Sezon 2017/2018
2018-03-21 18:30,Pogoń Prudnik(w),81 : 70P,70,22,44,50.0,6,20,30.0,28,64,43.8,8,12,66.7,4,13,17,12,18,14,9,10,3,5,63,Siarka Tarnobrzeg,Sezon 2017/2018
2018-03-24 18:30,Energa Kotwica Kołobrzeg(d),75 : 86P,75,21,39,53.8,8,30,26.7,29,69,42.0,9,15,60.0,11,17,28,14,16,15,10,9,3,0,73,Siarka Tarnobrzeg,Sezon 2017/2018
2018-03-31 15:00,Biofarm Basket Poznań(w),84 : 71P,71,18,39,46.2,7,25,28.0,25,64,39.1,14,17,82.4,7,18,25,13,18,17,12,7,1,3,63,Siarka Tarnobrzeg,Sezon 2017/2018
2018-04-08 18:00,SKK Siedlce(d),81 : 95P,81,26,44,59.1,7,22,31.8,33,66,50.0,8,12,66.7,15,20,35,19,16,20,19,4,2,1,85,Siarka Tarnobrzeg,Sezon 2017/2018
2018-04-14 16:30,SKK Siedlce(d),85 : 64W,85,19,39,48.7,10,31,32.3,29,70,41.4,17,19,89.5,15,33,48,21,15,21,15,10,6,4,112,Siarka Tarnobrzeg,Sezon 2017/2018
2018-04-15 19:30,SKK Siedlce(d),65 : 88P,65,17,32,53.1,4,26,15.4,21,58,36.2,19,30,63.3,10,21,31,12,18,27,19,8,0,3,49,Siarka Tarnobrzeg,Sezon 2017/2018
2018-04-21 19:00,SKK Siedlce(w),100 : 64P,64,10,37,27.0,9,28,32.1,19,65,29.2,17,20,85.0,10,17,27,15,19,19,18,4,1,6,44,Siarka Tarnobrzeg,Sezon 2017/2018
2018-04-22 16:00,SKK Siedlce(w),85 : 68P,68,22,39,56.4,3,24,12.5,25,63,39.7,15,20,75.0,5,22,27,17,20,18,21,11,0,5,59,Siarka Tarnobrzeg,Sezon 2017/2018
2017-09-23 17:30,Pogoń Prudnik(w),76 : 64P,64,14,28,50.0,10,29,34.5,24,57,42.1,6,12,50.0,3,28,31,10,24,12,18,5,1,0,54,SKK Siedlce,Sezon 2017/2018
2017-09-30 16:00,Energa Kotwica Kołobrzeg(d),63 : 69P,63,21,40,52.5,5,26,19.2,26,66,39.4,6,14,42.9,10,28,38,13,15,19,15,10,6,0,67,SKK Siedlce,Sezon 2017/2018
2017-10-08 15:00,Biofarm Basket Poznań(w),86 : 72P,72,12,34,35.3,11,26,42.3,23,60,38.3,15,19,78.9,10,24,34,15,16,17,20,11,1,6,72,SKK Siedlce,Sezon 2017/2018
2017-10-18 18:00,GKS Tychy(d),90 : 97P,90,20,38,52.6,11,31,35.5,31,69,44.9,17,24,70.8,15,24,39,21,26,20,14,5,1,4,97,SKK Siedlce,Sezon 2017/2018
2017-10-21 18:00,Jamalex Polonia 1912 Leszno(w),94 : 87P,87,23,41,56.1,9,21,42.9,32,62,51.6,14,23,60.9,9,27,36,14,27,21,26,10,5,2,87,SKK Siedlce,Sezon 2017/2018
2017-10-29 18:00,Elektrobud-Investment ZB Pruszków(d),71 : 72P,71,15,31,48.4,12,31,38.7,27,62,43.5,5,13,38.5,11,17,28,15,21,19,16,8,2,2,65,SKK Siedlce,Sezon 2017/2018
2017-11-05 16:00,R8 Basket AZS Politechnika Kraków(w),76 : 62P,62,17,27,63.0,7,34,20.6,24,61,39.3,7,12,58.3,16,26,42,19,21,16,18,5,1,1,69,SKK Siedlce,Sezon 2017/2018
2017-11-08 18:00,Sokół Łańcut(d),78 : 91P,78,19,42,45.2,10,23,43.5,29,65,44.6,10,18,55.6,13,38,51,16,24,16,25,3,1,5,80,SKK Siedlce,Sezon 2017/2018
2017-11-11 20:00,WKS Śląsk Wrocław(w),84 : 63P,63,12,35,34.3,9,29,31.0,21,64,32.8,12,17,70.6,10,26,36,17,26,20,15,6,2,5,61,SKK Siedlce,Sezon 2017/2018
2017-11-18 18:00,Enea Astoria Bydgoszcz(d),85 : 79W,85,22,41,53.7,10,28,35.7,32,69,46.4,11,14,78.6,11,28,39,20,23,17,17,11,3,2,101,SKK Siedlce,Sezon 2017/2018
2017-11-25 17:30,Polfarmex Kutno(w),65 : 67W,67,20,36,55.6,4,18,22.2,24,54,44.4,15,26,57.7,9,22,31,13,17,25,25,13,2,5,60,SKK Siedlce,Sezon 2017/2018
2017-12-02 18:00,Zetkama Doral Nysa Kłodzko(d),71 : 58W,71,17,34,50.0,10,29,34.5,27,63,42.9,7,11,63.6,8,23,31,18,20,17,12,8,3,3,79,SKK Siedlce,Sezon 2017/2018
2017-12-06 20:00,KK Warszawa(w),69 : 79W,79,23,47,48.9,4,16,25.0,27,63,42.9,21,36,58.3,18,26,44,18,19,29,17,5,0,2,78,SKK Siedlce,Sezon 2017/2018
2017-12-09 19:00,Spójnia Stargard(d),93 : 96P,93,20,35,57.1,10,29,34.5,30,64,46.9,23,29,79.3,5,27,32,24,18,23,18,4,4,4,99,SKK Siedlce,Sezon 2017/2018
2017-12-16 18:00,KSK Noteć Inowrocław(w),69 : 56P,56,13,38,34.2,5,21,23.8,18,59,30.5,15,18,83.3,14,25,39,12,27,20,25,8,1,4,47,SKK Siedlce,Sezon 2017/2018
2017-12-23 16:00,Siarka Tarnobrzeg(d),86 : 77W,86,21,40,52.5,10,29,34.5,31,69,44.9,14,18,77.8,12,23,35,19,31,16,20,15,4,3,97,SKK Siedlce,Sezon 2017/2018
2018-01-06 18:00,Pogoń Prudnik(d),97 : 67W,97,16,24,66.7,17,34,50.0,33,58,56.9,14,17,82.4,9,29,38,19,21,20,14,2,7,1,121,SKK Siedlce,Sezon 2017/2018
2018-01-14 17:00,Energa Kotwica Kołobrzeg(w),81 : 68P,68,19,37,51.4,6,24,25.0,25,61,41.0,12,20,60.0,7,27,34,12,20,18,12,6,1,0,65,SKK Siedlce,Sezon 2017/2018
2018-01-20 18:00,Biofarm Basket Poznań(d),75 : 77P,75,15,31,48.4,10,26,38.5,25,57,43.9,15,18,83.3,7,17,24,14,18,19,9,4,2,3,75,SKK Siedlce,Sezon 2017/2018
2018-01-31 19:00,GKS Tychy(w),96 : 76P,76,22,37,59.5,5,20,25.0,27,57,47.4,17,22,77.3,4,24,28,13,22,22,19,8,1,2,72,SKK Siedlce,Sezon 2017/2018
2018-02-03 18:00,Jamalex Polonia 1912 Leszno(d),77 : 97P,77,18,38,47.4,9,23,39.1,27,61,44.3,14,19,73.7,8,21,29,18,25,19,14,4,3,3,78,SKK Siedlce,Sezon 2017/2018
2018-02-10 18:00,Elektrobud-Investment ZB Pruszków(w),80 : 71P,71,18,47,38.3,6,26,23.1,24,73,32.9,17,23,73.9,13,18,31,11,19,19,11,12,1,4,60,SKK Siedlce,Sezon 2017/2018
2018-02-18 19:00,R8 Basket AZS Politechnika Kraków(d),79 : 84P,79,22,38,57.9,9,31,29.0,31,69,44.9,8,13,61.5,13,24,37,17,15,14,13,6,2,0,85,SKK Siedlce,Sezon 2017/2018
2018-02-21 18:00,Sokół Łańcut(w),85 : 83P,83,23,41,56.1,9,21,42.9,32,62,51.6,10,11,90.9,11,27,38,17,23,13,18,6,0,2,95,SKK Siedlce,Sezon 2017/2018
2018-02-25 14:00,WKS Śląsk Wrocław(d),78 : 83P,78,24,51,47.1,8,24,33.3,32,75,42.7,6,13,46.2,17,21,38,11,17,19,14,6,4,3,73,SKK Siedlce,Sezon 2017/2018
2018-03-03 17:00,Enea Astoria Bydgoszcz(w),87 : 75P,75,22,47,46.8,7,27,25.9,29,74,39.2,10,15,66.7,10,21,31,13,31,17,15,14,3,2,71,SKK Siedlce,Sezon 2017/2018
2018-03-10 19:30,Polfarmex Kutno(d),57 : 75P,57,14,25,56.0,5,26,19.2,19,51,37.3,14,20,70.0,5,20,25,10,17,19,21,10,1,0,44,SKK Siedlce,Sezon 2017/2018
2018-03-17 17:00,Zetkama Doral Nysa Kłodzko(w),84 : 59P,59,12,29,41.4,7,27,25.9,19,56,33.9,14,19,73.7,8,24,32,12,21,19,13,4,1,2,53,SKK Siedlce,Sezon 2017/2018
2018-03-21 20:00,KK Warszawa(d),75 : 80P,75,20,37,54.1,7,26,26.9,27,63,42.9,14,19,73.7,14,24,38,15,23,18,24,8,4,1,75,SKK Siedlce,Sezon 2017/2018
2018-03-24 18:00,Spójnia Stargard(w),87 : 65P,65,18,40,45.0,8,24,33.3,26,64,40.6,5,12,41.7,13,17,30,14,18,18,21,6,0,2,49,SKK Siedlce,Sezon 2017/2018
2018-03-30 18:00,KSK Noteć Inowrocław(d),86 : 68W,86,23,48,47.9,7,23,30.4,30,71,42.3,19,23,82.6,13,32,45,14,21,24,9,6,5,3,102,SKK Siedlce,Sezon 2017/2018
2018-04-08 18:00,Siarka Tarnobrzeg(w),81 : 95W,95,22,36,61.1,14,36,38.9,36,72,50.0,9,13,69.2,9,18,27,15,20,16,8,12,1,2,102,SKK Siedlce,Sezon 2017/2018
2018-04-14 16:30,Siarka Tarnobrzeg(w),85 : 64P,64,18,38,47.4,7,32,21.9,25,70,35.7,7,14,50.0,10,25,35,11,21,14,18,10,4,6,54,SKK Siedlce,Sezon 2017/2018
2018-04-15 19:30,Siarka Tarnobrzeg(w),65 : 88W,88,28,50,56.0,6,25,24.0,34,75,45.3,14,18,77.8,18,31,49,13,27,18,16,12,3,0,104,SKK Siedlce,Sezon 2017/2018
2018-04-21 19:00,Siarka Tarnobrzeg(d),100 : 64W,100,24,40,60.0,12,33,36.4,36,73,49.3,16,24,66.7,18,34,52,25,19,19,14,8,6,1,132,SKK Siedlce,Sezon 2017/2018
2018-04-22 16:00,Siarka Tarnobrzeg(d),85 : 68W,85,22,37,59.5,8,26,30.8,30,63,47.6,17,24,70.8,12,24,36,16,18,19,18,8,5,0,92,SKK Siedlce,Sezon 2017/2018
2017-09-23 17:00,Zetkama Doral Nysa Kłodzko(w),75 : 80W,80,25,47,53.2,4,23,17.4,29,70,41.4,18,26,69.2,9,27,36,12,24,26,8,10,0,0,81,Sokół Łańcut,Sezon 2017/2018
2017-09-30 17:30,KK Warszawa(d),85 : 71W,85,19,31,61.3,7,19,36.8,26,50,52.0,26,41,63.4,9,18,27,20,19,29,9,6,0,0,90,Sokół Łańcut,Sezon 2017/2018
2017-10-07 18:00,Spójnia Stargard(w),92 : 67P,67,20,36,55.6,6,27,22.2,26,63,41.3,9,14,64.3,10,21,31,12,18,17,17,5,4,1,60,Sokół Łańcut,Sezon 2017/2018
2017-10-09 19:00,Energa Kotwica Kołobrzeg(w),77 : 85W,85,23,37,62.2,9,27,33.3,32,64,50.0,12,18,66.7,7,30,37,16,15,21,9,8,3,0,102,Sokół Łańcut,Sezon 2017/2018
2017-10-14 17:30,KSK Noteć Inowrocław(d),92 : 77W,92,25,44,56.8,9,24,37.5,34,68,50.0,15,21,71.4,13,11,24,19,11,24,8,12,1,1,100,Sokół Łańcut,Sezon 2017/2018
2017-10-18 19:00,Siarka Tarnobrzeg(w),63 : 82W,82,19,38,50.0,9,28,32.1,28,66,42.4,17,24,70.8,14,33,47,15,18,21,14,12,3,1,100,Sokół Łańcut,Sezon 2017/2018
2017-10-22 17:00,Pogoń Prudnik(w),75 : 88W,88,24,41,58.5,11,24,45.8,35,65,53.8,7,10,70.0,5,23,28,14,19,14,14,12,3,2,98,Sokół Łańcut,Sezon 2017/2018
2017-11-04 17:30,Biofarm Basket Poznań(d),83 : 70W,83,20,34,58.8,10,26,38.5,30,60,50.0,13,15,86.7,4,18,22,17,12,18,9,13,5,2,99,Sokół Łańcut,Sezon 2017/2018
2017-11-08 18:00,SKK Siedlce(w),78 : 91W,91,17,41,41.5,13,31,41.9,30,72,41.7,18,30,60.0,7,22,29,18,16,24,5,16,5,1,100,Sokół Łańcut,Sezon 2017/2018
2017-11-11 17:30,GKS Tychy(d),81 : 74W,81,21,34,61.8,8,24,33.3,29,58,50.0,15,26,57.7,8,29,37,20,19,25,12,6,7,1,99,Sokół Łańcut,Sezon 2017/2018
2017-11-18 17:00,Jamalex Polonia 1912 Leszno(w),79 : 49P,49,13,34,38.2,2,16,12.5,15,50,30.0,17,22,77.3,10,27,37,5,19,23,27,4,7,2,35,Sokół Łańcut,Sezon 2017/2018
2017-11-25 17:30,Elektrobud-Investment ZB Pruszków(d),87 : 81W,87,19,41,46.3,14,27,51.9,33,68,48.5,7,10,70.0,8,21,29,24,22,14,13,15,4,2,108,Sokół Łańcut,Sezon 2017/2018
2017-12-02 18:00,R8 Basket AZS Politechnika Kraków(w),66 : 86W,86,24,38,63.2,10,26,38.5,34,64,53.1,8,12,66.7,7,24,31,25,14,19,11,11,3,1,111,Sokół Łańcut,Sezon 2017/2018
2017-12-09 17:30,WKS Śląsk Wrocław(d),66 : 59W,66,20,45,44.4,5,21,23.8,25,66,37.9,11,15,73.3,11,36,47,12,13,19,15,10,6,2,81,Sokół Łańcut,Sezon 2017/2018
2017-12-16 17:00,Enea Astoria Bydgoszcz(w),80 : 75P,75,17,28,60.7,10,34,29.4,27,62,43.5,11,15,73.3,4,21,25,18,26,22,13,4,3,0,73,Sokół Łańcut,Sezon 2017/2018
2017-12-21 18:00,Polfarmex Kutno(d),78 : 57W,78,16,36,44.4,11,26,42.3,27,62,43.5,13,15,86.7,9,31,40,18,12,19,12,7,7,1,101,Sokół Łańcut,Sezon 2017/2018
2018-01-06 17:30,Zetkama Doral Nysa Kłodzko(d),86 : 72W,86,21,42,50.0,10,21,47.6,31,63,49.2,14,20,70.0,9,24,33,17,19,20,9,11,5,2,105,Sokół Łańcut,Sezon 2017/2018
2018-01-14 17:30,KK Warszawa(w),78 : 71P,71,18,41,43.9,8,24,33.3,26,65,40.0,11,19,57.9,8,24,32,14,17,21,12,9,2,1,69,Sokół Łańcut,Sezon 2017/2018
2018-01-20 17:30,Spójnia Stargard(d),78 : 101P,78,21,41,51.2,7,23,30.4,28,64,43.8,15,22,68.2,5,23,28,20,21,20,10,9,2,3,84,Sokół Łańcut,Sezon 2017/2018
2018-01-27 18:00,KSK Noteć Inowrocław(w),72 : 91W,91,21,37,56.8,8,20,40.0,29,57,50.9,25,31,80.6,8,23,31,19,17,24,13,15,4,0,113,Sokół Łańcut,Sezon 2017/2018
2018-01-31 18:00,Siarka Tarnobrzeg(d),85 : 81W,85,22,33,66.7,6,25,24.0,28,58,48.3,23,32,71.9,5,21,26,20,16,26,10,9,2,5,93,Sokół Łańcut,Sezon 2017/2018
2018-02-03 17:30,Pogoń Prudnik(d),79 : 71W,79,21,43,48.8,6,24,25.0,27,67,40.3,19,27,70.4,11,24,35,15,19,22,10,18,4,2,93,Sokół Łańcut,Sezon 2017/2018
2018-02-17 17:00,Biofarm Basket Poznań(w),86 : 75P,75,21,42,50.0,7,29,24.1,28,71,39.4,12,20,60.0,11,22,33,14,18,18,9,7,0,3,69,Sokół Łańcut,Sezon 2017/2018
2018-02-21 18:00,SKK Siedlce(d),85 : 83W,85,15,34,44.1,11,34,32.4,26,68,38.2,22,32,68.8,15,20,35,19,13,23,10,13,2,0,92,Sokół Łańcut,Sezon 2017/2018
2018-02-24 19:00,GKS Tychy(w),104 : 83P,83,24,39,61.5,7,22,31.8,31,61,50.8,14,21,66.7,8,18,26,14,11,20,14,7,2,0,81,Sokół Łańcut,Sezon 2017/2018
2018-03-03 18:00,Jamalex Polonia 1912 Leszno(d),81 : 77W,81,11,31,35.5,14,34,41.2,25,65,38.5,17,24,70.8,14,24,38,17,20,20,10,4,5,6,88,Sokół Łańcut,Sezon 2017/2018
2018-03-11 17:00,Elektrobud-Investment ZB Pruszków(w),83 : 73P,73,16,36,44.4,7,23,30.4,23,59,39.0,20,29,69.0,6,16,22,16,19,23,10,13,1,3,70,Sokół Łańcut,Sezon 2017/2018
2018-03-17 17:30,R8 Basket AZS Politechnika Kraków(d),84 : 66W,84,20,42,47.6,11,22,50.0,31,64,48.4,11,18,61.1,7,29,36,16,15,18,8,10,3,0,101,Sokół Łańcut,Sezon 2017/2018
2018-03-24 19:00,WKS Śląsk Wrocław(w),65 : 85W,85,28,53,52.8,2,20,10.0,30,73,41.1,23,33,69.7,19,21,40,19,19,25,8,9,1,2,93,Sokół Łańcut,Sezon 2017/2018
2018-03-26 17:00,Energa Kotwica Kołobrzeg(d),76 : 62W,76,15,34,44.1,10,32,31.3,25,66,37.9,16,23,69.6,13,28,41,13,18,25,8,6,0,0,80,Sokół Łańcut,Sezon 2017/2018
2018-03-29 15:30,Enea Astoria Bydgoszcz(d),81 : 71W,81,19,40,47.5,8,26,30.8,27,66,40.9,19,27,70.4,17,15,32,16,16,23,9,10,5,1,88,Sokół Łańcut,Sezon 2017/2018
2018-04-08 18:00,Polfarmex Kutno(w),58 : 78W,78,22,41,53.7,9,25,36.0,31,66,47.0,7,14,50.0,10,23,33,16,8,16,10,11,3,3,89,Sokół Łańcut,Sezon 2017/2018
2018-04-14 17:30,Polfarmex Kutno(d),73 : 66W,73,21,33,63.6,8,26,30.8,29,59,49.2,7,13,53.8,7,28,35,19,15,20,17,11,4,0,89,Sokół Łańcut,Sezon 2017/2018
2018-04-15 17:30,Polfarmex Kutno(d),71 : 65W,71,17,29,58.6,9,28,32.1,26,57,45.6,10,14,71.4,7,21,28,15,16,18,13,8,3,2,77,Sokół Łańcut,Sezon 2017/2018
2018-04-21 17:30,Polfarmex Kutno(w),73 : 66P,66,13,30,43.3,8,28,28.6,21,58,36.2,16,29,55.2,11,18,29,11,17,19,12,9,0,2,53,Sokół Łańcut,Sezon 2017/2018
2018-04-22 17:30,Polfarmex Kutno(w),76 : 82W,82,22,45,48.9,8,23,34.8,30,68,44.1,14,26,53.8,12,28,40,17,14,25,14,7,4,2,86,Sokół Łańcut,Sezon 2017/2018
2018-04-28 19:00,Jamalex Polonia 1912 Leszno(w),66 : 73W,73,15,27,55.6,9,34,26.5,24,61,39.3,16,22,72.7,10,28,38,16,17,23,9,8,3,0,86,Sokół Łańcut,Sezon 2017/2018
2018-04-29 17:00,Jamalex Polonia 1912 Leszno(w),63 : 83W,83,18,34,52.9,12,28,42.9,30,62,48.4,11,16,68.8,9,26,35,14,16,20,12,7,0,2,90,Sokół Łańcut,Sezon 2017/2018
2018-05-05 17:30,Jamalex Polonia 1912 Leszno(d),75 : 82P,75,18,29,62.1,9,24,37.5,27,53,50.9,12,26,46.2,5,24,29,22,16,20,11,10,4,0,89,Sokół Łańcut,Sezon 2017/2018
2018-05-06 17:30,Jamalex Polonia 1912 Leszno(d),87 : 83W,87,27,42,64.3,5,19,26.3,32,61,52.5,18,28,64.3,11,23,34,18,15,29,13,7,7,0,101,Sokół Łańcut,Sezon 2017/2018
2018-05-12 18:00,Spójnia Stargard(w),76 : 73P,73,23,46,50.0,5,29,17.2,28,75,37.3,12,23,52.2,12,21,33,14,16,25,5,13,1,7,71,Sokół Łańcut,Sezon 2017/2018
2018-05-13 18:00,Spójnia Stargard(w),105 : 83P,83,20,39,51.3,9,25,36.0,29,64,45.3,16,23,69.6,12,16,28,17,14,23,14,5,1,1,78,Sokół Łańcut,Sezon 2017/2018
2018-05-17 18:00,Spójnia Stargard(d),89 : 94P,89,18,45,40.0,13,22,59.1,31,67,46.3,14,20,70.0,9,17,26,24,19,18,8,9,3,2,101,Sokół Łańcut,Sezon 2017/2018
2017-09-23 18:00,Elektrobud-Investment ZB Pruszków(d),85 : 65W,85,28,47,59.6,7,23,30.4,35,70,50.0,8,15,53.3,10,23,33,16,18,17,13,9,4,3,92,Spójnia Stargard,Sezon 2017/2018
2017-09-30 18:30,R8 Basket AZS Politechnika Kraków(w),71 : 88W,88,25,44,56.8,8,21,38.1,33,65,50.8,14,19,73.7,7,29,36,20,23,21,10,7,0,2,104,Spójnia Stargard,Sezon 2017/2018
2017-10-07 18:00,Sokół Łańcut(d),92 : 67W,92,25,45,55.6,11,32,34.4,36,77,46.8,9,14,64.3,16,23,39,20,17,18,12,11,1,4,105,Spójnia Stargard,Sezon 2017/2018
2017-10-15 19:00,WKS Śląsk Wrocław(w),94 : 100W,100,33,52,63.5,2,11,18.2,35,63,55.6,28,31,90.3,8,24,32,22,20,24,13,6,0,2,116,Spójnia Stargard,Sezon 2017/2018
2017-10-18 18:00,Enea Astoria Bydgoszcz(d),89 : 84W,89,16,36,44.4,16,30,53.3,32,66,48.5,9,14,64.3,9,25,34,21,18,16,15,8,6,2,104,Spójnia Stargard,Sezon 2017/2018
2017-10-21 17:30,Polfarmex Kutno(w),75 : 79W,79,15,30,50.0,12,30,40.0,27,60,45.0,13,19,68.4,9,25,34,24,21,20,19,5,5,3,89,Spójnia Stargard,Sezon 2017/2018
2017-10-28 18:00,Zetkama Doral Nysa Kłodzko(d),91 : 61W,91,24,38,63.2,8,18,44.4,32,56,57.1,19,24,79.2,5,34,39,21,19,27,22,6,4,2,110,Spójnia Stargard,Sezon 2017/2018
2017-11-05 15:00,KK Warszawa(w),83 : 95W,95,28,37,75.7,7,21,33.3,35,58,60.3,18,27,66.7,8,24,32,24,15,21,20,8,5,1,112,Spójnia Stargard,Sezon 2017/2018
2017-11-11 18:00,KSK Noteć Inowrocław(d),94 : 71W,94,31,47,66.0,7,22,31.8,38,69,55.1,11,14,78.6,11,31,42,24,15,16,11,3,0,3,118,Spójnia Stargard,Sezon 2017/2018
2017-11-18 18:00,Siarka Tarnobrzeg(w),80 : 86W,86,20,33,60.6,11,24,45.8,31,57,54.4,13,16,81.3,5,26,31,18,19,25,22,10,0,1,94,Spójnia Stargard,Sezon 2017/2018
2017-11-25 18:00,Pogoń Prudnik(d),82 : 65W,82,22,43,51.2,8,26,30.8,30,69,43.5,14,17,82.4,13,24,37,19,14,12,9,4,3,4,94,Spójnia Stargard,Sezon 2017/2018
2017-12-02 18:00,Energa Kotwica Kołobrzeg(w),82 : 89W,89,24,37,64.9,10,27,37.0,34,64,53.1,11,15,73.3,10,26,36,16,18,15,12,6,3,0,104,Spójnia Stargard,Sezon 2017/2018
2017-12-06 18:00,Biofarm Basket Poznań(d),89 : 61W,89,21,34,61.8,12,26,46.2,33,60,55.0,11,20,55.0,8,32,40,21,24,19,16,8,2,4,108,Spójnia Stargard,Sezon 2017/2018
2017-12-09 19:00,SKK Siedlce(w),93 : 96W,96,28,50,56.0,11,36,30.6,39,86,45.3,7,14,50.0,14,24,38,22,23,18,9,14,4,4,111,Spójnia Stargard,Sezon 2017/2018
2017-12-16 18:00,GKS Tychy(d),102 : 74W,102,26,35,74.3,12,24,50.0,38,59,64.4,14,21,66.7,9,25,34,23,24,22,13,10,0,2,128,Spójnia Stargard,Sezon 2017/2018
2017-12-21 20:00,Jamalex Polonia 1912 Leszno(w),76 : 67P,67,17,33,51.5,5,17,29.4,22,50,44.0,18,30,60.0,4,19,23,13,22,28,18,6,0,2,51,Spójnia Stargard,Sezon 2017/2018
2018-01-06 18:00,Elektrobud-Investment ZB Pruszków(w),79 : 103W,103,26,42,61.9,11,24,45.8,37,66,56.1,18,22,81.8,8,23,31,25,17,23,9,10,2,1,129,Spójnia Stargard,Sezon 2017/2018
2018-01-13 18:00,R8 Basket AZS Politechnika Kraków(d),81 : 78W,81,23,42,54.8,9,31,29.0,32,73,43.8,8,13,61.5,10,28,38,18,19,14,10,7,2,1,90,Spójnia Stargard,Sezon 2017/2018
2018-01-20 17:30,Sokół Łańcut(w),78 : 101W,101,21,38,55.3,13,32,40.6,34,70,48.6,20,25,80.0,15,29,44,26,20,20,13,6,3,2,126,Spójnia Stargard,Sezon 2017/2018
2018-01-27 18:00,WKS Śląsk Wrocław(d),77 : 69W,77,23,48,47.9,5,17,29.4,28,65,43.1,16,25,64.0,11,28,39,13,20,24,10,4,1,2,78,Spójnia Stargard,Sezon 2017/2018
2018-01-31 18:30,Enea Astoria Bydgoszcz(w),76 : 88W,88,24,43,55.8,10,26,38.5,34,69,49.3,10,12,83.3,8,17,25,22,20,16,14,11,4,3,99,Spójnia Stargard,Sezon 2017/2018
2018-02-04 17:00,Polfarmex Kutno(d),98 : 75W,98,21,35,60.0,12,22,54.5,33,57,57.9,20,30,66.7,7,27,34,23,19,24,13,8,5,2,121,Spójnia Stargard,Sezon 2017/2018
2018-02-14 19:30,Zetkama Doral Nysa Kłodzko(w),74 : 96W,96,19,36,52.8,10,23,43.5,29,59,49.2,28,32,87.5,10,23,33,18,19,26,13,8,1,1,109,Spójnia Stargard,Sezon 2017/2018
2018-02-18 17:30,KK Warszawa(d),75 : 79P,75,19,44,43.2,9,33,27.3,28,77,36.4,10,17,58.8,17,23,40,13,22,18,16,17,2,2,75,Spójnia Stargard,Sezon 2017/2018
2018-02-24 18:00,KSK Noteć Inowrocław(w),68 : 81W,81,25,47,53.2,7,18,38.9,32,65,49.2,10,11,90.9,7,28,35,21,20,18,14,9,3,4,101,Spójnia Stargard,Sezon 2017/2018
2018-03-03 18:00,Siarka Tarnobrzeg(d),74 : 73W,74,24,43,55.8,5,25,20.0,29,68,42.6,11,17,64.7,15,21,36,14,14,17,13,11,0,0,77,Spójnia Stargard,Sezon 2017/2018
2018-03-10 17:30,Pogoń Prudnik(w),77 : 80W,80,20,37,54.1,8,21,38.1,28,58,48.3,16,24,66.7,9,23,32,14,19,20,14,6,3,2,83,Spójnia Stargard,Sezon 2017/2018
2018-03-17 18:30,Energa Kotwica Kołobrzeg(d),92 : 76W,92,21,36,58.3,10,23,43.5,31,59,52.5,20,24,83.3,11,25,36,14,17,24,19,8,3,0,102,Spójnia Stargard,Sezon 2017/2018
2018-03-21 17:00,Biofarm Basket Poznań(w),72 : 74W,74,23,44,52.3,5,20,25.0,28,64,43.8,13,17,76.5,7,29,36,15,20,15,12,9,1,2,83,Spójnia Stargard,Sezon 2017/2018
2018-03-24 18:00,SKK Siedlce(d),87 : 65W,87,26,37,70.3,7,23,30.4,33,60,55.0,14,16,87.5,4,26,30,21,18,18,13,10,2,0,108,Spójnia Stargard,Sezon 2017/2018
2018-03-29 18:00,GKS Tychy(w),100 : 91P,91,22,36,61.1,9,28,32.1,31,64,48.4,20,22,90.9,9,20,29,18,17,22,12,3,3,2,97,Spójnia Stargard,Sezon 2017/2018
2018-04-08 18:00,Jamalex Polonia 1912 Leszno(d),78 : 85P,78,22,37,59.5,7,19,36.8,29,56,51.8,13,15,86.7,10,27,37,14,23,21,24,6,1,0,83,Spójnia Stargard,Sezon 2017/2018
2018-04-14 18:00,Biofarm Basket Poznań(d),86 : 73W,86,22,45,48.9,9,27,33.3,31,72,43.1,15,16,93.8,10,32,42,21,14,21,13,12,4,3,110,Spójnia Stargard,Sezon 2017/2018
2018-04-15 18:00,Biofarm Basket Poznań(d),77 : 70W,77,18,42,42.9,8,22,36.4,26,64,40.6,17,21,81.0,5,26,31,14,20,20,9,8,2,3,81,Spójnia Stargard,Sezon 2017/2018
2018-04-21 17:00,Biofarm Basket Poznań(w),87 : 76P,76,21,43,48.8,7,21,33.3,28,64,43.8,13,15,86.7,10,34,44,17,23,16,16,4,2,3,89,Spójnia Stargard,Sezon 2017/2018
2018-04-22 17:00,Biofarm Basket Poznań(w),79 : 92W,92,20,33,60.6,13,31,41.9,33,64,51.6,13,25,52.0,10,23,33,24,16,19,10,8,2,2,106,Spójnia Stargard,Sezon 2017/2018
2018-04-28 18:00,GKS Tychy(d),85 : 61W,85,21,34,61.8,12,30,40.0,33,64,51.6,7,11,63.6,13,32,45,20,22,17,16,7,3,0,109,Spójnia Stargard,Sezon 2017/2018
2018-04-29 18:00,GKS Tychy(d),93 : 77W,93,21,30,70.0,12,24,50.0,33,54,61.1,15,16,93.8,4,24,28,24,21,18,16,6,1,0,114,Spójnia Stargard,Sezon 2017/2018
2018-05-05 18:00,GKS Tychy(w),122 : 126W,126,25,43,58.1,16,38,42.1,41,81,50.6,28,32,87.5,11,23,34,29,23,24,12,12,2,3,147,Spójnia Stargard,Sezon 2017/2018
2018-05-12 18:00,Sokół Łańcut(d),76 : 73W,76,21,36,58.3,7,21,33.3,28,57,49.1,13,18,72.2,9,38,47,16,25,16,18,4,7,1,98,Spójnia Stargard,Sezon 2017/2018
2018-05-13 18:00,Sokół Łańcut(d),105 : 83W,105,32,53,60.4,10,21,47.6,42,74,56.8,11,13,84.6,13,27,40,23,23,14,11,10,1,1,134,Spójnia Stargard,Sezon 2017/2018
2018-05-17 18:00,Sokół Łańcut(w),89 : 94W,94,21,35,60.0,12,24,50.0,33,59,55.9,16,21,76.2,10,24,34,19,18,19,15,7,2,3,110,Spójnia Stargard,Sezon 2017/2018
2017-09-23 17:30,Polfarmex Kutno(w),86 : 74P,74,18,39,46.2,7,21,33.3,25,60,41.7,17,25,68.0,7,20,27,14,15,22,16,7,3,0,66,WKS Śląsk Wrocław,Sezon 2017/2018
2017-09-30 20:00,Zetkama Doral Nysa Kłodzko(d),70 : 56W,70,19,39,48.7,7,25,28.0,26,64,40.6,11,17,64.7,6,38,44,17,17,18,13,3,3,4,80,WKS Śląsk Wrocław,Sezon 2017/2018
2017-10-08 15:00,KK Warszawa(w),56 : 72W,72,19,43,44.2,5,20,25.0,24,63,38.1,19,25,76.0,15,35,50,12,17,25,17,7,2,1,81,WKS Śląsk Wrocław,Sezon 2017/2018
2017-10-15 19:00,Spójnia Stargard(d),94 : 100P,94,26,45,57.8,9,25,36.0,35,70,50.0,15,18,83.3,9,18,27,20,24,20,10,8,2,0,103,WKS Śląsk Wrocław,Sezon 2017/2018
2017-10-18 18:00,KSK Noteć Inowrocław(w),74 : 66P,66,19,36,52.8,5,21,23.8,24,57,42.1,13,18,72.2,10,27,37,11,19,17,15,4,1,2,66,WKS Śląsk Wrocław,Sezon 2017/2018
2017-10-21 20:00,Siarka Tarnobrzeg(d),73 : 100P,73,17,34,50.0,8,27,29.6,25,61,41.0,15,20,75.0,11,28,39,15,18,17,23,3,2,4,68,WKS Śląsk Wrocław,Sezon 2017/2018
2017-10-28 17:30,Pogoń Prudnik(w),69 : 74W,74,15,30,50.0,9,30,30.0,24,60,40.0,17,22,77.3,7,29,36,9,30,21,16,11,3,4,76,WKS Śląsk Wrocław,Sezon 2017/2018
2017-11-04 18:00,Energa Kotwica Kołobrzeg(d),73 : 74P,73,18,45,40.0,11,28,39.3,29,73,39.7,4,4,100.0,10,33,43,13,16,15,17,5,7,0,80,WKS Śląsk Wrocław,Sezon 2017/2018
2017-11-08 17:00,Biofarm Basket Poznań(w),77 : 82W,82,22,40,55.0,9,33,27.3,31,73,42.5,11,16,68.8,13,28,41,20,22,20,10,5,1,3,92,WKS Śląsk Wrocław,Sezon 2017/2018
2017-11-11 20:00,SKK Siedlce(d),84 : 63W,84,21,42,50.0,6,33,18.2,27,75,36.0,24,27,88.9,18,29,47,18,20,26,12,9,5,2,100,WKS Śląsk Wrocław,Sezon 2017/2018
2017-11-18 19:00,GKS Tychy(w),96 : 88P,88,18,36,50.0,14,30,46.7,32,66,48.5,10,14,71.4,10,23,33,14,19,19,16,5,3,2,89,WKS Śląsk Wrocław,Sezon 2017/2018
2017-11-24 20:00,Jamalex Polonia 1912 Leszno(d),86 : 96P,86,21,43,48.8,9,29,31.0,30,72,41.7,17,27,63.0,11,30,41,18,23,24,12,4,4,1,89,WKS Śląsk Wrocław,Sezon 2017/2018
2017-11-29 19:00,R8 Basket AZS Politechnika Kraków(d),77 : 89P,77,23,40,57.5,8,25,32.0,31,65,47.7,7,13,53.8,8,27,35,15,22,17,15,1,2,1,75,WKS Śląsk Wrocław,Sezon 2017/2018
2017-12-02 18:00,Elektrobud-Investment ZB Pruszków(w),81 : 82W,82,14,29,48.3,15,38,39.5,29,67,43.3,9,11,81.8,7,27,34,19,29,17,13,5,3,5,90,WKS Śląsk Wrocław,Sezon 2017/2018
2017-12-09 17:30,Sokół Łańcut(w),66 : 59P,59,14,40,35.0,9,34,26.5,23,74,31.1,4,6,66.7,10,26,36,11,19,13,15,9,2,6,49,WKS Śląsk Wrocław,Sezon 2017/2018
2017-12-20 19:00,Enea Astoria Bydgoszcz(d),89 : 71W,89,24,50,48.0,11,28,39.3,35,78,44.9,8,11,72.7,18,25,43,18,25,16,11,8,5,3,106,WKS Śląsk Wrocław,Sezon 2017/2018
2018-01-07 18:00,Polfarmex Kutno(d),57 : 79P,57,15,35,42.9,4,23,17.4,19,58,32.8,15,19,78.9,11,25,36,12,28,20,18,4,1,2,49,WKS Śląsk Wrocław,Sezon 2017/2018
2018-01-13 17:00,Zetkama Doral Nysa Kłodzko(w),88 : 72P,72,18,37,48.6,7,27,25.9,25,64,39.1,15,19,78.9,6,23,29,10,20,19,9,3,1,3,63,WKS Śląsk Wrocław,Sezon 2017/2018
2018-01-20 18:00,KK Warszawa(d),89 : 53W,89,23,39,59.0,11,33,33.3,34,72,47.2,10,12,83.3,9,35,44,17,23,14,13,10,7,1,114,WKS Śląsk Wrocław,Sezon 2017/2018
2018-01-27 18:00,Spójnia Stargard(w),77 : 69P,69,20,44,45.5,6,26,23.1,26,70,37.1,11,20,55.0,14,24,38,13,24,20,9,2,2,1,62,WKS Śląsk Wrocław,Sezon 2017/2018
2018-01-31 19:00,KSK Noteć Inowrocław(d),89 : 76W,89,23,45,51.1,12,27,44.4,35,72,48.6,7,11,63.6,10,23,33,20,23,18,12,7,4,2,100,WKS Śląsk Wrocław,Sezon 2017/2018
2018-02-03 18:00,Siarka Tarnobrzeg(w),73 : 71P,71,18,37,48.6,8,28,28.6,26,65,40.0,11,15,73.3,12,25,37,16,22,18,17,6,0,3,70,WKS Śląsk Wrocław,Sezon 2017/2018
2018-02-14 18:00,Pogoń Prudnik(d),98 : 100P,98,19,42,45.2,13,29,44.8,32,71,45.1,21,26,80.8,11,25,36,15,22,22,12,8,5,1,106,WKS Śląsk Wrocław,Sezon 2017/2018
2018-02-17 18:00,Energa Kotwica Kołobrzeg(w),77 : 82W,82,25,49,51.0,6,21,28.6,31,70,44.3,14,23,60.9,17,28,45,13,23,22,11,3,2,2,86,WKS Śląsk Wrocław,Sezon 2017/2018
2018-02-21 18:00,Biofarm Basket Poznań(d),92 : 87W,92,20,40,50.0,13,31,41.9,33,71,46.5,13,14,92.9,14,19,33,16,18,21,11,7,1,2,99,WKS Śląsk Wrocław,Sezon 2017/2018
2018-02-25 14:00,SKK Siedlce(w),78 : 83W,83,19,40,47.5,12,28,42.9,31,68,45.6,9,17,52.9,14,26,40,20,19,16,14,4,3,4,91,WKS Śląsk Wrocław,Sezon 2017/2018
2018-03-04 20:30,GKS Tychy(d),94 : 86W,94,21,33,63.6,13,35,37.1,34,68,50.0,13,18,72.2,10,25,35,18,32,24,14,4,3,2,101,WKS Śląsk Wrocław,Sezon 2017/2018
2018-03-10 18:00,Jamalex Polonia 1912 Leszno(w),61 : 79W,79,17,38,44.7,11,28,39.3,28,66,42.4,12,17,70.6,11,32,43,17,24,21,14,4,4,3,90,WKS Śląsk Wrocław,Sezon 2017/2018
2018-03-18 18:30,Elektrobud-Investment ZB Pruszków(d),82 : 81W,82,22,40,55.0,10,25,40.0,32,65,49.2,8,11,72.7,7,27,34,21,25,18,17,6,7,0,97,WKS Śląsk Wrocław,Sezon 2017/2018
2018-03-21 19:00,R8 Basket AZS Politechnika Kraków(w),93 : 75P,75,17,37,45.9,9,24,37.5,26,61,42.6,14,21,66.7,13,19,32,17,19,22,12,4,5,2,79,WKS Śląsk Wrocław,Sezon 2017/2018
2018-03-24 19:00,Sokół Łańcut(d),65 : 85P,65,21,40,52.5,4,15,26.7,25,55,45.5,11,15,73.3,9,27,36,10,26,19,22,3,2,1,60,WKS Śląsk Wrocław,Sezon 2017/2018
2018-04-08 18:00,Enea Astoria Bydgoszcz(w),73 : 71P,71,20,40,50.0,8,35,22.9,28,75,37.3,7,12,58.3,11,30,41,16,19,18,19,7,4,2,68,WKS Śląsk Wrocław,Sezon 2017/2018
2017-09-23 17:00,Sokół Łańcut(d),75 : 80P,75,18,33,54.5,8,32,25.0,26,65,40.0,15,21,71.4,12,29,41,14,26,24,15,3,0,0,73,Zetkama Doral Nysa Kłodzko,Sezon 2017/2018
2017-09-30 20:00,WKS Śląsk Wrocław(w),70 : 56P,56,11,38,28.9,8,23,34.8,19,61,31.1,10,15,66.7,4,24,28,9,18,17,11,5,4,3,44,Zetkama Doral Nysa Kłodzko,Sezon 2017/2018
2017-10-07 17:00,Enea Astoria Bydgoszcz(d),79 : 98P,79,21,44,47.7,8,27,29.6,29,71,40.8,13,18,72.2,12,20,32,16,24,23,13,8,3,1,78,Zetkama Doral Nysa Kłodzko,Sezon 2017/2018
2017-10-14 17:30,Polfarmex Kutno(w),57 : 43P,43,7,19,36.8,6,27,22.2,13,46,28.3,11,14,78.6,3,27,30,6,22,21,17,4,1,2,31,Zetkama Doral Nysa Kłodzko,Sezon 2017/2018
2017-10-21 17:00,KK Warszawa(d),70 : 90P,70,11,36,30.6,11,31,35.5,22,67,32.8,15,23,65.2,12,22,34,14,21,23,13,4,1,4,57,Zetkama Doral Nysa Kłodzko,Sezon 2017/2018
2017-10-28 18:00,Spójnia Stargard(w),91 : 61P,61,12,37,32.4,8,28,28.6,20,65,30.8,13,20,65.0,5,17,22,13,27,20,14,16,2,4,48,Zetkama Doral Nysa Kłodzko,Sezon 2017/2018
2017-11-04 17:00,KSK Noteć Inowrocław(d),90 : 84W,90,14,32,43.8,12,28,42.9,26,60,43.3,26,33,78.8,10,19,29,20,30,29,5,9,1,1,103,Zetkama Doral Nysa Kłodzko,Sezon 2017/2018
2017-11-08 19:00,Siarka Tarnobrzeg(w),75 : 70P,70,20,35,57.1,6,29,20.7,26,64,40.6,12,17,70.6,9,22,31,10,24,23,15,8,2,1,63,Zetkama Doral Nysa Kłodzko,Sezon 2017/2018
2017-11-11 17:00,Pogoń Prudnik(d),62 : 70P,62,20,32,62.5,3,29,10.3,23,61,37.7,13,19,68.4,8,26,34,12,16,20,9,6,0,1,61,Zetkama Doral Nysa Kłodzko,Sezon 2017/2018
2017-11-19 17:00,Energa Kotwica Kołobrzeg(w),60 : 63W,63,18,37,48.6,6,22,27.3,24,59,40.7,9,12,75.0,14,30,44,12,19,18,23,5,3,1,66,Zetkama Doral Nysa Kłodzko,Sezon 2017/2018
2017-11-25 17:00,Biofarm Basket Poznań(d),63 : 71P,63,22,43,51.2,2,16,12.5,24,59,40.7,13,23,56.5,5,24,29,13,19,22,9,6,3,4,60,Zetkama Doral Nysa Kłodzko,Sezon 2017/2018
2017-12-02 18:00,SKK Siedlce(w),71 : 58P,58,15,39,38.5,6,21,28.6,21,60,35.0,10,12,83.3,13,25,38,11,17,20,14,5,3,3,60,Zetkama Doral Nysa Kłodzko,Sezon 2017/2018
2017-12-06 19:30,GKS Tychy(d),59 : 56W,59,12,29,41.4,8,21,38.1,20,50,40.0,11,13,84.6,2,29,31,14,14,21,9,4,8,0,75,Zetkama Doral Nysa Kłodzko,Sezon 2017/2018
2017-12-09 18:00,Jamalex Polonia 1912 Leszno(w),79 : 57P,57,10,21,47.6,7,25,28.0,17,46,37.0,16,21,76.2,4,24,28,10,22,20,20,6,0,1,47,Zetkama Doral Nysa Kłodzko,Sezon 2017/2018
2017-12-16 17:00,Elektrobud-Investment ZB Pruszków(d),76 : 66W,76,23,39,59.0,9,23,39.1,32,62,51.6,3,6,50.0,8,15,23,22,10,13,7,11,0,3,92,Zetkama Doral Nysa Kłodzko,Sezon 2017/2018
2017-12-22 18:00,R8 Basket AZS Politechnika Kraków(w),103 : 86P,86,19,37,51.4,10,26,38.5,29,63,46.0,18,26,69.2,13,11,24,21,25,22,13,5,5,1,86,Zetkama Doral Nysa Kłodzko,Sezon 2017/2018
2018-01-06 17:30,Sokół Łańcut(w),86 : 72P,72,24,42,57.1,5,15,33.3,29,57,50.9,9,11,81.8,4,21,25,12,20,19,14,4,2,5,71,Zetkama Doral Nysa Kłodzko,Sezon 2017/2018
2018-01-13 17:00,WKS Śląsk Wrocław(d),88 : 72W,88,22,43,51.2,10,19,52.6,32,62,51.6,14,19,73.7,6,27,33,20,19,20,6,3,3,1,106,Zetkama Doral Nysa Kłodzko,Sezon 2017/2018
2018-01-20 17:00,Enea Astoria Bydgoszcz(w),89 : 90W,90,23,37,62.2,8,28,28.6,31,65,47.7,20,28,71.4,11,21,32,11,28,23,15,7,1,1,84,Zetkama Doral Nysa Kłodzko,Sezon 2017/2018
2018-01-24 19:30,Polfarmex Kutno(d),83 : 75W,83,17,37,45.9,8,15,53.3,25,52,48.1,25,31,80.6,3,33,36,18,18,28,12,3,2,4,97,Zetkama Doral Nysa Kłodzko,Sezon 2017/2018
2018-02-04 15:00,KK Warszawa(w),79 : 67P,67,19,38,50.0,4,23,17.4,23,61,37.7,17,27,63.0,10,19,29,14,27,26,13,7,3,2,59,Zetkama Doral Nysa Kłodzko,Sezon 2017/2018
2018-02-14 19:30,Spójnia Stargard(d),74 : 96P,74,23,42,54.8,6,18,33.3,29,60,48.3,10,22,45.5,12,20,32,21,26,19,14,8,1,1,79,Zetkama Doral Nysa Kłodzko,Sezon 2017/2018
2018-02-17 16:00,KSK Noteć Inowrocław(w),74 : 69P,69,17,29,58.6,9,28,32.1,26,57,45.6,8,12,66.7,9,27,36,18,16,16,14,3,1,1,78,Zetkama Doral Nysa Kłodzko,Sezon 2017/2018
2018-02-21 19:30,Siarka Tarnobrzeg(d),71 : 80P,71,18,36,50.0,5,18,27.8,23,54,42.6,20,26,76.9,8,19,27,12,30,24,18,8,0,1,63,Zetkama Doral Nysa Kłodzko,Sezon 2017/2018
2018-02-24 17:30,Pogoń Prudnik(w),94 : 87P,87,15,31,48.4,12,31,38.7,27,62,43.5,21,24,87.5,8,22,30,15,28,21,10,3,0,2,87,Zetkama Doral Nysa Kłodzko,Sezon 2017/2018
2018-03-07 19:30,Energa Kotwica Kołobrzeg(d),79 : 57W,79,21,39,53.8,9,25,36.0,30,64,46.9,10,13,76.9,15,33,48,21,22,13,18,5,4,1,102,Zetkama Doral Nysa Kłodzko,Sezon 2017/2018
2018-03-10 17:00,Biofarm Basket Poznań(w),73 : 43P,43,9,38,23.7,5,22,22.7,14,60,23.3,10,18,55.6,7,23,30,9,17,19,11,7,1,2,25,Zetkama Doral Nysa Kłodzko,Sezon 2017/2018
2018-03-17 17:00,SKK Siedlce(d),84 : 59W,84,19,35,54.3,11,29,37.9,30,64,46.9,13,21,61.9,12,28,40,17,19,21,7,8,2,1,102,Zetkama Doral Nysa Kłodzko,Sezon 2017/2018
2018-03-21 19:00,GKS Tychy(w),102 : 79P,79,23,41,56.1,7,23,30.4,30,64,46.9,12,19,63.2,15,14,29,12,22,21,14,6,3,1,74,Zetkama Doral Nysa Kłodzko,Sezon 2017/2018
2018-03-24 17:00,Jamalex Polonia 1912 Leszno(d),70 : 81P,70,19,37,51.4,7,19,36.8,26,56,46.4,11,18,61.1,8,17,25,21,18,22,13,4,4,2,74,Zetkama Doral Nysa Kłodzko,Sezon 2017/2018
2018-03-31 16:00,Elektrobud-Investment ZB Pruszków(w),63 : 61P,61,17,34,50.0,6,28,21.4,23,62,37.1,9,14,64.3,11,18,29,12,18,16,13,15,2,4,62,Zetkama Doral Nysa Kłodzko,Sezon 2017/2018
2018-04-08 18:00,R8 Basket AZS Politechnika Kraków(d),92 : 90W,92,20,36,55.6,9,24,37.5,29,60,48.3,25,35,71.4,8,22,30,21,25,29,9,6,1,0,100,Zetkama Doral Nysa Kłodzko,Sezon 2017/2018
2018-04-14 17:30,Pogoń Prudnik(w),56 : 58W,58,16,32,50.0,4,21,19.0,20,53,37.7,14,20,70.0,10,28,38,4,19,19,14,5,5,5,57,Zetkama Doral Nysa Kłodzko,Sezon 2017/2018
2018-04-15 17:30,Pogoń Prudnik(w),77 : 54P,54,14,35,40.0,5,25,20.0,19,60,31.7,11,13,84.6,11,14,25,12,21,18,12,7,0,3,43,Zetkama Doral Nysa Kłodzko,Sezon 2017/2018
2018-04-21 19:00,Pogoń Prudnik(d),63 : 65P,63,15,41,36.6,6,31,19.4,21,72,29.2,15,29,51.7,11,34,45,12,25,26,11,10,2,3,56,Zetkama Doral Nysa Kłodzko,Sezon 2017/2018
2018-04-22 17:00,Pogoń Prudnik(d),68 : 81P,68,17,38,44.7,7,29,24.1,24,67,35.8,13,14,92.9,8,19,27,18,22,20,8,5,2,3,68,Zetkama Doral Nysa Kłodzko,Sezon 2017/2018
2016-09-24 17:30,meritumkredyt Pogoń Prudnik(w),75 : 70P,70,18,40,45.0,5,24,20.8,23,64,35.9,19,20,95.0,13,19,32,15,19,21,21,5,0,0,59,ACK UTH Rosa Radom,Sezon 2016/2017
2016-10-02 17:00,Jamalex Polonia 1912 Leszno(w),92 : 73P,73,12,27,44.4,12,34,35.3,24,61,39.3,13,15,86.7,8,19,27,17,25,18,18,9,2,2,71,ACK UTH Rosa Radom,Sezon 2016/2017
2016-10-09 17:00,MKS Znicz Basket Pruszków(d),57 : 67P,57,18,37,48.6,3,23,13.0,21,60,35.0,12,16,75.0,8,20,28,11,19,17,13,4,1,1,45,ACK UTH Rosa Radom,Sezon 2016/2017
2016-10-16 18:00,GTK Gliwice(w),58 : 55P,55,12,31,38.7,7,29,24.1,19,60,31.7,10,14,71.4,7,25,32,11,14,17,13,9,1,0,50,ACK UTH Rosa Radom,Sezon 2016/2017
2016-10-19 17:00,GKS Tychy(d),64 : 75P,64,18,32,56.3,2,24,8.3,20,56,35.7,22,31,71.0,13,19,32,12,19,25,12,4,0,1,55,ACK UTH Rosa Radom,Sezon 2016/2017
2016-10-22 17:00,Zetkama Doral Nysa Kłodzko(w),66 : 60P,60,15,24,62.5,6,23,26.1,21,47,44.7,12,14,85.7,8,18,26,16,16,19,17,10,1,1,68,ACK UTH Rosa Radom,Sezon 2016/2017
2016-10-30 17:00,AZS AGH Kraków(d),78 : 72W,78,14,34,41.2,9,23,39.1,23,57,40.4,23,32,71.9,9,23,32,19,18,24,11,12,0,3,87,ACK UTH Rosa Radom,Sezon 2016/2017
2016-11-05 15:00,Biofarm Basket Poznań(w),64 : 51P,51,14,28,50.0,3,21,14.3,17,49,34.7,14,21,66.7,8,20,28,14,22,20,22,7,4,3,43,ACK UTH Rosa Radom,Sezon 2016/2017
2016-11-13 17:00,Enea Astoria Bydgoszcz(d),93 : 85W,93,27,46,58.7,7,20,35.0,34,66,51.5,18,27,66.7,13,25,38,26,26,22,10,7,2,0,115,ACK UTH Rosa Radom,Sezon 2016/2017
2016-11-16 20:00,Legia Warszawa(w),101 : 62P,62,15,36,41.7,7,20,35.0,22,56,39.3,11,20,55.0,10,20,30,12,19,19,26,6,0,2,41,ACK UTH Rosa Radom,Sezon 2016/2017
2016-11-19 13:00,KSK Noteć Inowrocław(d),76 : 65W,76,13,32,40.6,13,32,40.6,26,64,40.6,11,15,73.3,9,22,31,15,19,16,13,11,2,2,80,ACK UTH Rosa Radom,Sezon 2016/2017
2016-11-27 15:30,SKK Siedlce(w),81 : 56P,56,15,35,42.9,4,34,11.8,19,69,27.5,14,21,66.7,15,18,33,9,18,22,16,10,0,1,35,ACK UTH Rosa Radom,Sezon 2016/2017
2016-12-03 15:00,Spójnia Stargard(d),91 : 81W,91,23,40,57.5,8,25,32.0,31,65,47.7,21,25,84.0,11,26,37,22,19,20,10,5,4,0,111,ACK UTH Rosa Radom,Sezon 2016/2017
2016-12-11 17:00,Kotwica Kołobrzeg(d),65 : 69P,65,18,38,47.4,9,22,40.9,27,60,45.0,2,6,33.3,13,25,38,20,15,15,23,9,1,1,73,ACK UTH Rosa Radom,Sezon 2016/2017
2016-12-17 17:00,Max Elektro Sokół Łańcut(d),87 : 81W,87,23,43,53.5,8,18,44.4,31,61,50.8,17,28,60.7,7,20,27,20,17,21,8,7,3,4,95,ACK UTH Rosa Radom,Sezon 2016/2017
2017-01-07 17:00,meritumkredyt Pogoń Prudnik(d),53 : 76P,53,15,34,44.1,5,30,16.7,20,64,31.3,8,12,66.7,13,28,41,15,16,18,15,7,1,5,54,ACK UTH Rosa Radom,Sezon 2016/2017
2017-01-15 17:00,Jamalex Polonia 1912 Leszno(d),57 : 71P,57,14,35,40.0,7,34,20.6,21,69,30.4,8,15,53.3,16,20,36,13,29,24,17,9,3,3,46,ACK UTH Rosa Radom,Sezon 2016/2017
2017-01-22 14:00,MKS Znicz Basket Pruszków(w),81 : 78P,78,20,42,47.6,10,24,41.7,30,66,45.5,8,12,66.7,12,14,26,17,20,18,12,9,2,1,80,ACK UTH Rosa Radom,Sezon 2016/2017
2017-01-28 18:00,GTK Gliwice(d),60 : 69P,60,14,30,46.7,8,25,32.0,22,55,40.0,8,15,53.3,7,21,28,13,18,17,22,14,2,1,55,ACK UTH Rosa Radom,Sezon 2016/2017
2017-02-01 19:00,GKS Tychy(w),82 : 74P,74,21,40,52.5,8,22,36.4,29,62,46.8,8,12,66.7,8,19,27,15,19,14,17,12,1,2,75,ACK UTH Rosa Radom,Sezon 2016/2017
2017-02-04 18:00,Zetkama Doral Nysa Kłodzko(d),79 : 58W,79,24,38,63.2,8,28,28.6,32,66,48.5,7,13,53.8,8,31,39,25,16,16,15,10,4,2,102,ACK UTH Rosa Radom,Sezon 2016/2017
2017-02-15 19:00,AZS AGH Kraków(w),69 : 77W,77,18,40,45.0,8,20,40.0,26,60,43.3,17,26,65.4,6,20,26,18,21,23,9,12,1,0,82,ACK UTH Rosa Radom,Sezon 2016/2017
2017-02-19 17:00,Biofarm Basket Poznań(d),64 : 58W,64,10,24,41.7,10,25,40.0,20,49,40.8,14,20,70.0,8,26,34,12,16,18,16,11,5,2,75,ACK UTH Rosa Radom,Sezon 2016/2017
2017-03-01 16:00,Legia Warszawa(d),85 : 79W,85,21,40,52.5,8,29,27.6,29,69,42.0,19,27,70.4,10,29,39,20,20,22,11,8,2,5,95,ACK UTH Rosa Radom,Sezon 2016/2017
2017-03-04 18:00,KSK Noteć Inowrocław(w),73 : 69P,69,17,34,50.0,6,22,27.3,23,56,41.1,17,22,77.3,7,21,28,14,20,21,13,8,2,1,70,ACK UTH Rosa Radom,Sezon 2016/2017
2017-03-08 18:30,Enea Astoria Bydgoszcz(w),75 : 82W,82,23,43,53.5,7,24,29.2,30,67,44.8,15,20,75.0,12,20,32,20,22,18,11,7,4,2,92,ACK UTH Rosa Radom,Sezon 2016/2017
2017-03-11 18:00,SKK Siedlce(d),83 : 61W,83,19,36,52.8,13,28,46.4,32,64,50.0,6,10,60.0,6,29,35,19,16,13,14,11,3,0,101,ACK UTH Rosa Radom,Sezon 2016/2017
2017-03-19 17:00,Spójnia Stargard(w),98 : 72P,72,19,39,48.7,5,19,26.3,24,58,41.4,19,25,76.0,11,18,29,13,13,23,20,8,2,4,64,ACK UTH Rosa Radom,Sezon 2016/2017
2017-03-21 18:00,Kotwica Kołobrzeg(w),82 : 75P,75,18,35,51.4,6,25,24.0,24,60,40.0,21,29,72.4,8,21,29,11,25,19,14,5,3,3,65,ACK UTH Rosa Radom,Sezon 2016/2017
2017-04-02 18:00,Max Elektro Sokół Łańcut(w),88 : 94W,94,28,46,60.9,5,25,20.0,33,71,46.5,23,31,74.2,19,25,44,15,18,26,14,10,2,2,105,ACK UTH Rosa Radom,Sezon 2016/2017
2017-04-08 18:00,Enea Astoria Bydgoszcz(d),60 : 62P,60,17,39,43.6,5,22,22.7,22,61,36.1,11,20,55.0,14,23,37,8,20,16,16,5,1,3,47,ACK UTH Rosa Radom,Sezon 2016/2017
2017-04-09 13:00,Enea Astoria Bydgoszcz(d),73 : 77P,73,17,44,38.6,8,24,33.3,25,68,36.8,15,29,51.7,12,17,29,17,25,24,14,12,3,0,63,ACK UTH Rosa Radom,Sezon 2016/2017
2017-04-23 15:00,Enea Astoria Bydgoszcz(w),95 : 68P,68,16,40,40.0,7,27,25.9,23,67,34.3,15,23,65.2,13,13,26,17,26,23,17,14,3,1,59,ACK UTH Rosa Radom,Sezon 2016/2017
2016-09-24 18:00,KSK Noteć Inowrocław(w),74 : 73P,73,22,42,52.4,7,27,25.9,29,69,42.0,8,11,72.7,16,24,40,11,18,15,14,4,2,5,73,AZS AGH Kraków,Sezon 2016/2017
2016-10-02 19:00,SKK Siedlce(d),75 : 60W,75,16,34,47.1,9,18,50.0,25,52,48.1,16,26,61.5,3,26,29,15,19,23,18,11,5,5,80,AZS AGH Kraków,Sezon 2016/2017
2016-10-08 18:00,Spójnia Stargard(w),76 : 63P,63,16,42,38.1,7,32,21.9,23,74,31.1,10,16,62.5,13,22,35,11,22,17,10,5,0,4,47,AZS AGH Kraków,Sezon 2016/2017
2016-10-15 20:00,Kotwica Kołobrzeg(w),73 : 71P,71,20,44,45.5,7,24,29.2,27,68,39.7,10,14,71.4,14,18,32,11,20,17,14,8,2,1,65,AZS AGH Kraków,Sezon 2016/2017
2016-10-19 18:00,Max Elektro Sokół Łańcut(w),88 : 72P,72,15,31,48.4,10,25,40.0,25,56,44.6,12,16,75.0,4,13,17,15,16,18,13,6,0,4,62,AZS AGH Kraków,Sezon 2016/2017
2016-10-23 19:00,meritumkredyt Pogoń Prudnik(d),72 : 75P,72,17,31,54.8,10,30,33.3,27,61,44.3,8,18,44.4,12,23,35,17,24,22,17,11,3,3,77,AZS AGH Kraków,Sezon 2016/2017
2016-10-30 17:00,ACK UTH Rosa Radom(w),78 : 72P,72,17,32,53.1,9,26,34.6,26,58,44.8,11,15,73.3,7,25,32,9,24,18,20,5,3,0,65,AZS AGH Kraków,Sezon 2016/2017
2016-11-06 17:00,MKS Znicz Basket Pruszków(w),73 : 86W,86,17,30,56.7,11,27,40.7,28,57,49.1,19,24,79.2,5,19,24,17,19,21,12,11,3,5,95,AZS AGH Kraków,Sezon 2016/2017
2016-11-12 18:00,GTK Gliwice(w),91 : 63P,63,20,36,55.6,5,22,22.7,25,58,43.1,8,17,47.1,8,17,25,12,16,22,18,8,0,3,48,AZS AGH Kraków,Sezon 2016/2017
2016-11-16 18:30,GKS Tychy(d),76 : 66W,76,18,35,51.4,10,27,37.0,28,62,45.2,10,22,45.5,11,29,40,22,23,21,13,5,6,4,90,AZS AGH Kraków,Sezon 2016/2017
2016-11-19 17:00,Zetkama Doral Nysa Kłodzko(w),64 : 84W,84,15,29,51.7,12,33,36.4,27,62,43.5,18,23,78.3,10,25,35,19,19,21,13,7,1,3,93,AZS AGH Kraków,Sezon 2016/2017
2016-11-27 19:00,Jamalex Polonia 1912 Leszno(w),80 : 65P,65,12,28,42.9,9,28,32.1,21,56,37.5,14,29,48.3,9,25,34,15,24,28,19,8,1,3,54,AZS AGH Kraków,Sezon 2016/2017
2016-12-03 17:00,Biofarm Basket Poznań(d),81 : 77W,81,21,45,46.7,9,32,28.1,30,77,39.0,12,25,48.0,23,20,43,19,23,25,11,7,3,3,82,AZS AGH Kraków,Sezon 2016/2017
2016-12-11 19:00,Enea Astoria Bydgoszcz(w),87 : 78P,78,23,39,59.0,6,26,23.1,29,65,44.6,14,22,63.6,10,21,31,22,22,23,11,8,2,3,86,AZS AGH Kraków,Sezon 2016/2017
2016-12-17 19:30,Legia Warszawa(d),53 : 84P,53,16,31,51.6,4,24,16.7,20,55,36.4,9,16,56.3,8,15,23,14,14,18,18,8,3,1,41,AZS AGH Kraków,Sezon 2016/2017
2017-01-15 19:00,SKK Siedlce(w),84 : 71P,71,17,38,44.7,8,23,34.8,25,61,41.0,13,20,65.0,9,17,26,12,22,23,21,12,3,2,60,AZS AGH Kraków,Sezon 2016/2017
2017-01-21 19:30,Spójnia Stargard(d),72 : 83P,72,21,36,58.3,5,24,20.8,26,60,43.3,15,18,83.3,11,23,34,20,19,18,21,6,2,3,76,AZS AGH Kraków,Sezon 2016/2017
2017-01-28 17:00,Kotwica Kołobrzeg(d),85 : 78W,85,24,40,60.0,6,28,21.4,30,68,44.1,19,24,79.2,12,24,36,20,28,23,13,10,3,0,98,AZS AGH Kraków,Sezon 2016/2017
2017-02-01 18:30,Max Elektro Sokół Łańcut(d),65 : 64W,65,18,35,51.4,5,27,18.5,23,62,37.1,14,25,56.0,17,26,43,15,21,22,16,8,2,3,67,AZS AGH Kraków,Sezon 2016/2017
2017-02-05 17:30,meritumkredyt Pogoń Prudnik(w),81 : 72P,72,11,35,31.4,13,33,39.4,24,68,35.3,11,12,91.7,13,24,37,14,22,20,17,6,2,5,69,AZS AGH Kraków,Sezon 2016/2017
2017-02-15 19:00,ACK UTH Rosa Radom(d),69 : 77P,69,19,35,54.3,5,17,29.4,24,52,46.2,16,25,64.0,8,29,37,18,23,21,21,4,0,1,70,AZS AGH Kraków,Sezon 2016/2017
2017-02-18 18:00,MKS Znicz Basket Pruszków(d),63 : 84P,63,18,36,50.0,6,22,27.3,24,58,41.4,9,12,75.0,9,13,22,19,26,19,17,12,2,2,64,AZS AGH Kraków,Sezon 2016/2017
2017-02-22 19:00,KSK Noteć Inowrocław(d),79 : 59W,79,20,31,64.5,11,31,35.5,31,62,50.0,6,10,60.0,8,24,32,22,23,17,19,12,3,2,94,AZS AGH Kraków,Sezon 2016/2017
2017-02-25 18:30,GTK Gliwice(d),73 : 81P,73,19,43,44.2,8,20,40.0,27,63,42.9,11,12,91.7,12,24,36,17,16,16,20,8,1,8,78,AZS AGH Kraków,Sezon 2016/2017
2017-03-01 18:00,GKS Tychy(w),83 : 74P,74,22,44,50.0,5,21,23.8,27,65,41.5,15,22,68.2,8,13,21,16,17,22,13,13,0,2,66,AZS AGH Kraków,Sezon 2016/2017
2017-03-04 19:30,Zetkama Doral Nysa Kłodzko(d),67 : 61W,67,22,42,52.4,5,30,16.7,27,72,37.5,8,13,61.5,19,30,49,24,23,20,18,11,3,2,86,AZS AGH Kraków,Sezon 2016/2017
2017-03-11 18:00,Jamalex Polonia 1912 Leszno(d),66 : 78P,66,13,31,41.9,6,27,22.2,19,58,32.8,22,27,81.5,11,18,29,21,25,24,15,8,6,2,71,AZS AGH Kraków,Sezon 2016/2017
2017-03-18 15:45,Biofarm Basket Poznań(w),68 : 58P,58,15,35,42.9,6,22,27.3,21,57,36.8,10,16,62.5,9,23,32,13,23,19,17,12,4,1,60,AZS AGH Kraków,Sezon 2016/2017
2017-03-25 18:00,Enea Astoria Bydgoszcz(d),91 : 83W,91,19,33,57.6,11,36,30.6,30,69,43.5,20,32,62.5,10,22,32,25,25,26,6,8,3,0,102,AZS AGH Kraków,Sezon 2016/2017
2017-03-31 19:00,Legia Warszawa(w),86 : 75P,75,22,39,56.4,7,30,23.3,29,69,42.0,10,17,58.8,11,17,28,15,26,18,15,14,5,3,75,AZS AGH Kraków,Sezon 2016/2017
2017-04-08 15:00,SKK Siedlce(w),69 : 68P,68,16,40,40.0,7,26,26.9,23,66,34.8,15,19,78.9,10,29,39,10,22,23,16,8,5,2,67,AZS AGH Kraków,Sezon 2016/2017
2017-04-09 19:00,SKK Siedlce(w),85 : 77P,77,21,36,58.3,8,28,28.6,29,64,45.3,11,19,57.9,8,17,25,11,23,21,11,10,1,1,70,AZS AGH Kraków,Sezon 2016/2017
2017-04-13 19:00,SKK Siedlce(d),70 : 63W,70,16,29,55.2,6,22,27.3,22,51,43.1,20,29,69.0,8,22,30,19,20,24,15,7,4,2,77,AZS AGH Kraków,Sezon 2016/2017
2017-04-14 19:00,SKK Siedlce(d),74 : 89P,74,16,34,47.1,7,26,26.9,23,60,38.3,21,31,67.7,8,21,29,15,19,24,9,8,3,3,73,AZS AGH Kraków,Sezon 2016/2017
2016-09-25 16:00,Legia Warszawa(w),60 : 64W,64,18,44,40.9,4,16,25.0,22,60,36.7,16,18,88.9,10,21,31,11,18,23,10,4,3,5,63,Biofarm Basket Poznań,Sezon 2016/2017
2016-10-01 18:30,KSK Noteć Inowrocław(d),70 : 67W,70,16,42,38.1,9,21,42.9,25,63,39.7,11,12,91.7,12,22,34,13,16,15,17,6,3,5,70,Biofarm Basket Poznań,Sezon 2016/2017
2016-10-08 19:30,SKK Siedlce(w),84 : 77P,77,19,34,55.9,6,19,31.6,25,53,47.2,21,25,84.0,5,20,25,14,18,24,20,10,1,3,75,Biofarm Basket Poznań,Sezon 2016/2017
2016-10-16 17:00,Spójnia Stargard(d),61 : 70P,61,18,45,40.0,7,23,30.4,25,68,36.8,4,11,36.4,14,19,33,12,20,14,11,9,1,7,55,Biofarm Basket Poznań,Sezon 2016/2017
2016-10-19 18:00,Kotwica Kołobrzeg(w),61 : 58P,58,16,44,36.4,6,24,25.0,22,68,32.4,8,11,72.7,12,27,39,11,26,14,12,6,3,2,56,Biofarm Basket Poznań,Sezon 2016/2017
2016-10-22 15:45,Max Elektro Sokół Łańcut(d),48 : 73P,48,15,44,34.1,2,21,9.5,17,65,26.2,12,20,60.0,12,20,32,6,29,18,20,11,2,5,23,Biofarm Basket Poznań,Sezon 2016/2017
2016-10-29 17:30,meritumkredyt Pogoń Prudnik(w),90 : 67P,67,16,34,47.1,7,23,30.4,23,57,40.4,14,19,73.7,9,17,26,14,18,20,20,8,0,1,56,Biofarm Basket Poznań,Sezon 2016/2017
2016-11-05 15:00,ACK UTH Rosa Radom(d),64 : 51W,64,21,49,42.9,3,18,16.7,24,67,35.8,13,25,52.0,19,26,45,14,20,22,15,11,3,4,67,Biofarm Basket Poznań,Sezon 2016/2017
2016-11-12 18:00,MKS Znicz Basket Pruszków(w),61 : 63W,63,19,41,46.3,6,19,31.6,25,60,41.7,7,9,77.8,12,18,30,15,18,14,13,7,3,1,68,Biofarm Basket Poznań,Sezon 2016/2017
2016-11-16 19:30,GTK Gliwice(d),69 : 64W,69,18,40,45.0,6,19,31.6,24,59,40.7,15,25,60.0,13,33,46,15,15,22,19,3,7,3,76,Biofarm Basket Poznań,Sezon 2016/2017
2016-11-19 19:00,GKS Tychy(w),71 : 69P,69,20,47,42.6,5,18,27.8,25,65,38.5,14,19,73.7,12,23,35,10,15,21,12,10,4,2,71,Biofarm Basket Poznań,Sezon 2016/2017
2016-11-26 15:45,Zetkama Doral Nysa Kłodzko(d),73 : 60W,73,21,46,45.7,8,19,42.1,29,65,44.6,7,14,50.0,14,20,34,17,15,19,7,9,3,4,86,Biofarm Basket Poznań,Sezon 2016/2017
2016-12-03 17:00,AZS AGH Kraków(w),81 : 77P,77,22,42,52.4,7,18,38.9,29,60,48.3,12,25,48.0,13,23,36,15,25,23,17,5,3,3,75,Biofarm Basket Poznań,Sezon 2016/2017
2016-12-10 17:00,Jamalex Polonia 1912 Leszno(w),82 : 69P,69,20,39,51.3,7,21,33.3,27,60,45.0,8,12,66.7,4,22,26,12,24,17,19,5,6,3,62,Biofarm Basket Poznań,Sezon 2016/2017
2016-12-17 15:45,Enea Astoria Bydgoszcz(d),87 : 59W,87,20,34,58.8,11,22,50.0,31,56,55.4,14,18,77.8,7,24,31,19,21,23,15,8,4,2,105,Biofarm Basket Poznań,Sezon 2016/2017
2017-01-07 15:45,Legia Warszawa(d),58 : 66P,58,18,38,47.4,4,17,23.5,22,55,40.0,10,18,55.6,13,26,39,13,23,15,23,5,3,4,54,Biofarm Basket Poznań,Sezon 2016/2017
2017-01-14 18:00,KSK Noteć Inowrocław(w),92 : 62P,62,20,44,45.5,2,20,10.0,22,64,34.4,16,20,80.0,17,17,34,8,17,19,14,7,1,3,52,Biofarm Basket Poznań,Sezon 2016/2017
2017-01-21 17:30,SKK Siedlce(d),93 : 80W,93,30,46,65.2,4,17,23.5,34,63,54.0,21,28,75.0,10,33,43,10,19,25,20,6,1,1,97,Biofarm Basket Poznań,Sezon 2016/2017
2017-01-28 18:00,Spójnia Stargard(w),62 : 71W,71,25,40,62.5,3,17,17.6,28,57,49.1,12,23,52.2,13,20,33,15,13,19,18,10,0,0,71,Biofarm Basket Poznań,Sezon 2016/2017
2017-02-01 19:30,Kotwica Kołobrzeg(d),65 : 59W,65,20,45,44.4,5,21,23.8,25,66,37.9,10,17,58.8,15,29,44,12,17,16,17,4,4,3,64,Biofarm Basket Poznań,Sezon 2016/2017
2017-02-04 17:30,Max Elektro Sokół Łańcut(w),72 : 74W,74,21,44,47.7,8,21,38.1,29,65,44.6,8,14,57.1,12,27,39,17,20,20,15,4,2,1,79,Biofarm Basket Poznań,Sezon 2016/2017
2017-02-15 20:00,meritumkredyt Pogoń Prudnik(d),62 : 65P,62,19,47,40.4,7,20,35.0,26,67,38.8,3,6,50.0,13,26,39,13,18,15,13,6,3,4,66,Biofarm Basket Poznań,Sezon 2016/2017
2017-02-19 17:00,ACK UTH Rosa Radom(w),64 : 58P,58,20,50,40.0,5,18,27.8,25,68,36.8,3,6,50.0,15,22,37,12,18,16,17,13,2,5,59,Biofarm Basket Poznań,Sezon 2016/2017
2017-03-01 18:00,GTK Gliwice(w),57 : 56P,56,21,43,48.8,4,19,21.1,25,62,40.3,2,9,22.2,13,26,39,10,14,18,19,9,0,0,51,Biofarm Basket Poznań,Sezon 2016/2017
2017-03-05 17:00,GKS Tychy(d),67 : 57W,67,17,40,42.5,6,21,28.6,23,61,37.7,15,20,75.0,12,30,42,13,20,22,14,8,5,6,78,Biofarm Basket Poznań,Sezon 2016/2017
2017-03-08 20:00,MKS Znicz Basket Pruszków(d),66 : 58W,66,17,38,44.7,6,19,31.6,23,57,40.4,14,19,73.7,9,32,41,24,18,21,15,8,8,2,93,Biofarm Basket Poznań,Sezon 2016/2017
2017-03-11 17:00,Zetkama Doral Nysa Kłodzko(w),66 : 71W,71,26,39,66.7,5,21,23.8,31,60,51.7,4,6,66.7,9,30,39,11,16,16,15,4,2,1,81,Biofarm Basket Poznań,Sezon 2016/2017
2017-03-18 15:45,AZS AGH Kraków(d),68 : 58W,68,22,49,44.9,3,11,27.3,25,60,41.7,15,18,83.3,11,27,38,16,19,23,18,11,1,4,78,Biofarm Basket Poznań,Sezon 2016/2017
2017-03-25 15:45,Jamalex Polonia 1912 Leszno(d),67 : 68P,67,19,44,43.2,6,21,28.6,25,65,38.5,11,17,64.7,9,28,37,16,22,22,14,9,6,1,75,Biofarm Basket Poznań,Sezon 2016/2017
2017-04-02 18:00,Enea Astoria Bydgoszcz(w),78 : 87W,87,21,33,63.6,8,26,30.8,29,59,49.2,21,24,87.5,9,24,33,19,21,21,15,8,3,1,102,Biofarm Basket Poznań,Sezon 2016/2017
2017-04-07 19:00,Legia Warszawa(w),57 : 69W,69,19,41,46.3,8,21,38.1,27,62,43.5,7,10,70.0,12,24,36,14,19,14,16,7,4,4,76,Biofarm Basket Poznań,Sezon 2016/2017
2017-04-08 17:00,Legia Warszawa(w),91 : 69P,69,23,45,51.1,5,12,41.7,28,57,49.1,8,10,80.0,9,22,31,10,21,12,21,5,2,0,65,Biofarm Basket Poznań,Sezon 2016/2017
2017-04-22 19:00,Legia Warszawa(d),63 : 70P,63,21,47,44.7,3,11,27.3,24,58,41.4,12,17,70.6,10,23,33,10,22,20,19,6,6,3,60,Biofarm Basket Poznań,Sezon 2016/2017
2017-04-23 17:00,Legia Warszawa(d),77 : 82P,77,18,35,51.4,7,20,35.0,25,55,45.5,20,28,71.4,5,34,39,16,20,22,23,9,5,2,85,Biofarm Basket Poznań,Sezon 2016/2017
2016-09-23 19:30,Jamalex Polonia 1912 Leszno(d),76 : 80P,76,21,38,55.3,5,19,26.3,26,57,45.6,19,26,73.1,3,25,28,17,27,24,20,6,4,5,73,Enea Astoria Bydgoszcz,Sezon 2016/2017
2016-10-01 19:00,Legia Warszawa(d),72 : 85P,72,20,34,58.8,6,16,37.5,26,50,52.0,14,21,66.7,4,29,33,22,19,19,23,4,3,3,80,Enea Astoria Bydgoszcz,Sezon 2016/2017
2016-10-08 18:00,KSK Noteć Inowrocław(w),89 : 62P,62,16,38,42.1,7,29,24.1,23,67,34.3,9,20,45.0,13,23,36,11,16,17,15,10,2,2,51,Enea Astoria Bydgoszcz,Sezon 2016/2017
2016-10-13 20:00,SKK Siedlce(w),72 : 61P,61,21,48,43.8,4,17,23.5,25,65,38.5,7,11,63.6,9,22,31,11,25,18,13,7,1,2,54,Enea Astoria Bydgoszcz,Sezon 2016/2017
2016-10-19 18:00,Spójnia Stargard(w),87 : 77P,77,22,47,46.8,6,17,35.3,28,64,43.8,15,20,75.0,6,19,25,10,23,21,10,8,1,3,70,Enea Astoria Bydgoszcz,Sezon 2016/2017
2016-10-22 19:00,Kotwica Kołobrzeg(d),84 : 79W,84,19,37,51.4,10,27,37.0,29,64,45.3,16,21,76.2,8,32,40,18,23,23,13,4,3,1,96,Enea Astoria Bydgoszcz,Sezon 2016/2017
2016-10-29 17:30,Max Elektro Sokół Łańcut(w),84 : 69P,69,23,42,54.8,4,13,30.8,27,55,49.1,11,14,78.6,6,25,31,9,20,19,21,5,1,5,63,Enea Astoria Bydgoszcz,Sezon 2016/2017
2016-11-05 19:00,meritumkredyt Pogoń Prudnik(d),97 : 86W,97,27,41,65.9,9,21,42.9,36,62,58.1,16,20,80.0,11,20,31,16,22,20,19,9,2,3,106,Enea Astoria Bydgoszcz,Sezon 2016/2017
2016-11-13 17:00,ACK UTH Rosa Radom(w),93 : 85P,85,27,53,50.9,4,17,23.5,31,70,44.3,19,25,76.0,13,22,35,17,25,25,11,8,0,2,89,Enea Astoria Bydgoszcz,Sezon 2016/2017
2016-11-16 19:00,MKS Znicz Basket Pruszków(d),56 : 105P,56,18,52,34.6,3,19,15.8,21,71,29.6,11,15,73.3,11,18,29,12,26,20,11,7,3,4,42,Enea Astoria Bydgoszcz,Sezon 2016/2017
2016-11-19 18:00,GTK Gliwice(w),70 : 58P,58,24,41,58.5,2,11,18.2,26,52,50.0,4,6,66.7,6,21,27,18,18,16,21,6,2,0,62,Enea Astoria Bydgoszcz,Sezon 2016/2017
2016-11-26 19:00,GKS Tychy(d),71 : 76P,71,21,42,50.0,5,23,21.7,26,65,40.0,14,20,70.0,5,23,28,20,21,25,10,5,2,2,71,Enea Astoria Bydgoszcz,Sezon 2016/2017
2016-12-03 17:00,Zetkama Doral Nysa Kłodzko(w),55 : 75W,75,25,40,62.5,5,16,31.3,30,56,53.6,10,16,62.5,9,31,40,15,23,24,16,6,0,0,88,Enea Astoria Bydgoszcz,Sezon 2016/2017
2016-12-11 19:00,AZS AGH Kraków(d),87 : 78W,87,26,44,59.1,6,14,42.9,32,58,55.2,17,22,77.3,6,25,31,24,24,21,14,5,3,2,105,Enea Astoria Bydgoszcz,Sezon 2016/2017
2016-12-17 15:45,Biofarm Basket Poznań(w),87 : 59P,59,20,36,55.6,5,21,23.8,25,57,43.9,4,10,40.0,7,16,23,14,23,21,19,7,2,4,48,Enea Astoria Bydgoszcz,Sezon 2016/2017
2017-01-08 17:00,Jamalex Polonia 1912 Leszno(w),77 : 74P,74,24,41,58.5,4,22,18.2,28,63,44.4,14,24,58.3,10,23,33,12,23,23,16,10,1,4,69,Enea Astoria Bydgoszcz,Sezon 2016/2017
2017-01-14 17:00,Legia Warszawa(w),83 : 61P,61,21,36,58.3,3,17,17.6,24,53,45.3,10,13,76.9,5,15,20,13,25,18,22,10,1,3,51,Enea Astoria Bydgoszcz,Sezon 2016/2017
2017-01-21 19:00,KSK Noteć Inowrocław(d),62 : 63P,62,20,44,45.5,1,11,9.1,21,55,38.2,19,26,73.1,12,25,37,9,24,28,19,8,3,4,59,Enea Astoria Bydgoszcz,Sezon 2016/2017
2017-01-28 17:00,SKK Siedlce(d),87 : 96P,87,20,42,47.6,11,21,52.4,31,63,49.2,14,21,66.7,7,25,32,22,22,22,20,9,1,7,92,Enea Astoria Bydgoszcz,Sezon 2016/2017
2017-02-01 19:00,Spójnia Stargard(d),94 : 83W,94,32,50,64.0,5,19,26.3,37,69,53.6,15,24,62.5,12,27,39,25,24,18,10,3,2,1,112,Enea Astoria Bydgoszcz,Sezon 2016/2017
2017-02-04 18:00,Kotwica Kołobrzeg(w),80 : 71P,71,25,45,55.6,4,28,14.3,29,73,39.7,9,11,81.8,12,24,36,18,20,17,13,3,1,5,70,Enea Astoria Bydgoszcz,Sezon 2016/2017
2017-02-12 17:00,Max Elektro Sokół Łańcut(d),79 : 112P,79,28,46,60.9,4,19,21.1,32,65,49.2,11,20,55.0,7,17,24,22,24,21,14,6,0,2,75,Enea Astoria Bydgoszcz,Sezon 2016/2017
2017-02-19 17:30,meritumkredyt Pogoń Prudnik(w),80 : 86W,86,24,53,45.3,5,20,25.0,29,73,39.7,23,29,79.3,12,26,38,11,24,23,19,7,1,6,74,Enea Astoria Bydgoszcz,Sezon 2016/2017
2017-03-01 19:00,MKS Znicz Basket Pruszków(w),76 : 78W,78,27,52,51.9,4,13,30.8,31,65,47.7,12,18,66.7,10,15,25,14,22,22,10,11,2,6,80,Enea Astoria Bydgoszcz,Sezon 2016/2017
2017-03-05 17:00,GTK Gliwice(d),83 : 100P,83,26,52,50.0,6,20,30.0,32,72,44.4,13,18,72.2,10,20,30,12,27,21,9,5,5,4,81,Enea Astoria Bydgoszcz,Sezon 2016/2017
2017-03-08 18:30,ACK UTH Rosa Radom(d),75 : 82P,75,17,32,53.1,8,22,36.4,25,54,46.3,17,23,73.9,6,20,26,17,18,22,22,6,2,4,69,Enea Astoria Bydgoszcz,Sezon 2016/2017
2017-03-11 19:00,GKS Tychy(w),97 : 79P,79,24,44,54.5,4,20,20.0,28,64,43.8,19,26,73.1,11,19,30,18,16,18,15,8,2,1,79,Enea Astoria Bydgoszcz,Sezon 2016/2017
2017-03-20 17:30,Zetkama Doral Nysa Kłodzko(d),89 : 100P,89,18,39,46.2,6,15,40.0,24,54,44.4,35,47,74.5,8,27,35,17,23,32,12,3,1,3,91,Enea Astoria Bydgoszcz,Sezon 2016/2017
2017-03-25 18:00,AZS AGH Kraków(w),91 : 83P,83,24,47,51.1,4,12,33.3,28,59,47.5,23,32,71.9,9,28,37,18,26,25,13,3,0,3,88,Enea Astoria Bydgoszcz,Sezon 2016/2017
2017-04-02 18:00,Biofarm Basket Poznań(d),78 : 87P,78,24,43,55.8,5,20,25.0,29,63,46.0,15,22,68.2,11,20,31,22,21,21,18,9,1,3,82,Enea Astoria Bydgoszcz,Sezon 2016/2017
2017-04-08 18:00,ACK UTH Rosa Radom(w),60 : 62W,62,21,45,46.7,4,18,22.2,25,63,39.7,8,14,57.1,13,24,37,11,17,20,12,10,3,1,67,Enea Astoria Bydgoszcz,Sezon 2016/2017
2017-04-09 13:00,ACK UTH Rosa Radom(w),73 : 77W,77,26,49,53.1,3,9,33.3,29,58,50.0,16,31,51.6,13,30,43,14,25,25,22,7,0,3,75,Enea Astoria Bydgoszcz,Sezon 2016/2017
2017-04-23 15:00,ACK UTH Rosa Radom(d),95 : 68W,95,27,40,67.5,7,15,46.7,34,55,61.8,20,27,74.1,8,30,38,16,23,26,23,9,1,3,108,Enea Astoria Bydgoszcz,Sezon 2016/2017
2016-09-25 17:00,Spójnia Stargard(w),76 : 75P,75,23,44,52.3,8,22,36.4,31,66,47.0,5,8,62.5,9,19,28,20,18,15,12,10,1,3,84,GKS Tychy,Sezon 2016/2017
2016-10-01 18:00,Kotwica Kołobrzeg(d),84 : 89P,84,25,44,56.8,5,20,25.0,30,64,46.9,19,24,79.2,12,23,35,13,20,18,17,13,0,1,89,GKS Tychy,Sezon 2016/2017
2016-10-08 17:30,Max Elektro Sokół Łańcut(w),79 : 74P,74,22,38,57.9,7,21,33.3,29,59,49.2,9,15,60.0,8,25,33,15,28,16,17,7,5,5,81,GKS Tychy,Sezon 2016/2017
2016-10-15 18:00,meritumkredyt Pogoń Prudnik(d),81 : 73W,81,23,35,65.7,8,22,36.4,31,57,54.4,11,16,68.8,4,28,32,19,22,18,11,2,0,0,92,GKS Tychy,Sezon 2016/2017
2016-10-19 17:00,ACK UTH Rosa Radom(w),64 : 75W,75,26,41,63.4,3,17,17.6,29,58,50.0,14,18,77.8,9,23,32,17,25,18,10,8,1,0,90,GKS Tychy,Sezon 2016/2017
2016-10-22 19:00,MKS Znicz Basket Pruszków(d),74 : 73W,74,23,43,53.5,6,16,37.5,29,59,49.2,10,15,66.7,5,33,38,21,23,17,15,7,8,1,98,GKS Tychy,Sezon 2016/2017
2016-10-29 18:00,GTK Gliwice(w),62 : 59P,59,10,28,35.7,10,27,37.0,20,55,36.4,9,20,45.0,7,23,30,15,17,22,13,6,1,0,52,GKS Tychy,Sezon 2016/2017
2016-11-05 17:00,Jamalex Polonia 1912 Leszno(w),65 : 75W,75,19,32,59.4,9,25,36.0,28,57,49.1,10,15,66.7,4,29,33,18,24,20,16,6,1,2,83,GKS Tychy,Sezon 2016/2017
2016-11-12 18:00,Zetkama Doral Nysa Kłodzko(d),86 : 74W,86,24,49,49.0,7,21,33.3,31,70,44.3,17,18,94.4,14,19,33,23,16,19,10,13,0,4,105,GKS Tychy,Sezon 2016/2017
2016-11-16 18:30,AZS AGH Kraków(w),76 : 66P,66,16,38,42.1,7,19,36.8,23,57,40.4,13,24,54.2,7,21,28,13,22,23,12,7,4,5,61,GKS Tychy,Sezon 2016/2017
2016-11-19 19:00,Biofarm Basket Poznań(d),71 : 69W,71,27,51,52.9,3,16,18.8,30,67,44.8,8,10,80.0,12,27,39,12,21,15,16,10,2,3,79,GKS Tychy,Sezon 2016/2017
2016-11-26 19:00,Enea Astoria Bydgoszcz(w),71 : 76W,76,17,37,45.9,8,19,42.1,25,56,44.6,18,25,72.0,5,26,31,21,25,21,14,6,2,2,84,GKS Tychy,Sezon 2016/2017
2016-12-03 18:00,Legia Warszawa(d),68 : 89P,68,19,39,48.7,7,18,38.9,26,57,45.6,9,12,75.0,5,19,24,18,21,14,15,8,5,2,74,GKS Tychy,Sezon 2016/2017
2016-12-10 18:00,KSK Noteć Inowrocław(w),70 : 88W,88,24,38,63.2,10,29,34.5,34,67,50.7,10,14,71.4,12,26,38,17,19,17,15,12,3,1,106,GKS Tychy,Sezon 2016/2017
2016-12-18 19:00,SKK Siedlce(d),90 : 49W,90,26,52,50.0,8,21,38.1,34,73,46.6,14,16,87.5,13,29,42,18,16,18,8,15,2,5,118,GKS Tychy,Sezon 2016/2017
2017-01-07 19:00,Spójnia Stargard(d),79 : 71W,79,24,41,58.5,6,20,30.0,30,61,49.2,13,13,100.0,4,21,25,16,18,13,14,12,5,3,92,GKS Tychy,Sezon 2016/2017
2017-01-14 18:00,Kotwica Kołobrzeg(w),72 : 56P,56,17,39,43.6,4,17,23.5,21,56,37.5,10,16,62.5,6,30,36,12,19,16,20,7,3,3,53,GKS Tychy,Sezon 2016/2017
2017-01-21 18:00,Max Elektro Sokół Łańcut(d),84 : 86P,84,25,48,52.1,8,33,24.2,33,81,40.7,10,13,76.9,12,24,36,21,23,17,12,6,2,3,86,GKS Tychy,Sezon 2016/2017
2017-01-28 17:30,meritumkredyt Pogoń Prudnik(w),73 : 81W,81,25,45,55.6,5,22,22.7,30,67,44.8,16,16,100.0,6,23,29,13,18,18,16,9,2,3,81,GKS Tychy,Sezon 2016/2017
2017-02-01 19:00,ACK UTH Rosa Radom(d),82 : 74W,82,23,45,51.1,6,17,35.3,29,62,46.8,18,18,100.0,11,25,36,26,14,19,16,14,2,1,111,GKS Tychy,Sezon 2016/2017
2017-02-05 17:00,MKS Znicz Basket Pruszków(w),68 : 79W,79,18,34,52.9,10,23,43.5,28,57,49.1,13,18,72.2,6,25,31,19,15,18,11,4,1,3,89,GKS Tychy,Sezon 2016/2017
2017-02-11 19:00,GTK Gliwice(d),72 : 86P,72,18,37,48.6,5,19,26.3,23,56,41.1,21,25,84.0,10,20,30,12,21,26,15,8,3,0,73,GKS Tychy,Sezon 2016/2017
2017-02-18 18:00,Jamalex Polonia 1912 Leszno(d),79 : 67W,79,17,38,44.7,8,20,40.0,25,58,43.1,21,25,84.0,9,21,30,13,23,24,14,10,0,0,81,GKS Tychy,Sezon 2016/2017
2017-02-25 17:00,Zetkama Doral Nysa Kłodzko(w),76 : 78W,78,15,40,37.5,8,17,47.1,23,57,40.4,24,31,77.4,8,31,39,19,22,24,14,5,2,3,88,GKS Tychy,Sezon 2016/2017
2017-03-01 18:00,AZS AGH Kraków(d),83 : 74W,83,30,44,68.2,5,11,45.5,35,55,63.6,8,10,80.0,6,27,33,25,22,17,22,10,3,0,110,GKS Tychy,Sezon 2016/2017
2017-03-05 17:00,Biofarm Basket Poznań(w),67 : 57P,57,9,35,25.7,9,21,42.9,18,56,32.1,12,16,75.0,8,24,32,16,22,20,15,7,6,5,61,GKS Tychy,Sezon 2016/2017
2017-03-11 19:00,Enea Astoria Bydgoszcz(d),97 : 79W,97,27,41,65.9,10,24,41.7,37,65,56.9,13,18,72.2,11,24,35,24,18,16,16,7,1,2,115,GKS Tychy,Sezon 2016/2017
2017-03-18 17:00,Legia Warszawa(w),77 : 84W,84,24,39,61.5,6,20,30.0,30,59,50.8,18,22,81.8,10,25,35,23,22,20,18,9,2,0,102,GKS Tychy,Sezon 2016/2017
2017-03-25 19:00,KSK Noteć Inowrocław(d),108 : 74W,108,28,40,70.0,14,25,56.0,42,65,64.6,10,12,83.3,6,30,36,30,17,16,16,12,3,0,148,GKS Tychy,Sezon 2016/2017
2017-04-02 18:00,SKK Siedlce(w),70 : 74W,74,22,41,53.7,7,24,29.2,29,65,44.6,9,18,50.0,7,29,36,17,19,17,12,8,3,0,81,GKS Tychy,Sezon 2016/2017
2017-04-08 18:00,Spójnia Stargard(d),82 : 87P,82,17,35,48.6,7,22,31.8,24,57,42.1,27,32,84.4,6,22,28,19,23,23,11,11,1,3,92,GKS Tychy,Sezon 2016/2017
2017-04-09 19:00,Spójnia Stargard(d),99 : 51W,99,27,43,62.8,13,21,61.9,40,64,62.5,6,8,75.0,6,30,36,21,15,15,12,9,3,2,130,GKS Tychy,Sezon 2016/2017
2017-04-22 18:00,Spójnia Stargard(w),84 : 72P,72,20,41,48.8,5,23,21.7,25,64,39.1,17,29,58.6,13,29,42,16,19,25,15,12,1,3,77,GKS Tychy,Sezon 2016/2017
2017-04-23 17:00,Spójnia Stargard(w),87 : 83P,83,22,42,52.4,9,21,42.9,31,63,49.2,12,20,60.0,10,27,37,13,23,20,13,2,3,3,85,GKS Tychy,Sezon 2016/2017
2016-09-25 17:00,Kotwica Kołobrzeg(w),65 : 77W,77,26,46,56.5,3,21,14.3,29,67,43.3,16,25,64.0,13,21,34,19,24,19,9,14,2,2,90,GTK Gliwice,Sezon 2016/2017
2016-10-01 18:00,Max Elektro Sokół Łańcut(d),73 : 77P,73,21,44,47.7,6,20,30.0,27,64,42.2,13,24,54.2,7,21,28,13,33,25,12,8,1,0,63,GTK Gliwice,Sezon 2016/2017
2016-10-08 17:30,meritumkredyt Pogoń Prudnik(w),71 : 74W,74,21,41,51.2,8,27,29.6,29,68,42.6,8,12,66.7,7,26,33,14,23,19,14,9,0,3,73,GTK Gliwice,Sezon 2016/2017
2016-10-16 18:00,ACK UTH Rosa Radom(d),58 : 55W,58,16,35,45.7,7,29,24.1,23,64,35.9,5,9,55.6,9,29,38,9,17,14,13,8,0,0,55,GTK Gliwice,Sezon 2016/2017
2016-10-19 18:00,MKS Znicz Basket Pruszków(d),85 : 64W,85,21,46,45.7,11,25,44.0,32,71,45.1,10,15,66.7,19,19,38,19,28,20,12,4,2,0,92,GTK Gliwice,Sezon 2016/2017
2016-10-22 17:00,Jamalex Polonia 1912 Leszno(w),87 : 79P,79,22,42,52.4,7,26,26.9,29,68,42.6,14,20,70.0,12,14,26,12,26,23,15,9,2,4,68,GTK Gliwice,Sezon 2016/2017
2016-10-29 18:00,GKS Tychy(d),62 : 59W,62,17,37,45.9,7,26,26.9,24,63,38.1,7,15,46.7,10,26,36,18,23,17,15,7,0,0,61,GTK Gliwice,Sezon 2016/2017
2016-11-05 17:00,Zetkama Doral Nysa Kłodzko(w),57 : 72W,72,17,40,42.5,9,27,33.3,26,67,38.8,11,13,84.6,17,13,30,14,18,19,12,8,1,3,70,GTK Gliwice,Sezon 2016/2017
2016-11-12 18:00,AZS AGH Kraków(d),91 : 63W,91,21,34,61.8,11,18,61.1,32,52,61.5,16,20,80.0,5,24,29,18,22,16,16,10,3,0,111,GTK Gliwice,Sezon 2016/2017
2016-11-16 19:30,Biofarm Basket Poznań(w),69 : 64P,64,23,44,52.3,4,28,14.3,27,72,37.5,6,12,50.0,12,19,31,14,22,15,12,12,3,7,61,GTK Gliwice,Sezon 2016/2017
2016-11-19 18:00,Enea Astoria Bydgoszcz(d),70 : 58W,70,21,41,51.2,6,23,26.1,27,64,42.2,10,20,50.0,20,23,43,19,16,18,14,13,3,0,87,GTK Gliwice,Sezon 2016/2017
2016-11-25 20:00,Legia Warszawa(w),78 : 74P,74,21,45,46.7,9,16,56.3,30,61,49.2,5,14,35.7,8,18,26,15,24,15,16,8,0,0,67,GTK Gliwice,Sezon 2016/2017
2016-12-03 18:00,KSK Noteć Inowrocław(d),92 : 84W,92,25,35,71.4,10,22,45.5,35,57,61.4,12,23,52.2,2,21,23,19,28,22,13,9,0,0,97,GTK Gliwice,Sezon 2016/2017
2016-12-10 19:00,SKK Siedlce(w),85 : 80P,80,25,41,61.0,6,26,23.1,31,67,46.3,12,26,46.2,9,25,34,11,22,22,20,9,1,2,65,GTK Gliwice,Sezon 2016/2017
2016-12-17 18:00,Spójnia Stargard(d),82 : 73W,82,20,32,62.5,10,23,43.5,30,55,54.5,12,15,80.0,3,22,25,20,23,16,14,8,0,0,93,GTK Gliwice,Sezon 2016/2017
2017-01-07 18:00,Kotwica Kołobrzeg(d),77 : 72W,77,24,34,70.6,7,30,23.3,31,64,48.4,8,13,61.5,8,22,30,20,21,13,10,12,2,0,93,GTK Gliwice,Sezon 2016/2017
2017-01-14 17:30,Max Elektro Sokół Łańcut(w),75 : 63P,63,21,40,52.5,4,24,16.7,25,64,39.1,9,16,56.3,11,18,29,18,24,15,17,7,2,1,56,GTK Gliwice,Sezon 2016/2017
2017-01-21 18:00,meritumkredyt Pogoń Prudnik(d),102 : 71W,102,22,39,56.4,17,32,53.1,39,71,54.9,7,12,58.3,13,23,36,24,24,14,7,10,1,2,129,GTK Gliwice,Sezon 2016/2017
2017-01-28 18:00,ACK UTH Rosa Radom(w),60 : 69W,69,20,38,52.6,7,18,38.9,27,56,48.2,8,12,66.7,7,27,34,20,18,18,22,14,1,2,83,GTK Gliwice,Sezon 2016/2017
2017-02-01 19:00,MKS Znicz Basket Pruszków(w),74 : 72P,72,24,42,57.1,6,22,27.3,30,64,46.9,6,9,66.7,4,16,20,19,17,15,12,13,4,3,79,GTK Gliwice,Sezon 2016/2017
2017-02-04 18:00,Jamalex Polonia 1912 Leszno(d),71 : 75P,71,25,41,61.0,4,18,22.2,29,59,49.2,9,19,47.4,7,18,25,17,24,21,10,10,0,0,73,GTK Gliwice,Sezon 2016/2017
2017-02-11 19:00,GKS Tychy(w),72 : 86W,86,26,39,66.7,8,20,40.0,34,59,57.6,10,16,62.5,3,23,26,21,26,20,16,10,0,3,96,GTK Gliwice,Sezon 2016/2017
2017-02-18 18:00,Zetkama Doral Nysa Kłodzko(d),67 : 60W,67,20,44,45.5,6,19,31.6,26,63,41.3,9,9,100.0,5,24,29,16,14,17,16,8,1,4,68,GTK Gliwice,Sezon 2016/2017
2017-02-25 18:30,AZS AGH Kraków(w),73 : 81W,81,19,34,55.9,10,22,45.5,29,56,51.8,13,22,59.1,6,20,26,19,16,16,13,11,8,1,96,GTK Gliwice,Sezon 2016/2017
2017-03-01 18:00,Biofarm Basket Poznań(d),57 : 56W,57,20,36,55.6,4,24,16.7,24,60,40.0,5,9,55.6,10,21,31,17,18,14,13,14,2,0,68,GTK Gliwice,Sezon 2016/2017
2017-03-05 17:00,Enea Astoria Bydgoszcz(w),83 : 100W,100,20,39,51.3,11,26,42.3,31,65,47.7,27,35,77.1,10,30,40,30,21,26,12,6,4,5,126,GTK Gliwice,Sezon 2016/2017
2017-03-11 18:00,Legia Warszawa(d),66 : 79P,66,18,34,52.9,7,20,35.0,25,54,46.3,9,11,81.8,6,18,24,15,22,14,16,8,0,0,66,GTK Gliwice,Sezon 2016/2017
2017-03-18 17:00,KSK Noteć Inowrocław(w),65 : 63P,63,11,32,34.4,12,31,38.7,23,63,36.5,5,8,62.5,4,24,28,16,24,19,16,5,2,3,55,GTK Gliwice,Sezon 2016/2017
2017-03-25 18:00,SKK Siedlce(d),91 : 74W,91,28,41,68.3,7,26,26.9,35,67,52.2,14,20,70.0,4,32,36,22,21,16,7,11,0,0,115,GTK Gliwice,Sezon 2016/2017
2017-04-02 18:00,Spójnia Stargard(w),57 : 84W,84,29,47,61.7,6,21,28.6,35,68,51.5,8,12,66.7,12,22,34,17,19,19,11,16,0,2,103,GTK Gliwice,Sezon 2016/2017
2017-04-08 18:00,Jamalex Polonia 1912 Leszno(d),88 : 72W,88,21,33,63.6,11,28,39.3,32,61,52.5,13,17,76.5,8,23,31,22,29,21,10,8,0,0,106,GTK Gliwice,Sezon 2016/2017
2017-04-09 19:00,Jamalex Polonia 1912 Leszno(d),71 : 67W,71,12,22,54.5,9,29,31.0,21,51,41.2,20,36,55.6,10,29,39,15,25,28,13,7,2,0,75,GTK Gliwice,Sezon 2016/2017
2017-04-22 18:00,Jamalex Polonia 1912 Leszno(w),61 : 62W,62,21,40,52.5,4,22,18.2,25,62,40.3,8,13,61.5,10,26,36,12,19,20,16,6,2,3,60,GTK Gliwice,Sezon 2016/2017
2017-04-29 17:30,Max Elektro Sokół Łańcut(w),77 : 80W,80,18,35,51.4,8,33,24.2,26,68,38.2,20,23,87.0,12,23,35,20,23,21,11,8,0,3,87,GTK Gliwice,Sezon 2016/2017
2017-04-30 17:30,Max Elektro Sokół Łańcut(w),67 : 68W,68,23,40,57.5,5,24,20.8,28,64,43.8,7,15,46.7,4,19,23,14,25,19,14,15,2,3,64,GTK Gliwice,Sezon 2016/2017
2017-05-06 18:00,Max Elektro Sokół Łańcut(d),83 : 78W,83,26,39,66.7,8,18,44.4,34,57,59.6,7,15,46.7,6,26,32,30,23,17,13,7,1,0,109,GTK Gliwice,Sezon 2016/2017
2017-05-12 20:00,Legia Warszawa(w),90 : 80P,80,29,45,64.4,4,14,28.6,33,59,55.9,10,16,62.5,6,21,27,16,25,18,15,8,4,1,88,GTK Gliwice,Sezon 2016/2017
2017-05-13 18:00,Legia Warszawa(w),75 : 70P,70,25,48,52.1,2,15,13.3,27,63,42.9,14,19,73.7,8,18,26,11,24,19,15,11,3,4,65,GTK Gliwice,Sezon 2016/2017
2017-05-20 18:00,Legia Warszawa(d),65 : 74P,65,13,33,39.4,9,24,37.5,22,57,38.6,12,19,63.2,9,23,32,13,25,16,9,7,2,0,68,GTK Gliwice,Sezon 2016/2017
2016-09-23 19:30,Enea Astoria Bydgoszcz(w),76 : 80W,80,25,48,52.1,3,24,12.5,28,72,38.9,21,36,58.3,20,24,44,11,25,27,19,10,5,4,72,Jamalex Polonia 1912 Leszno,Sezon 2016/2017
2016-10-02 17:00,ACK UTH Rosa Radom(d),92 : 73W,92,26,47,55.3,8,13,61.5,34,60,56.7,16,26,61.5,9,26,35,15,18,25,18,12,2,2,102,Jamalex Polonia 1912 Leszno,Sezon 2016/2017
2016-10-09 17:00,Legia Warszawa(w),80 : 58P,58,13,41,31.7,6,24,25.0,19,65,29.2,14,18,77.8,10,19,29,11,19,25,16,9,2,3,43,Jamalex Polonia 1912 Leszno,Sezon 2016/2017
2016-10-15 17:00,MKS Znicz Basket Pruszków(d),79 : 77W,79,23,51,45.1,6,22,27.3,29,73,39.7,15,19,78.9,19,19,38,8,26,16,19,12,2,3,72,Jamalex Polonia 1912 Leszno,Sezon 2016/2017
2016-10-19 19:30,KSK Noteć Inowrocław(d),79 : 67W,79,22,48,45.8,9,24,37.5,31,72,43.1,8,12,66.7,13,27,40,11,20,20,17,14,4,3,86,Jamalex Polonia 1912 Leszno,Sezon 2016/2017
2016-10-22 17:00,GTK Gliwice(d),87 : 79W,87,27,46,58.7,3,10,30.0,30,56,53.6,24,31,77.4,12,24,36,13,23,26,16,9,4,2,100,Jamalex Polonia 1912 Leszno,Sezon 2016/2017
2016-10-29 20:00,SKK Siedlce(w),80 : 65P,65,19,46,41.3,4,21,19.0,23,67,34.3,15,21,71.4,12,23,35,6,27,26,16,8,0,4,48,Jamalex Polonia 1912 Leszno,Sezon 2016/2017
2016-11-05 17:00,GKS Tychy(d),65 : 75P,65,14,40,35.0,5,26,19.2,19,66,28.8,22,30,73.3,17,24,41,9,20,24,11,9,2,1,60,Jamalex Polonia 1912 Leszno,Sezon 2016/2017
2016-11-12 18:00,Spójnia Stargard(w),79 : 70P,70,20,52,38.5,5,21,23.8,25,73,34.2,15,22,68.2,12,23,35,13,21,21,13,10,2,7,62,Jamalex Polonia 1912 Leszno,Sezon 2016/2017
2016-11-16 19:30,Zetkama Doral Nysa Kłodzko(d),64 : 57W,64,18,42,42.9,6,19,31.6,24,61,39.3,10,20,50.0,19,28,47,12,20,18,18,8,3,2,69,Jamalex Polonia 1912 Leszno,Sezon 2016/2017
2016-11-20 17:00,Kotwica Kołobrzeg(w),54 : 65W,65,19,39,48.7,7,22,31.8,26,61,42.6,6,10,60.0,6,20,26,17,13,13,15,15,0,3,69,Jamalex Polonia 1912 Leszno,Sezon 2016/2017
2016-11-27 19:00,AZS AGH Kraków(d),80 : 65W,80,15,32,46.9,10,25,40.0,25,57,43.9,20,27,74.1,7,25,32,20,30,22,13,10,3,1,93,Jamalex Polonia 1912 Leszno,Sezon 2016/2017
2016-12-03 17:30,Max Elektro Sokół Łańcut(w),76 : 65P,65,17,47,36.2,6,24,25.0,23,71,32.4,13,19,68.4,12,24,36,13,21,19,14,8,1,4,55,Jamalex Polonia 1912 Leszno,Sezon 2016/2017
2016-12-10 17:00,Biofarm Basket Poznań(d),82 : 69W,82,17,39,43.6,11,24,45.8,28,63,44.4,15,18,83.3,13,27,40,16,17,24,13,13,3,6,103,Jamalex Polonia 1912 Leszno,Sezon 2016/2017
2016-12-17 17:30,meritumkredyt Pogoń Prudnik(w),82 : 74P,74,21,48,43.8,7,23,30.4,28,71,39.4,11,16,68.8,9,25,34,12,20,16,16,11,2,6,69,Jamalex Polonia 1912 Leszno,Sezon 2016/2017
2017-01-08 17:00,Enea Astoria Bydgoszcz(d),77 : 74W,77,14,29,48.3,10,26,38.5,24,55,43.6,19,28,67.9,10,27,37,15,24,23,17,10,4,1,86,Jamalex Polonia 1912 Leszno,Sezon 2016/2017
2017-01-15 17:00,ACK UTH Rosa Radom(w),57 : 71W,71,10,32,31.3,9,22,40.9,19,54,35.2,24,32,75.0,5,31,36,11,23,29,12,11,3,3,77,Jamalex Polonia 1912 Leszno,Sezon 2016/2017
2017-01-21 17:00,Legia Warszawa(d),70 : 90P,70,18,46,39.1,5,21,23.8,23,67,34.3,19,24,79.2,14,20,34,10,22,22,17,7,2,8,57,Jamalex Polonia 1912 Leszno,Sezon 2016/2017
2017-01-28 18:00,MKS Znicz Basket Pruszków(w),56 : 67W,67,19,45,42.2,5,16,31.3,24,61,39.3,14,24,58.3,10,23,33,7,28,25,14,8,2,4,56,Jamalex Polonia 1912 Leszno,Sezon 2016/2017
2017-02-01 18:00,KSK Noteć Inowrocław(w),73 : 71P,71,25,51,49.0,4,17,23.5,29,68,42.6,9,17,52.9,15,24,39,16,24,22,20,8,0,3,67,Jamalex Polonia 1912 Leszno,Sezon 2016/2017
2017-02-04 18:00,GTK Gliwice(w),71 : 75W,75,18,39,46.2,7,13,53.8,25,52,48.1,18,28,64.3,5,30,35,10,21,24,17,5,3,0,74,Jamalex Polonia 1912 Leszno,Sezon 2016/2017
2017-02-11 17:00,SKK Siedlce(d),83 : 67W,83,27,49,55.1,6,20,30.0,33,69,47.8,11,19,57.9,14,33,47,14,23,23,13,12,2,1,101,Jamalex Polonia 1912 Leszno,Sezon 2016/2017
2017-02-18 18:00,GKS Tychy(w),79 : 67P,67,20,37,54.1,4,15,26.7,24,52,46.2,15,19,78.9,5,24,29,11,24,22,23,5,0,0,57,Jamalex Polonia 1912 Leszno,Sezon 2016/2017
2017-02-24 19:30,Spójnia Stargard(d),65 : 68P,65,17,40,42.5,5,23,21.7,22,63,34.9,16,29,55.2,17,24,41,16,26,26,17,10,2,1,63,Jamalex Polonia 1912 Leszno,Sezon 2016/2017
2017-03-01 19:30,Zetkama Doral Nysa Kłodzko(w),94 : 91P,91,26,43,60.5,8,19,42.1,34,62,54.8,15,21,71.4,8,22,30,22,25,21,15,6,3,3,103,Jamalex Polonia 1912 Leszno,Sezon 2016/2017
2017-03-04 18:00,Kotwica Kołobrzeg(d),69 : 78P,69,12,41,29.3,10,29,34.5,22,70,31.4,15,20,75.0,11,26,37,13,30,20,18,9,0,4,57,Jamalex Polonia 1912 Leszno,Sezon 2016/2017
2017-03-11 18:00,AZS AGH Kraków(w),66 : 78W,78,26,52,50.0,4,12,33.3,30,64,46.9,14,20,70.0,13,26,39,12,24,25,14,9,2,4,86,Jamalex Polonia 1912 Leszno,Sezon 2016/2017
2017-03-18 19:00,Max Elektro Sokół Łańcut(d),77 : 65W,77,21,41,51.2,7,19,36.8,28,60,46.7,14,19,73.7,6,20,26,13,20,22,15,13,2,2,79,Jamalex Polonia 1912 Leszno,Sezon 2016/2017
2017-03-25 15:45,Biofarm Basket Poznań(w),67 : 68W,68,17,48,35.4,6,18,33.3,23,66,34.8,16,23,69.6,14,26,40,6,23,22,15,7,1,6,57,Jamalex Polonia 1912 Leszno,Sezon 2016/2017
2017-04-02 18:00,meritumkredyt Pogoń Prudnik(d),72 : 69W,72,20,39,51.3,9,22,40.9,29,61,47.5,5,9,55.6,11,21,32,15,20,16,16,10,3,0,80,Jamalex Polonia 1912 Leszno,Sezon 2016/2017
2017-04-08 18:00,GTK Gliwice(w),88 : 72P,72,20,37,54.1,3,18,16.7,23,55,41.8,23,37,62.2,9,21,30,5,23,29,16,6,1,0,52,Jamalex Polonia 1912 Leszno,Sezon 2016/2017
2017-04-09 19:00,GTK Gliwice(w),71 : 67P,67,20,41,48.8,4,14,28.6,24,55,43.6,15,25,60.0,4,27,31,10,28,25,9,5,0,0,63,Jamalex Polonia 1912 Leszno,Sezon 2016/2017
2017-04-22 18:00,GTK Gliwice(d),61 : 62P,61,15,41,36.6,5,15,33.3,20,56,35.7,16,23,69.6,7,24,31,6,20,19,15,4,3,2,47,Jamalex Polonia 1912 Leszno,Sezon 2016/2017
2016-09-25 17:00,GTK Gliwice(d),65 : 77P,65,15,34,44.1,7,13,53.8,22,47,46.8,14,25,56.0,10,20,30,15,19,24,23,4,2,2,57,Kotwica Kołobrzeg,Sezon 2016/2017
2016-10-01 18:00,GKS Tychy(w),84 : 89W,89,21,31,67.7,10,25,40.0,31,56,55.4,17,20,85.0,5,19,24,20,18,20,20,13,1,0,99,Kotwica Kołobrzeg,Sezon 2016/2017
2016-10-08 18:00,Zetkama Doral Nysa Kłodzko(d),75 : 54W,75,14,32,43.8,12,32,37.5,26,64,40.6,11,19,57.9,12,21,33,21,23,22,9,9,5,2,88,Kotwica Kołobrzeg,Sezon 2016/2017
2016-10-15 20:00,AZS AGH Kraków(d),73 : 71W,73,20,33,60.6,7,22,31.8,27,55,49.1,12,16,75.0,7,27,34,17,17,19,22,5,1,2,76,Kotwica Kołobrzeg,Sezon 2016/2017
2016-10-19 18:00,Biofarm Basket Poznań(d),61 : 58W,61,15,34,44.1,4,24,16.7,19,58,32.8,19,31,61.3,10,29,39,17,14,26,11,4,2,3,61,Kotwica Kołobrzeg,Sezon 2016/2017
2016-10-22 19:00,Enea Astoria Bydgoszcz(w),84 : 79P,79,15,38,39.5,11,26,42.3,26,64,40.6,16,26,61.5,5,25,30,22,23,23,7,5,1,3,82,Kotwica Kołobrzeg,Sezon 2016/2017
2016-10-31 17:00,Legia Warszawa(d),51 : 85P,51,16,29,55.2,2,25,8.0,18,54,33.3,13,18,72.2,11,21,32,12,19,18,22,6,2,0,40,Kotwica Kołobrzeg,Sezon 2016/2017
2016-11-05 18:00,KSK Noteć Inowrocław(w),75 : 54P,54,16,33,48.5,5,28,17.9,21,61,34.4,7,10,70.0,5,25,30,9,17,15,17,6,1,3,40,Kotwica Kołobrzeg,Sezon 2016/2017
2016-11-10 18:00,SKK Siedlce(d),70 : 60W,70,18,35,51.4,8,26,30.8,26,61,42.6,10,15,66.7,6,21,27,15,14,18,13,9,1,0,69,Kotwica Kołobrzeg,Sezon 2016/2017
2016-11-16 18:00,Spójnia Stargard(w),72 : 66P,66,16,31,51.6,8,26,30.8,24,57,42.1,10,12,83.3,6,22,28,12,18,13,16,9,0,1,64,Kotwica Kołobrzeg,Sezon 2016/2017
2016-11-20 17:00,Jamalex Polonia 1912 Leszno(d),54 : 65P,54,13,23,56.5,7,26,26.9,20,49,40.8,7,10,70.0,4,27,31,15,13,13,23,6,3,0,54,Kotwica Kołobrzeg,Sezon 2016/2017
2016-11-26 18:00,Max Elektro Sokół Łańcut(d),62 : 70P,62,21,46,45.7,3,19,15.8,24,65,36.9,11,14,78.6,8,23,31,13,20,13,8,6,2,1,62,Kotwica Kołobrzeg,Sezon 2016/2017
2016-12-03 17:30,meritumkredyt Pogoń Prudnik(w),79 : 57P,57,15,38,39.5,6,21,28.6,21,59,35.6,9,12,75.0,9,24,33,14,15,16,18,6,2,3,53,Kotwica Kołobrzeg,Sezon 2016/2017
2016-12-11 17:00,ACK UTH Rosa Radom(w),65 : 69W,69,21,38,55.3,7,23,30.4,28,61,45.9,6,7,85.7,5,18,23,25,15,14,13,12,1,1,83,Kotwica Kołobrzeg,Sezon 2016/2017
2016-12-17 18:00,MKS Znicz Basket Pruszków(w),80 : 75P,75,10,31,32.3,12,30,40.0,22,61,36.1,19,26,73.1,10,25,35,10,22,23,14,7,2,5,69,Kotwica Kołobrzeg,Sezon 2016/2017
2017-01-07 18:00,GTK Gliwice(w),77 : 72P,72,15,30,50.0,10,20,50.0,25,50,50.0,12,21,57.1,10,24,34,10,13,21,19,4,0,0,67,Kotwica Kołobrzeg,Sezon 2016/2017
2017-01-14 18:00,GKS Tychy(d),72 : 56W,72,21,38,55.3,8,28,28.6,29,66,43.9,6,11,54.5,6,28,34,21,16,19,12,9,3,3,85,Kotwica Kołobrzeg,Sezon 2016/2017
2017-01-21 17:00,Zetkama Doral Nysa Kłodzko(w),99 : 65P,65,13,27,48.1,5,25,20.0,18,52,34.6,24,36,66.7,4,21,25,14,18,29,8,3,0,1,53,Kotwica Kołobrzeg,Sezon 2016/2017
2017-01-28 17:00,AZS AGH Kraków(w),85 : 78P,78,24,47,51.1,4,22,18.2,28,69,40.6,18,30,60.0,17,24,41,12,23,28,14,8,1,2,73,Kotwica Kołobrzeg,Sezon 2016/2017
2017-02-01 19:30,Biofarm Basket Poznań(w),65 : 59P,59,18,39,46.2,6,21,28.6,24,60,40.0,5,7,71.4,6,19,25,20,16,17,11,8,3,4,66,Kotwica Kołobrzeg,Sezon 2016/2017
2017-02-04 18:00,Enea Astoria Bydgoszcz(d),80 : 71W,80,20,35,57.1,10,26,38.5,30,61,49.2,10,22,45.5,8,29,37,16,17,20,12,8,5,1,91,Kotwica Kołobrzeg,Sezon 2016/2017
2017-02-10 19:30,Legia Warszawa(w),94 : 65P,65,21,41,51.2,7,26,26.9,28,67,41.8,2,7,28.6,7,26,33,15,14,15,12,5,1,2,63,Kotwica Kołobrzeg,Sezon 2016/2017
2017-02-18 18:00,KSK Noteć Inowrocław(d),69 : 57W,69,17,42,40.5,11,24,45.8,28,66,42.4,2,4,50.0,5,34,39,16,15,18,9,5,3,2,83,Kotwica Kołobrzeg,Sezon 2016/2017
2017-02-26 13:30,SKK Siedlce(w),87 : 70P,70,18,41,43.9,6,23,26.1,24,64,37.5,16,24,66.7,8,20,28,15,11,22,13,9,5,2,66,Kotwica Kołobrzeg,Sezon 2016/2017
2017-03-01 19:00,Spójnia Stargard(d),74 : 64W,74,22,40,55.0,7,20,35.0,29,60,48.3,9,12,75.0,4,27,31,21,13,17,14,11,1,0,90,Kotwica Kołobrzeg,Sezon 2016/2017
2017-03-04 18:00,Jamalex Polonia 1912 Leszno(w),69 : 78W,78,14,20,70.0,7,26,26.9,21,46,45.7,29,37,78.4,2,32,34,15,22,29,25,9,4,0,82,Kotwica Kołobrzeg,Sezon 2016/2017
2017-03-11 17:00,Max Elektro Sokół Łańcut(w),71 : 73W,73,23,35,65.7,8,22,36.4,31,57,54.4,3,7,42.9,5,24,29,24,12,11,14,8,1,1,91,Kotwica Kołobrzeg,Sezon 2016/2017
2017-03-18 18:00,meritumkredyt Pogoń Prudnik(d),81 : 71W,81,22,39,56.4,8,23,34.8,30,62,48.4,13,21,61.9,7,29,36,24,23,23,12,8,6,5,103,Kotwica Kołobrzeg,Sezon 2016/2017
2017-03-21 18:00,ACK UTH Rosa Radom(d),82 : 75W,82,22,45,48.9,5,16,31.3,27,61,44.3,23,30,76.7,11,27,38,19,19,25,11,8,3,3,98,Kotwica Kołobrzeg,Sezon 2016/2017
2017-04-02 18:00,MKS Znicz Basket Pruszków(d),51 : 71P,51,10,31,32.3,6,23,26.1,16,54,29.6,13,20,65.0,6,24,30,13,21,20,18,10,2,2,43,Kotwica Kołobrzeg,Sezon 2016/2017
2016-09-24 18:00,AZS AGH Kraków(d),74 : 73W,74,17,40,42.5,9,22,40.9,26,62,41.9,13,21,61.9,11,23,34,15,15,18,12,7,5,2,79,KSK Noteć Inowrocław,Sezon 2016/2017
2016-10-01 18:30,Biofarm Basket Poznań(w),70 : 67P,67,23,45,51.1,5,22,22.7,28,67,41.8,6,10,60.0,9,16,25,16,15,16,10,11,5,3,71,KSK Noteć Inowrocław,Sezon 2016/2017
2016-10-08 18:00,Enea Astoria Bydgoszcz(d),89 : 62W,89,22,41,53.7,12,29,41.4,34,70,48.6,9,18,50.0,13,30,43,27,17,16,13,6,2,2,109,KSK Noteć Inowrocław,Sezon 2016/2017
2016-10-15 17:00,Legia Warszawa(w),85 : 62P,62,21,43,48.8,3,18,16.7,24,61,39.3,11,17,64.7,8,20,28,14,20,19,20,7,1,5,49,KSK Noteć Inowrocław,Sezon 2016/2017
2016-10-19 19:30,Jamalex Polonia 1912 Leszno(w),79 : 67P,67,21,49,42.9,5,16,31.3,26,65,40.0,10,14,71.4,10,24,34,13,20,19,20,7,3,4,61,KSK Noteć Inowrocław,Sezon 2016/2017
2016-10-23 18:00,SKK Siedlce(d),79 : 60W,79,18,42,42.9,8,20,40.0,26,62,41.9,19,28,67.9,14,26,40,18,12,23,9,10,1,2,94,KSK Noteć Inowrocław,Sezon 2016/2017
2016-10-29 18:00,Spójnia Stargard(w),102 : 97P,97,28,44,63.6,8,28,28.6,36,72,50.0,17,26,65.4,6,29,35,20,19,20,17,13,0,1,103,KSK Noteć Inowrocław,Sezon 2016/2017
2016-11-05 18:00,Kotwica Kołobrzeg(d),75 : 54W,75,25,49,51.0,6,26,23.1,31,75,41.3,7,10,70.0,15,31,46,22,15,17,10,11,3,1,100,KSK Noteć Inowrocław,Sezon 2016/2017
2016-11-12 17:30,Max Elektro Sokół Łańcut(w),77 : 82W,82,19,37,51.4,11,24,45.8,30,61,49.2,11,13,84.6,4,27,31,16,27,16,14,6,2,0,90,KSK Noteć Inowrocław,Sezon 2016/2017
2016-11-16 18:00,meritumkredyt Pogoń Prudnik(d),68 : 78P,68,23,44,52.3,5,23,21.7,28,67,41.8,7,13,53.8,10,22,32,15,18,18,16,7,2,4,63,KSK Noteć Inowrocław,Sezon 2016/2017
2016-11-19 13:00,ACK UTH Rosa Radom(w),76 : 65P,65,17,33,51.5,6,17,35.3,23,50,46.0,13,17,76.5,5,21,26,15,16,19,19,8,2,2,66,KSK Noteć Inowrocław,Sezon 2016/2017
2016-11-26 18:00,MKS Znicz Basket Pruszków(d),75 : 87P,75,27,49,55.1,3,24,12.5,30,73,41.1,12,18,66.7,14,23,37,18,15,17,10,7,2,2,80,KSK Noteć Inowrocław,Sezon 2016/2017
2016-12-03 18:00,GTK Gliwice(w),92 : 84P,84,24,41,58.5,6,22,27.3,30,63,47.6,18,25,72.0,5,19,24,11,22,28,15,7,0,0,71,KSK Noteć Inowrocław,Sezon 2016/2017
2016-12-10 18:00,GKS Tychy(d),70 : 88P,70,17,35,48.6,7,24,29.2,24,59,40.7,15,18,83.3,4,21,25,18,18,19,19,9,1,3,66,KSK Noteć Inowrocław,Sezon 2016/2017
2016-12-17 17:00,Zetkama Doral Nysa Kłodzko(w),65 : 71W,71,25,45,55.6,3,20,15.0,28,65,43.1,12,17,70.6,10,28,38,17,16,21,18,8,1,3,75,KSK Noteć Inowrocław,Sezon 2016/2017
2017-01-14 18:00,Biofarm Basket Poznań(d),92 : 62W,92,20,36,55.6,12,23,52.2,32,59,54.2,16,18,88.9,8,22,30,24,19,17,11,5,3,1,114,KSK Noteć Inowrocław,Sezon 2016/2017
2017-01-21 19:00,Enea Astoria Bydgoszcz(w),62 : 63W,63,14,36,38.9,8,25,32.0,22,61,36.1,11,17,64.7,8,20,28,15,28,22,14,11,4,3,62,KSK Noteć Inowrocław,Sezon 2016/2017
2017-01-28 18:00,Legia Warszawa(d),70 : 89P,70,19,37,51.4,5,19,26.3,24,56,42.9,17,25,68.0,10,19,29,14,29,25,15,5,2,1,65,KSK Noteć Inowrocław,Sezon 2016/2017
2017-02-01 18:00,Jamalex Polonia 1912 Leszno(d),73 : 71W,73,20,42,47.6,3,9,33.3,23,51,45.1,24,31,77.4,5,21,26,13,22,24,17,11,3,0,74,KSK Noteć Inowrocław,Sezon 2016/2017
2017-02-04 18:00,SKK Siedlce(w),94 : 87P,87,21,41,51.2,10,27,37.0,31,68,45.6,15,21,71.4,9,26,35,15,15,20,13,8,2,0,91,KSK Noteć Inowrocław,Sezon 2016/2017
2017-02-12 18:00,Spójnia Stargard(d),65 : 92P,65,19,39,48.7,4,16,25.0,23,55,41.8,15,27,55.6,6,15,21,16,19,20,12,8,3,3,57,KSK Noteć Inowrocław,Sezon 2016/2017
2017-02-18 18:00,Kotwica Kołobrzeg(w),69 : 57P,57,16,38,42.1,7,28,25.0,23,66,34.8,4,13,30.8,10,30,40,16,19,15,6,5,2,3,62,KSK Noteć Inowrocław,Sezon 2016/2017
2017-02-22 19:00,AZS AGH Kraków(w),79 : 59P,59,22,45,48.9,3,14,21.4,25,59,42.4,6,16,37.5,12,19,31,16,17,22,21,9,2,3,52,KSK Noteć Inowrocław,Sezon 2016/2017
2017-02-25 13:00,Max Elektro Sokół Łańcut(d),71 : 75P,71,22,43,51.2,8,30,26.7,30,73,41.1,3,5,60.0,12,26,38,20,23,12,23,10,5,4,76,KSK Noteć Inowrocław,Sezon 2016/2017
2017-03-01 18:30,meritumkredyt Pogoń Prudnik(w),69 : 75W,75,19,35,54.3,7,21,33.3,26,56,46.4,16,19,84.2,7,23,30,15,22,20,10,6,3,3,86,KSK Noteć Inowrocław,Sezon 2016/2017
2017-03-04 18:00,ACK UTH Rosa Radom(d),73 : 69W,73,18,34,52.9,8,30,26.7,26,64,40.6,13,20,65.0,13,28,41,19,21,20,15,10,1,2,84,KSK Noteć Inowrocław,Sezon 2016/2017
2017-03-11 18:00,MKS Znicz Basket Pruszków(w),89 : 66P,66,18,30,60.0,6,28,21.4,24,58,41.4,12,24,50.0,8,17,25,15,16,21,17,14,0,0,57,KSK Noteć Inowrocław,Sezon 2016/2017
2017-03-18 17:00,GTK Gliwice(d),65 : 63W,65,25,45,55.6,2,15,13.3,27,60,45.0,9,20,45.0,10,29,39,21,19,24,16,9,3,2,77,KSK Noteć Inowrocław,Sezon 2016/2017
2017-03-25 19:00,GKS Tychy(w),108 : 74P,74,25,48,52.1,5,24,20.8,30,72,41.7,9,15,60.0,15,15,30,17,16,17,16,7,0,3,64,KSK Noteć Inowrocław,Sezon 2016/2017
2017-04-02 18:00,Zetkama Doral Nysa Kłodzko(d),68 : 78P,68,16,31,51.6,7,32,21.9,23,63,36.5,15,24,62.5,12,22,34,18,23,23,13,9,2,2,69,KSK Noteć Inowrocław,Sezon 2016/2017
2017-04-08 18:00,Zetkama Doral Nysa Kłodzko(d),74 : 78P,74,20,40,50.0,5,23,21.7,25,63,39.7,19,25,76.0,14,35,49,9,24,22,22,5,1,3,72,KSK Noteć Inowrocław,Sezon 2016/2017
2017-04-09 18:00,Zetkama Doral Nysa Kłodzko(d),72 : 79P,72,13,32,40.6,10,35,28.6,23,67,34.3,16,30,53.3,12,21,33,15,21,27,9,9,2,0,64,KSK Noteć Inowrocław,Sezon 2016/2017
2017-04-22 17:00,Zetkama Doral Nysa Kłodzko(w),86 : 89W,89,26,41,63.4,9,25,36.0,35,66,53.0,10,16,62.5,9,24,33,23,19,19,14,8,3,2,105,KSK Noteć Inowrocław,Sezon 2016/2017
2017-04-23 17:00,Zetkama Doral Nysa Kłodzko(w),93 : 79P,79,17,39,43.6,8,25,32.0,25,64,39.1,21,27,77.8,10,19,29,11,30,22,13,6,3,4,70,KSK Noteć Inowrocław,Sezon 2016/2017
2016-09-25 16:00,Biofarm Basket Poznań(d),60 : 64P,60,17,37,45.9,5,23,21.7,22,60,36.7,11,16,68.8,12,23,35,12,23,18,13,6,5,3,62,Legia Warszawa,Sezon 2016/2017
2016-10-01 19:00,Enea Astoria Bydgoszcz(w),72 : 85W,85,18,39,46.2,13,37,35.1,31,76,40.8,10,14,71.4,12,17,29,22,19,19,11,12,2,3,90,Legia Warszawa,Sezon 2016/2017
2016-10-09 17:00,Jamalex Polonia 1912 Leszno(d),80 : 58W,80,23,38,60.5,9,25,36.0,32,63,50.8,7,13,53.8,9,29,38,24,25,19,18,9,3,2,99,Legia Warszawa,Sezon 2016/2017
2016-10-15 17:00,KSK Noteć Inowrocław(d),85 : 62W,85,17,22,77.3,13,37,35.1,30,59,50.8,12,15,80.0,4,25,29,21,19,20,15,12,5,1,105,Legia Warszawa,Sezon 2016/2017
2016-10-19 20:00,SKK Siedlce(w),62 : 80W,80,19,40,47.5,8,24,33.3,27,64,42.2,18,23,78.3,11,20,31,19,15,21,8,6,6,3,92,Legia Warszawa,Sezon 2016/2017
2016-10-22 16:00,Spójnia Stargard(d),66 : 83P,66,18,39,46.2,7,25,28.0,25,64,39.1,9,14,64.3,7,17,24,13,10,17,11,9,0,4,57,Legia Warszawa,Sezon 2016/2017
2016-10-31 17:00,Kotwica Kołobrzeg(w),51 : 85W,85,21,36,58.3,11,33,33.3,32,69,46.4,10,15,66.7,13,23,36,23,18,19,12,13,0,2,103,Legia Warszawa,Sezon 2016/2017
2016-11-05 17:00,Max Elektro Sokół Łańcut(d),60 : 65P,60,14,28,50.0,7,28,25.0,21,56,37.5,11,12,91.7,8,24,32,15,21,16,20,7,4,1,62,Legia Warszawa,Sezon 2016/2017
2016-11-11 17:30,meritumkredyt Pogoń Prudnik(w),72 : 64P,64,20,31,64.5,4,23,17.4,24,54,44.4,12,15,80.0,8,20,28,11,16,19,18,9,1,3,62,Legia Warszawa,Sezon 2016/2017
2016-11-16 20:00,ACK UTH Rosa Radom(d),101 : 62W,101,26,38,68.4,12,25,48.0,38,63,60.3,13,16,81.3,2,23,25,31,19,19,13,18,2,0,136,Legia Warszawa,Sezon 2016/2017
2016-11-19 18:00,MKS Znicz Basket Pruszków(w),59 : 79W,79,19,36,52.8,11,26,42.3,30,62,48.4,8,8,100.0,7,20,27,21,15,17,7,8,6,0,102,Legia Warszawa,Sezon 2016/2017
2016-11-25 20:00,GTK Gliwice(d),78 : 74W,78,23,32,71.9,3,18,16.7,26,50,52.0,23,32,71.9,8,27,35,20,15,24,18,9,0,0,91,Legia Warszawa,Sezon 2016/2017
2016-12-03 18:00,GKS Tychy(w),68 : 89W,89,26,44,59.1,9,23,39.1,35,67,52.2,10,11,90.9,13,26,39,17,14,21,13,9,2,5,110,Legia Warszawa,Sezon 2016/2017
2016-12-10 17:00,Zetkama Doral Nysa Kłodzko(w),69 : 87W,87,22,36,61.1,6,24,25.0,28,60,46.7,25,29,86.2,8,15,23,26,16,24,11,12,1,2,102,Legia Warszawa,Sezon 2016/2017
2016-12-17 19:30,AZS AGH Kraków(w),53 : 84W,84,27,43,62.8,5,15,33.3,32,58,55.2,15,22,68.2,9,27,36,26,18,14,12,12,1,3,114,Legia Warszawa,Sezon 2016/2017
2017-01-07 15:45,Biofarm Basket Poznań(w),58 : 66W,66,22,43,51.2,4,21,19.0,26,64,40.6,10,15,66.7,12,20,32,16,15,23,16,11,4,3,70,Legia Warszawa,Sezon 2016/2017
2017-01-14 17:00,Enea Astoria Bydgoszcz(d),83 : 61W,83,23,40,57.5,7,19,36.8,30,59,50.8,16,21,76.2,11,20,31,23,18,25,19,13,3,1,100,Legia Warszawa,Sezon 2016/2017
2017-01-21 17:00,Jamalex Polonia 1912 Leszno(w),70 : 90W,90,23,37,62.2,8,20,40.0,31,57,54.4,20,26,76.9,7,27,34,16,22,22,16,10,8,2,110,Legia Warszawa,Sezon 2016/2017
2017-01-28 18:00,KSK Noteć Inowrocław(w),70 : 89W,89,18,30,60.0,10,22,45.5,28,52,53.8,23,32,71.9,9,21,30,18,25,29,14,9,1,2,100,Legia Warszawa,Sezon 2016/2017
2017-01-31 20:00,SKK Siedlce(d),92 : 82W,92,27,44,61.4,8,19,42.1,35,63,55.6,14,18,77.8,12,20,32,20,17,20,17,4,2,1,101,Legia Warszawa,Sezon 2016/2017
2017-02-04 18:00,Spójnia Stargard(w),89 : 101W,101,24,37,64.9,11,23,47.8,35,60,58.3,20,27,74.1,5,23,28,20,18,22,7,6,2,3,118,Legia Warszawa,Sezon 2016/2017
2017-02-10 19:30,Kotwica Kołobrzeg(d),94 : 65W,94,18,38,47.4,16,34,47.1,34,72,47.2,10,10,100.0,9,29,38,22,15,13,10,8,2,1,116,Legia Warszawa,Sezon 2016/2017
2017-02-18 17:30,Max Elektro Sokół Łańcut(w),80 : 73P,73,13,35,37.1,9,24,37.5,22,59,37.3,20,26,76.9,7,30,37,16,17,25,15,8,2,4,78,Legia Warszawa,Sezon 2016/2017
2017-02-25 17:00,meritumkredyt Pogoń Prudnik(d),85 : 75W,85,23,44,52.3,8,23,34.8,31,67,46.3,15,20,75.0,13,29,42,20,18,19,14,7,0,4,99,Legia Warszawa,Sezon 2016/2017
2017-03-01 16:00,ACK UTH Rosa Radom(w),85 : 79P,79,21,42,50.0,8,28,28.6,29,70,41.4,13,19,68.4,12,27,39,29,22,20,13,7,5,2,99,Legia Warszawa,Sezon 2016/2017
2017-03-04 17:00,MKS Znicz Basket Pruszków(d),74 : 65W,74,20,31,64.5,6,24,25.0,26,55,47.3,16,22,72.7,7,25,32,16,16,24,13,7,3,2,84,Legia Warszawa,Sezon 2016/2017
2017-03-11 18:00,GTK Gliwice(w),66 : 79W,79,18,33,54.5,10,30,33.3,28,63,44.4,13,16,81.3,12,21,33,13,14,22,13,6,0,0,80,Legia Warszawa,Sezon 2016/2017
2017-03-18 17:00,GKS Tychy(d),77 : 84P,77,19,38,50.0,8,33,24.2,27,71,38.0,15,21,71.4,15,18,33,16,22,22,17,9,0,2,68,Legia Warszawa,Sezon 2016/2017
2017-03-25 15:00,Zetkama Doral Nysa Kłodzko(d),91 : 54W,91,24,38,63.2,7,20,35.0,31,58,53.4,22,28,78.6,7,37,44,16,18,28,14,7,1,3,112,Legia Warszawa,Sezon 2016/2017
2017-03-31 19:00,AZS AGH Kraków(d),86 : 75W,86,22,40,55.0,7,25,28.0,29,65,44.6,21,28,75.0,12,26,38,23,19,25,19,6,3,5,94,Legia Warszawa,Sezon 2016/2017
2017-04-07 19:00,Biofarm Basket Poznań(d),57 : 69P,57,15,37,40.5,6,25,24.0,21,62,33.9,9,16,56.3,12,23,35,10,14,19,13,7,4,4,52,Legia Warszawa,Sezon 2016/2017
2017-04-08 17:00,Biofarm Basket Poznań(d),91 : 69W,91,21,39,53.8,12,29,41.4,33,68,48.5,13,19,68.4,13,20,33,21,12,21,12,11,0,2,103,Legia Warszawa,Sezon 2016/2017
2017-04-22 19:00,Biofarm Basket Poznań(w),63 : 70W,70,22,40,55.0,4,21,19.0,26,61,42.6,14,19,73.7,10,21,31,11,20,22,13,11,3,6,73,Legia Warszawa,Sezon 2016/2017
2017-04-23 17:00,Biofarm Basket Poznań(w),77 : 82W,82,17,42,40.5,13,32,40.6,30,74,40.5,9,18,50.0,11,24,35,21,24,20,18,13,2,5,82,Legia Warszawa,Sezon 2016/2017
2017-04-28 20:00,Spójnia Stargard(d),85 : 75W,85,16,32,50.0,12,23,52.2,28,55,50.9,17,24,70.8,6,29,35,21,22,21,18,8,4,0,101,Legia Warszawa,Sezon 2016/2017
2017-04-29 18:00,Spójnia Stargard(d),104 : 80W,104,30,44,68.2,6,20,30.0,36,64,56.3,26,29,89.7,10,24,34,20,15,21,12,9,6,0,130,Legia Warszawa,Sezon 2016/2017
2017-05-06 18:30,Spójnia Stargard(w),82 : 88W,88,23,32,71.9,8,22,36.4,31,54,57.4,18,29,62.1,3,27,30,18,20,21,17,7,5,0,97,Legia Warszawa,Sezon 2016/2017
2017-05-12 20:00,GTK Gliwice(d),90 : 80W,90,16,33,48.5,12,23,52.2,28,56,50.0,22,30,73.3,7,21,28,18,19,24,15,6,1,4,92,Legia Warszawa,Sezon 2016/2017
2017-05-13 18:00,GTK Gliwice(d),75 : 70W,75,19,37,51.4,6,20,30.0,25,57,43.9,19,23,82.6,12,28,40,14,19,24,16,4,4,3,85,Legia Warszawa,Sezon 2016/2017
2017-05-20 18:00,GTK Gliwice(w),65 : 74W,74,18,32,56.3,7,25,28.0,25,57,43.9,17,25,68.0,8,23,31,12,17,24,10,4,0,0,71,Legia Warszawa,Sezon 2016/2017
2016-09-25 17:00,MKS Znicz Basket Pruszków(w),71 : 80W,80,13,30,43.3,12,32,37.5,25,62,40.3,18,24,75.0,9,28,37,24,28,23,15,7,0,0,90,Max Elektro Sokół Łańcut,Sezon 2016/2017
2016-10-01 18:00,GTK Gliwice(w),73 : 77W,77,20,33,60.6,5,18,27.8,25,51,49.0,22,28,78.6,4,35,39,13,26,33,18,2,1,0,82,Max Elektro Sokół Łańcut,Sezon 2016/2017
2016-10-08 17:30,GKS Tychy(d),79 : 74W,79,18,42,42.9,6,24,25.0,24,66,36.4,25,30,83.3,14,23,37,20,17,28,11,6,5,5,89,Max Elektro Sokół Łańcut,Sezon 2016/2017
2016-10-15 17:00,Zetkama Doral Nysa Kłodzko(w),73 : 90W,90,20,36,55.6,9,22,40.9,29,58,50.0,23,26,88.5,6,25,31,19,17,23,11,9,2,1,108,Max Elektro Sokół Łańcut,Sezon 2016/2017
2016-10-19 18:00,AZS AGH Kraków(d),88 : 72W,88,32,54,59.3,4,17,23.5,36,71,50.7,12,14,85.7,18,30,48,23,18,16,17,9,4,0,118,Max Elektro Sokół Łańcut,Sezon 2016/2017
2016-10-22 15:45,Biofarm Basket Poznań(w),48 : 73W,73,14,36,38.9,8,21,38.1,22,57,38.6,21,38,55.3,20,26,46,14,19,28,23,8,5,2,71,Max Elektro Sokół Łańcut,Sezon 2016/2017
2016-10-29 17:30,Enea Astoria Bydgoszcz(d),84 : 69W,84,21,41,51.2,10,26,38.5,31,67,46.3,12,24,50.0,9,22,31,16,19,20,13,12,5,1,87,Max Elektro Sokół Łańcut,Sezon 2016/2017
2016-11-05 17:00,Legia Warszawa(w),60 : 65W,65,13,35,37.1,8,28,28.6,21,63,33.3,15,17,88.2,8,23,31,14,16,21,14,14,1,4,67,Max Elektro Sokół Łańcut,Sezon 2016/2017
2016-11-12 17:30,KSK Noteć Inowrocław(d),77 : 82P,77,17,36,47.2,7,28,25.0,24,64,37.5,22,24,91.7,12,27,39,17,18,26,11,7,0,2,87,Max Elektro Sokół Łańcut,Sezon 2016/2017
2016-11-16 18:00,SKK Siedlce(w),75 : 87W,87,16,33,48.5,12,26,46.2,28,59,47.5,19,24,79.2,8,24,32,17,16,21,12,8,1,1,97,Max Elektro Sokół Łańcut,Sezon 2016/2017
2016-11-19 17:30,Spójnia Stargard(d),73 : 70W,73,20,44,45.5,6,26,23.1,26,70,37.1,15,19,78.9,13,30,43,13,19,25,15,8,4,1,78,Max Elektro Sokół Łańcut,Sezon 2016/2017
2016-11-26 18:00,Kotwica Kołobrzeg(w),62 : 70W,70,18,35,51.4,5,21,23.8,23,56,41.1,19,25,76.0,9,27,36,17,13,20,17,2,1,2,70,Max Elektro Sokół Łańcut,Sezon 2016/2017
2016-12-03 17:30,Jamalex Polonia 1912 Leszno(d),76 : 65W,76,25,44,56.8,4,26,15.4,29,70,41.4,14,21,66.7,15,33,48,16,21,21,13,7,4,1,90,Max Elektro Sokół Łańcut,Sezon 2016/2017
2016-12-10 17:30,meritumkredyt Pogoń Prudnik(d),82 : 62W,82,20,34,58.8,10,29,34.5,30,63,47.6,12,16,75.0,10,29,39,17,17,19,13,7,1,3,96,Max Elektro Sokół Łańcut,Sezon 2016/2017
2016-12-17 17:00,ACK UTH Rosa Radom(w),87 : 81P,81,20,40,50.0,10,24,41.7,30,64,46.9,11,15,73.3,11,26,37,24,21,17,12,3,4,3,99,Max Elektro Sokół Łańcut,Sezon 2016/2017
2017-01-07 17:30,MKS Znicz Basket Pruszków(d),84 : 66W,84,23,43,53.5,9,22,40.9,32,65,49.2,11,14,78.6,13,25,38,18,23,18,17,10,5,3,102,Max Elektro Sokół Łańcut,Sezon 2016/2017
2017-01-14 17:30,GTK Gliwice(d),75 : 63W,75,18,31,58.1,7,22,31.8,25,53,47.2,18,19,94.7,6,22,28,15,15,24,13,12,1,2,89,Max Elektro Sokół Łańcut,Sezon 2016/2017
2017-01-21 18:00,GKS Tychy(w),84 : 86W,86,17,37,45.9,10,29,34.5,27,66,40.9,22,31,71.0,11,29,40,10,18,22,14,5,3,2,82,Max Elektro Sokół Łańcut,Sezon 2016/2017
2017-01-28 17:30,Zetkama Doral Nysa Kłodzko(d),83 : 57W,83,26,43,60.5,6,33,18.2,32,76,42.1,13,15,86.7,12,28,40,20,18,22,5,12,2,4,106,Max Elektro Sokół Łańcut,Sezon 2016/2017
2017-02-01 18:30,AZS AGH Kraków(w),65 : 64P,64,22,38,57.9,4,18,22.2,26,56,46.4,8,20,40.0,5,22,27,13,24,21,14,6,3,2,57,Max Elektro Sokół Łańcut,Sezon 2016/2017
2017-02-04 17:30,Biofarm Basket Poznań(d),72 : 74P,72,16,41,39.0,9,27,33.3,25,68,36.8,13,17,76.5,13,23,36,16,20,20,14,6,1,2,70,Max Elektro Sokół Łańcut,Sezon 2016/2017
2017-02-12 17:00,Enea Astoria Bydgoszcz(w),79 : 112W,112,19,31,61.3,18,32,56.3,37,63,58.7,20,25,80.0,6,23,29,30,21,24,12,10,2,0,140,Max Elektro Sokół Łańcut,Sezon 2016/2017
2017-02-18 17:30,Legia Warszawa(d),80 : 73W,80,22,42,52.4,9,23,39.1,31,65,47.7,9,18,50.0,6,31,37,17,25,17,11,13,4,2,97,Max Elektro Sokół Łańcut,Sezon 2016/2017
2017-02-25 13:00,KSK Noteć Inowrocław(w),71 : 75W,75,16,39,41.0,8,22,36.4,24,61,39.3,19,25,76.0,9,24,33,12,13,23,20,15,4,5,76,Max Elektro Sokół Łańcut,Sezon 2016/2017
2017-03-01 18:00,SKK Siedlce(d),73 : 61W,73,21,39,53.8,6,26,23.1,27,65,41.5,13,16,81.3,11,28,39,17,17,19,10,9,1,0,88,Max Elektro Sokół Łańcut,Sezon 2016/2017
2017-03-04 18:00,Spójnia Stargard(w),85 : 70P,70,19,37,51.4,5,25,20.0,24,62,38.7,17,24,70.8,9,18,27,6,14,20,11,7,0,3,54,Max Elektro Sokół Łańcut,Sezon 2016/2017
2017-03-11 17:00,Kotwica Kołobrzeg(d),71 : 73P,71,20,42,47.6,9,27,33.3,29,69,42.0,4,7,57.1,13,22,35,18,12,11,12,9,1,1,79,Max Elektro Sokół Łańcut,Sezon 2016/2017
2017-03-18 19:00,Jamalex Polonia 1912 Leszno(w),77 : 65P,65,16,31,51.6,8,21,38.1,24,52,46.2,9,11,81.8,4,25,29,12,22,20,25,8,2,2,61,Max Elektro Sokół Łańcut,Sezon 2016/2017
2017-03-25 17:30,meritumkredyt Pogoń Prudnik(w),81 : 77P,77,13,24,54.2,13,31,41.9,26,55,47.3,12,18,66.7,7,23,30,16,30,19,14,8,0,0,82,Max Elektro Sokół Łańcut,Sezon 2016/2017
2017-04-02 18:00,ACK UTH Rosa Radom(d),88 : 94P,88,20,37,54.1,11,30,36.7,31,67,46.3,15,15,100.0,9,20,29,14,27,18,14,8,2,2,91,Max Elektro Sokół Łańcut,Sezon 2016/2017
2017-04-08 17:30,meritumkredyt Pogoń Prudnik(d),87 : 81W,87,14,33,42.4,14,29,48.3,28,62,45.2,17,23,73.9,9,23,32,14,19,20,9,10,2,2,96,Max Elektro Sokół Łańcut,Sezon 2016/2017
2017-04-09 17:30,meritumkredyt Pogoń Prudnik(d),105 : 77W,105,30,42,71.4,11,24,45.8,41,66,62.1,12,16,75.0,6,29,35,27,19,17,10,5,1,2,134,Max Elektro Sokół Łańcut,Sezon 2016/2017
2017-04-22 17:30,meritumkredyt Pogoń Prudnik(w),59 : 73W,73,29,47,61.7,2,19,10.5,31,66,47.0,9,13,69.2,8,40,48,15,14,16,13,7,2,3,93,Max Elektro Sokół Łańcut,Sezon 2016/2017
2017-04-29 17:30,GTK Gliwice(d),77 : 80P,77,17,32,53.1,9,24,37.5,26,56,46.4,16,20,80.0,6,25,31,16,21,23,16,5,3,0,82,Max Elektro Sokół Łańcut,Sezon 2016/2017
2017-04-30 17:30,GTK Gliwice(d),67 : 68P,67,13,28,46.4,7,21,33.3,20,49,40.8,20,26,76.9,9,28,37,15,19,25,24,9,3,2,72,Max Elektro Sokół Łańcut,Sezon 2016/2017
2017-05-06 18:00,GTK Gliwice(w),83 : 78P,78,12,24,50.0,9,28,32.1,21,52,40.4,27,31,87.1,8,14,22,11,17,23,12,6,0,0,70,Max Elektro Sokół Łańcut,Sezon 2016/2017
2017-05-13 20:00,Spójnia Stargard(w),96 : 76P,76,19,42,45.2,9,31,29.0,28,73,38.4,11,13,84.6,12,16,28,14,15,18,12,10,1,4,70,Max Elektro Sokół Łańcut,Sezon 2016/2017
2017-05-20 17:30,Spójnia Stargard(d),89 : 76W,89,24,44,54.5,8,28,28.6,32,72,44.4,17,24,70.8,13,28,41,20,24,24,12,7,2,1,100,Max Elektro Sokół Łańcut,Sezon 2016/2017
2016-09-24 17:30,ACK UTH Rosa Radom(d),75 : 70W,75,13,29,44.8,12,29,41.4,25,58,43.1,13,14,92.9,7,20,27,17,23,19,15,12,0,0,82,meritumkredyt Pogoń Prudnik,Sezon 2016/2017
2016-10-02 17:00,MKS Znicz Basket Pruszków(w),66 : 77W,77,20,41,48.8,9,24,37.5,29,65,44.6,10,13,76.9,9,21,30,17,22,13,13,9,1,2,82,meritumkredyt Pogoń Prudnik,Sezon 2016/2017
2016-10-08 17:30,GTK Gliwice(d),71 : 74P,71,18,36,50.0,5,20,25.0,23,56,41.1,20,24,83.3,6,26,32,15,19,22,19,9,3,0,74,meritumkredyt Pogoń Prudnik,Sezon 2016/2017
2016-10-15 18:00,GKS Tychy(w),81 : 73P,73,18,39,46.2,6,18,33.3,24,57,42.1,19,23,82.6,2,22,24,11,18,21,14,4,0,0,61,meritumkredyt Pogoń Prudnik,Sezon 2016/2017
2016-10-19 18:30,Zetkama Doral Nysa Kłodzko(d),96 : 70W,96,25,42,59.5,11,26,42.3,36,68,52.9,13,14,92.9,13,19,32,15,15,16,8,14,3,5,119,meritumkredyt Pogoń Prudnik,Sezon 2016/2017
2016-10-23 19:00,AZS AGH Kraków(w),72 : 75W,75,17,35,48.6,9,22,40.9,26,57,45.6,14,20,70.0,8,20,28,18,22,23,18,7,3,3,76,meritumkredyt Pogoń Prudnik,Sezon 2016/2017
2016-10-29 17:30,Biofarm Basket Poznań(d),90 : 67W,90,21,39,53.8,12,24,50.0,33,63,52.4,12,12,100.0,8,20,28,22,20,18,12,10,1,0,109,meritumkredyt Pogoń Prudnik,Sezon 2016/2017
2016-11-05 19:00,Enea Astoria Bydgoszcz(w),97 : 86P,86,17,30,56.7,11,28,39.3,28,58,48.3,19,24,79.2,7,13,20,22,20,22,17,10,3,2,89,meritumkredyt Pogoń Prudnik,Sezon 2016/2017
2016-11-11 17:30,Legia Warszawa(d),72 : 64W,72,18,32,56.3,8,23,34.8,26,55,47.3,12,14,85.7,8,17,25,21,20,15,13,6,3,1,83,meritumkredyt Pogoń Prudnik,Sezon 2016/2017
2016-11-16 18:00,KSK Noteć Inowrocław(w),68 : 78W,78,21,42,50.0,8,28,28.6,29,70,41.4,12,12,100.0,16,24,40,15,18,18,11,7,4,2,92,meritumkredyt Pogoń Prudnik,Sezon 2016/2017
2016-11-20 17:30,SKK Siedlce(d),78 : 65W,78,24,38,63.2,7,22,31.8,31,60,51.7,9,9,100.0,2,29,31,18,18,15,13,6,0,0,91,meritumkredyt Pogoń Prudnik,Sezon 2016/2017
2016-11-26 18:00,Spójnia Stargard(w),91 : 82P,82,22,36,61.1,11,24,45.8,33,60,55.0,5,5,100.0,6,23,29,21,12,14,18,8,1,1,96,meritumkredyt Pogoń Prudnik,Sezon 2016/2017
2016-12-03 17:30,Kotwica Kołobrzeg(d),79 : 57W,79,22,40,55.0,8,26,30.8,30,66,45.5,11,12,91.7,10,27,37,16,16,15,9,12,3,2,101,meritumkredyt Pogoń Prudnik,Sezon 2016/2017
2016-12-10 17:30,Max Elektro Sokół Łańcut(w),82 : 62P,62,13,34,38.2,9,21,42.9,22,55,40.0,9,15,60.0,3,21,24,12,19,17,14,2,3,1,50,meritumkredyt Pogoń Prudnik,Sezon 2016/2017
2016-12-17 17:30,Jamalex Polonia 1912 Leszno(d),82 : 74W,82,18,30,60.0,11,28,39.3,29,58,50.0,13,15,86.7,3,29,32,23,17,19,22,7,6,2,97,meritumkredyt Pogoń Prudnik,Sezon 2016/2017
2017-01-07 17:00,ACK UTH Rosa Radom(w),53 : 76W,76,24,42,57.1,6,22,27.3,30,64,46.9,10,16,62.5,6,28,34,17,18,16,7,8,5,1,93,meritumkredyt Pogoń Prudnik,Sezon 2016/2017
2017-01-14 17:30,MKS Znicz Basket Pruszków(d),95 : 84W,95,20,35,57.1,9,20,45.0,29,55,52.7,28,30,93.3,8,19,27,19,24,23,14,9,3,0,111,meritumkredyt Pogoń Prudnik,Sezon 2016/2017
2017-01-21 18:00,GTK Gliwice(w),102 : 71P,71,22,38,57.9,5,17,29.4,27,55,49.1,12,16,75.0,6,19,25,12,14,24,15,0,2,1,63,meritumkredyt Pogoń Prudnik,Sezon 2016/2017
2017-01-28 17:30,GKS Tychy(d),73 : 81P,73,20,39,51.3,6,20,30.0,26,59,44.1,15,17,88.2,3,25,28,15,18,18,15,6,4,1,76,meritumkredyt Pogoń Prudnik,Sezon 2016/2017
2017-02-01 19:30,Zetkama Doral Nysa Kłodzko(w),100 : 83P,83,22,35,62.9,10,22,45.5,32,57,56.1,9,12,75.0,2,16,18,21,14,17,19,6,2,2,83,meritumkredyt Pogoń Prudnik,Sezon 2016/2017
2017-02-05 17:30,AZS AGH Kraków(d),81 : 72W,81,26,49,53.1,5,16,31.3,31,65,47.7,14,20,70.0,9,27,36,18,20,22,14,10,5,2,96,meritumkredyt Pogoń Prudnik,Sezon 2016/2017
2017-02-15 20:00,Biofarm Basket Poznań(w),62 : 65W,65,19,33,57.6,5,25,20.0,24,58,41.4,12,14,85.7,6,26,32,12,15,18,11,4,4,3,70,meritumkredyt Pogoń Prudnik,Sezon 2016/2017
2017-02-19 17:30,Enea Astoria Bydgoszcz(d),80 : 86P,80,18,52,34.6,8,23,34.8,26,75,34.7,20,24,83.3,17,29,46,15,23,23,20,8,6,1,82,meritumkredyt Pogoń Prudnik,Sezon 2016/2017
2017-02-25 17:00,Legia Warszawa(w),85 : 75P,75,16,37,43.2,10,23,43.5,26,60,43.3,13,18,72.2,4,21,25,13,19,18,13,8,4,0,73,meritumkredyt Pogoń Prudnik,Sezon 2016/2017
2017-03-01 18:30,KSK Noteć Inowrocław(d),69 : 75P,69,21,43,48.8,6,22,27.3,27,65,41.5,9,12,75.0,10,16,26,18,20,22,9,5,3,3,71,meritumkredyt Pogoń Prudnik,Sezon 2016/2017
2017-03-05 17:00,SKK Siedlce(w),83 : 60P,60,17,42,40.5,6,27,22.2,23,69,33.3,8,11,72.7,15,25,40,11,21,21,15,4,1,2,52,meritumkredyt Pogoń Prudnik,Sezon 2016/2017
2017-03-11 17:30,Spójnia Stargard(d),79 : 54W,79,25,35,71.4,7,23,30.4,32,58,55.2,8,12,66.7,6,32,38,21,14,13,13,7,1,1,103,meritumkredyt Pogoń Prudnik,Sezon 2016/2017
2017-03-18 18:00,Kotwica Kołobrzeg(w),81 : 71P,71,19,38,50.0,5,25,20.0,24,63,38.1,18,25,72.0,11,24,35,14,23,23,13,4,5,6,70,meritumkredyt Pogoń Prudnik,Sezon 2016/2017
2017-03-25 17:30,Max Elektro Sokół Łańcut(d),81 : 77W,81,20,36,55.6,6,20,30.0,26,56,46.4,23,27,85.2,5,21,26,12,20,30,10,7,0,0,82,meritumkredyt Pogoń Prudnik,Sezon 2016/2017
2017-04-02 18:00,Jamalex Polonia 1912 Leszno(w),72 : 69P,69,19,29,65.5,9,29,31.0,28,58,48.3,4,9,44.4,8,23,31,13,16,20,16,6,1,0,69,meritumkredyt Pogoń Prudnik,Sezon 2016/2017
2017-04-08 17:30,Max Elektro Sokół Łańcut(w),87 : 81P,81,17,34,50.0,12,25,48.0,29,59,49.2,11,13,84.6,7,21,28,16,21,17,16,5,2,2,84,meritumkredyt Pogoń Prudnik,Sezon 2016/2017
2017-04-09 17:30,Max Elektro Sokół Łańcut(w),105 : 77P,77,22,43,51.2,7,30,23.3,29,73,39.7,12,19,63.2,14,20,34,15,18,18,11,6,2,1,72,meritumkredyt Pogoń Prudnik,Sezon 2016/2017
2017-04-22 17:30,Max Elektro Sokół Łańcut(d),59 : 73P,59,13,34,38.2,10,35,28.6,23,69,33.3,3,5,60.0,6,22,28,12,16,14,9,7,3,2,52,meritumkredyt Pogoń Prudnik,Sezon 2016/2017
2016-09-25 17:00,Max Elektro Sokół Łańcut(d),71 : 80P,71,16,36,44.4,7,27,25.9,23,63,36.5,18,35,51.4,9,27,36,12,23,28,14,7,0,0,55,MKS Znicz Basket Pruszków,Sezon 2016/2017
2016-10-02 17:00,meritumkredyt Pogoń Prudnik(d),66 : 77P,66,19,35,54.3,5,18,27.8,24,53,45.3,13,23,56.5,12,26,38,12,15,22,18,5,2,1,66,MKS Znicz Basket Pruszków,Sezon 2016/2017
2016-10-09 17:00,ACK UTH Rosa Radom(w),57 : 67W,67,22,41,53.7,6,22,27.3,28,63,44.4,5,11,45.5,11,26,37,15,17,19,14,6,1,1,71,MKS Znicz Basket Pruszków,Sezon 2016/2017
2016-10-15 17:00,Jamalex Polonia 1912 Leszno(w),79 : 77P,77,20,36,55.6,7,17,41.2,27,53,50.9,16,24,66.7,5,25,30,10,17,26,16,8,3,2,78,MKS Znicz Basket Pruszków,Sezon 2016/2017
2016-10-19 18:00,GTK Gliwice(w),85 : 64P,64,19,36,52.8,2,15,13.3,21,51,41.2,20,29,69.0,9,16,25,11,21,28,14,6,0,0,53,MKS Znicz Basket Pruszków,Sezon 2016/2017
2016-10-22 19:00,GKS Tychy(w),74 : 73P,73,19,38,50.0,5,25,20.0,24,63,38.1,20,24,83.3,7,23,30,17,18,23,8,12,1,8,82,MKS Znicz Basket Pruszków,Sezon 2016/2017
2016-10-30 17:00,Zetkama Doral Nysa Kłodzko(d),77 : 69W,77,24,36,66.7,6,25,24.0,30,61,49.2,11,15,73.3,11,22,33,14,17,22,18,7,2,5,80,MKS Znicz Basket Pruszków,Sezon 2016/2017
2016-11-06 17:00,AZS AGH Kraków(d),73 : 86P,73,22,40,55.0,6,21,28.6,28,61,45.9,11,18,61.1,13,22,35,13,22,19,18,7,5,3,75,MKS Znicz Basket Pruszków,Sezon 2016/2017
2016-11-12 18:00,Biofarm Basket Poznań(d),61 : 63P,61,20,36,55.6,4,26,15.4,24,62,38.7,9,16,56.3,15,21,36,10,14,18,14,7,1,3,56,MKS Znicz Basket Pruszków,Sezon 2016/2017
2016-11-16 19:00,Enea Astoria Bydgoszcz(w),56 : 105W,105,17,26,65.4,15,29,51.7,32,55,58.2,26,30,86.7,4,35,39,27,20,25,15,6,4,3,139,MKS Znicz Basket Pruszków,Sezon 2016/2017
2016-11-19 18:00,Legia Warszawa(d),59 : 79P,59,20,38,52.6,5,23,21.7,25,61,41.0,4,8,50.0,13,21,34,14,17,14,14,4,4,0,61,MKS Znicz Basket Pruszków,Sezon 2016/2017
2016-11-26 18:00,KSK Noteć Inowrocław(w),75 : 87W,87,19,39,48.7,15,40,37.5,34,79,43.0,4,7,57.1,13,27,40,19,17,15,7,6,2,2,99,MKS Znicz Basket Pruszków,Sezon 2016/2017
2016-12-03 18:00,SKK Siedlce(d),88 : 68W,88,21,35,60.0,9,25,36.0,30,60,50.0,19,24,79.2,12,26,38,18,17,21,12,7,2,3,106,MKS Znicz Basket Pruszków,Sezon 2016/2017
2016-12-11 17:00,Spójnia Stargard(w),85 : 78P,78,24,43,55.8,6,23,26.1,30,66,45.5,12,13,92.3,12,21,33,16,20,14,19,12,1,7,84,MKS Znicz Basket Pruszków,Sezon 2016/2017
2016-12-17 18:00,Kotwica Kołobrzeg(d),80 : 75W,80,19,37,51.4,9,26,34.6,28,63,44.4,15,23,65.2,8,29,37,17,23,22,14,8,5,2,90,MKS Znicz Basket Pruszków,Sezon 2016/2017
2017-01-07 17:30,Max Elektro Sokół Łańcut(w),84 : 66P,66,13,36,36.1,8,21,38.1,21,57,36.8,16,25,64.0,14,16,30,13,18,22,19,10,3,5,58,MKS Znicz Basket Pruszków,Sezon 2016/2017
2017-01-14 17:30,meritumkredyt Pogoń Prudnik(w),95 : 84P,84,14,29,48.3,12,28,42.9,26,57,45.6,20,25,80.0,8,17,25,15,23,24,18,10,0,3,80,MKS Znicz Basket Pruszków,Sezon 2016/2017
2017-01-22 14:00,ACK UTH Rosa Radom(d),81 : 78W,81,17,30,56.7,11,25,44.0,28,55,50.9,14,18,77.8,9,20,29,19,18,20,16,8,1,2,91,MKS Znicz Basket Pruszków,Sezon 2016/2017
2017-01-28 18:00,Jamalex Polonia 1912 Leszno(d),56 : 67P,56,13,28,46.4,3,27,11.1,16,55,29.1,21,27,77.8,12,22,34,9,26,27,19,6,4,2,45,MKS Znicz Basket Pruszków,Sezon 2016/2017
2017-02-01 19:00,GTK Gliwice(d),74 : 72W,74,17,31,54.8,10,20,50.0,27,51,52.9,10,14,71.4,6,29,35,18,15,17,21,6,3,4,87,MKS Znicz Basket Pruszków,Sezon 2016/2017
2017-02-05 17:00,GKS Tychy(d),68 : 79P,68,21,40,52.5,6,26,23.1,27,66,40.9,8,9,88.9,8,20,28,11,18,15,8,5,3,1,67,MKS Znicz Basket Pruszków,Sezon 2016/2017
2017-02-11 17:00,Zetkama Doral Nysa Kłodzko(w),89 : 62P,62,16,32,50.0,3,23,13.0,19,55,34.5,21,24,87.5,8,20,28,11,19,22,20,6,2,1,50,MKS Znicz Basket Pruszków,Sezon 2016/2017
2017-02-18 18:00,AZS AGH Kraków(w),63 : 84W,84,24,42,57.1,6,17,35.3,30,59,50.8,18,25,72.0,17,23,40,21,19,26,18,9,3,2,103,MKS Znicz Basket Pruszków,Sezon 2016/2017
2017-03-01 19:00,Enea Astoria Bydgoszcz(d),76 : 78P,76,22,38,57.9,5,25,20.0,27,63,42.9,17,24,70.8,19,20,39,15,22,22,18,2,6,2,77,MKS Znicz Basket Pruszków,Sezon 2016/2017
2017-03-04 17:00,Legia Warszawa(w),74 : 65P,65,20,38,52.6,5,22,22.7,25,60,41.7,10,13,76.9,9,19,28,11,24,16,15,10,2,3,63,MKS Znicz Basket Pruszków,Sezon 2016/2017
2017-03-08 20:00,Biofarm Basket Poznań(w),66 : 58P,58,16,44,36.4,5,19,26.3,21,63,33.3,11,12,91.7,10,24,34,13,21,18,14,6,2,8,56,MKS Znicz Basket Pruszków,Sezon 2016/2017
2017-03-11 18:00,KSK Noteć Inowrocław(d),89 : 66W,89,24,36,66.7,11,24,45.8,35,60,58.3,8,12,66.7,5,28,33,22,21,15,19,11,0,0,107,MKS Znicz Basket Pruszków,Sezon 2016/2017
2017-03-19 14:00,SKK Siedlce(w),75 : 89W,89,26,44,59.1,4,24,16.7,30,68,44.1,25,30,83.3,13,30,43,16,21,25,17,12,1,3,101,MKS Znicz Basket Pruszków,Sezon 2016/2017
2017-03-25 18:00,Spójnia Stargard(d),87 : 83W,87,26,43,60.5,7,21,33.3,33,64,51.6,14,20,70.0,9,23,32,20,19,19,17,4,6,3,95,MKS Znicz Basket Pruszków,Sezon 2016/2017
2017-04-02 18:00,Kotwica Kołobrzeg(w),51 : 71W,71,21,45,46.7,5,19,26.3,26,64,40.6,14,26,53.8,16,32,48,16,20,21,14,12,2,2,85,MKS Znicz Basket Pruszków,Sezon 2016/2017
2016-09-24 18:00,Zetkama Doral Nysa Kłodzko(d),65 : 61W,65,13,34,38.2,8,24,33.3,21,58,36.2,15,25,60.0,12,21,33,12,17,21,13,8,3,3,61,SKK Siedlce,Sezon 2016/2017
2016-10-02 19:00,AZS AGH Kraków(w),75 : 60P,60,20,44,45.5,3,17,17.6,23,61,37.7,11,20,55.0,10,19,29,16,23,19,17,9,5,5,55,SKK Siedlce,Sezon 2016/2017
2016-10-08 19:30,Biofarm Basket Poznań(d),84 : 77W,84,19,35,54.3,10,22,45.5,29,57,50.9,16,18,88.9,1,14,15,19,24,18,18,13,3,1,86,SKK Siedlce,Sezon 2016/2017
2016-10-13 20:00,Enea Astoria Bydgoszcz(d),72 : 61W,72,13,33,39.4,9,23,39.1,22,56,39.3,19,24,79.2,8,26,34,14,18,24,14,7,2,1,76,SKK Siedlce,Sezon 2016/2017
2016-10-19 20:00,Legia Warszawa(d),62 : 80P,62,20,42,47.6,5,19,26.3,25,61,41.0,7,8,87.5,10,20,30,10,22,15,17,2,3,6,53,SKK Siedlce,Sezon 2016/2017
2016-10-23 18:00,KSK Noteć Inowrocław(w),79 : 60P,60,8,30,26.7,12,29,41.4,20,59,33.9,8,10,80.0,9,22,31,16,23,12,15,7,2,1,60,SKK Siedlce,Sezon 2016/2017
2016-10-29 20:00,Jamalex Polonia 1912 Leszno(d),80 : 65W,80,21,34,61.8,9,26,34.6,30,60,50.0,11,19,57.9,5,25,30,15,27,27,16,4,4,0,79,SKK Siedlce,Sezon 2016/2017
2016-11-06 18:00,Spójnia Stargard(d),74 : 75P,74,23,41,56.1,8,24,33.3,31,65,47.7,4,7,57.1,5,21,26,13,13,13,15,9,0,1,70,SKK Siedlce,Sezon 2016/2017
2016-11-10 18:00,Kotwica Kołobrzeg(w),70 : 60P,60,18,30,60.0,6,27,22.2,24,57,42.1,6,8,75.0,8,27,35,8,19,14,22,7,0,0,53,SKK Siedlce,Sezon 2016/2017
2016-11-16 18:00,Max Elektro Sokół Łańcut(d),75 : 87P,75,15,33,45.5,11,27,40.7,26,60,43.3,12,18,66.7,9,19,28,17,21,15,14,7,1,1,74,SKK Siedlce,Sezon 2016/2017
2016-11-20 17:30,meritumkredyt Pogoń Prudnik(w),78 : 65P,65,25,41,61.0,2,24,8.3,27,65,41.5,9,13,69.2,8,24,32,13,16,18,12,4,1,0,61,SKK Siedlce,Sezon 2016/2017
2016-11-27 15:30,ACK UTH Rosa Radom(d),81 : 56W,81,18,32,56.3,11,27,40.7,29,59,49.2,12,14,85.7,9,27,36,23,23,18,18,9,1,0,100,SKK Siedlce,Sezon 2016/2017
2016-12-03 18:00,MKS Znicz Basket Pruszków(w),88 : 68P,68,19,35,54.3,8,28,28.6,27,63,42.9,6,13,46.2,9,18,27,18,22,16,14,7,3,2,66,SKK Siedlce,Sezon 2016/2017
2016-12-10 19:00,GTK Gliwice(d),85 : 80W,85,21,39,53.8,7,26,26.9,28,65,43.1,22,27,81.5,8,31,39,22,22,21,21,9,2,1,94,SKK Siedlce,Sezon 2016/2017
2016-12-18 19:00,GKS Tychy(w),90 : 49P,49,15,28,53.6,4,21,19.0,19,49,38.8,7,9,77.8,0,24,24,13,18,16,22,3,5,2,40,SKK Siedlce,Sezon 2016/2017
2017-01-07 17:00,Zetkama Doral Nysa Kłodzko(w),79 : 65P,65,8,27,29.6,9,33,27.3,17,60,28.3,22,29,75.9,9,18,27,14,23,24,11,8,3,5,56,SKK Siedlce,Sezon 2016/2017
2017-01-15 19:00,AZS AGH Kraków(d),84 : 71W,84,20,35,57.1,10,23,43.5,30,58,51.7,14,21,66.7,8,25,33,16,23,21,21,15,2,3,94,SKK Siedlce,Sezon 2016/2017
2017-01-21 17:30,Biofarm Basket Poznań(w),93 : 80P,80,20,44,45.5,10,26,38.5,30,70,42.9,10,13,76.9,4,15,19,14,26,19,12,5,1,1,64,SKK Siedlce,Sezon 2016/2017
2017-01-28 17:00,Enea Astoria Bydgoszcz(w),87 : 96W,96,19,33,57.6,14,37,37.8,33,70,47.1,16,22,72.7,10,24,34,20,22,22,13,11,7,1,112,SKK Siedlce,Sezon 2016/2017
2017-01-31 20:00,Legia Warszawa(w),92 : 82P,82,21,40,52.5,10,27,37.0,31,67,46.3,10,14,71.4,8,12,20,17,20,16,14,11,1,2,77,SKK Siedlce,Sezon 2016/2017
2017-02-04 18:00,KSK Noteć Inowrocław(d),94 : 87W,94,23,35,65.7,12,27,44.4,35,62,56.5,12,16,75.0,3,20,23,22,19,15,11,4,0,2,101,SKK Siedlce,Sezon 2016/2017
2017-02-11 17:00,Jamalex Polonia 1912 Leszno(w),83 : 67P,67,15,30,50.0,7,29,24.1,22,59,37.3,16,26,61.5,7,23,30,14,23,22,15,4,1,2,54,SKK Siedlce,Sezon 2016/2017
2017-02-18 18:00,Spójnia Stargard(w),104 : 70P,70,19,40,47.5,9,23,39.1,28,63,44.4,5,13,38.5,8,16,24,8,20,16,20,7,2,6,48,SKK Siedlce,Sezon 2016/2017
2017-02-26 13:30,Kotwica Kołobrzeg(d),87 : 70W,87,24,41,58.5,11,27,40.7,35,68,51.5,6,9,66.7,4,32,36,21,22,11,15,7,2,5,102,SKK Siedlce,Sezon 2016/2017
2017-03-01 18:00,Max Elektro Sokół Łańcut(w),73 : 61P,61,18,34,52.9,5,22,22.7,23,56,41.1,10,13,76.9,6,27,33,13,19,17,17,2,0,1,56,SKK Siedlce,Sezon 2016/2017
2017-03-05 17:00,meritumkredyt Pogoń Prudnik(d),83 : 60W,83,16,36,44.4,10,27,37.0,26,63,41.3,21,28,75.0,12,25,37,15,21,21,8,10,2,1,95,SKK Siedlce,Sezon 2016/2017
2017-03-11 18:00,ACK UTH Rosa Radom(w),83 : 61P,61,16,28,57.1,6,32,18.8,22,60,36.7,11,15,73.3,6,25,31,11,13,16,15,9,0,3,55,SKK Siedlce,Sezon 2016/2017
2017-03-19 14:00,MKS Znicz Basket Pruszków(d),75 : 89P,75,19,38,50.0,7,24,29.2,26,62,41.9,16,23,69.6,5,21,26,14,26,21,18,13,3,1,70,SKK Siedlce,Sezon 2016/2017
2017-03-25 18:00,GTK Gliwice(w),91 : 74P,74,13,34,38.2,10,23,43.5,23,57,40.4,18,24,75.0,0,25,25,9,16,21,17,5,0,0,56,SKK Siedlce,Sezon 2016/2017
2017-04-02 18:00,GKS Tychy(d),70 : 74P,70,18,39,46.2,6,24,25.0,24,63,38.1,16,20,80.0,7,27,34,15,17,19,15,5,0,3,66,SKK Siedlce,Sezon 2016/2017
2017-04-08 15:00,AZS AGH Kraków(d),69 : 68W,69,12,36,33.3,9,21,42.9,21,57,36.8,18,23,78.3,6,26,32,11,24,21,19,10,2,5,64,SKK Siedlce,Sezon 2016/2017
2017-04-09 19:00,AZS AGH Kraków(d),85 : 77W,85,21,39,53.8,7,14,50.0,28,53,52.8,22,30,73.3,8,28,36,15,21,23,16,6,1,1,94,SKK Siedlce,Sezon 2016/2017
2017-04-13 19:00,AZS AGH Kraków(w),70 : 63P,63,17,32,53.1,5,20,25.0,22,52,42.3,14,18,77.8,6,21,27,18,24,20,15,7,2,3,68,SKK Siedlce,Sezon 2016/2017
2017-04-14 19:00,AZS AGH Kraków(w),74 : 89W,89,31,49,63.3,5,18,27.8,36,67,53.7,12,15,80.0,11,30,41,21,24,19,14,5,3,3,111,SKK Siedlce,Sezon 2016/2017
2016-09-25 17:00,GKS Tychy(d),76 : 75W,76,21,40,52.5,7,19,36.8,28,59,47.5,13,16,81.3,8,26,34,13,15,18,15,4,3,1,81,Spójnia Stargard,Sezon 2016/2017
2016-10-01 17:00,Zetkama Doral Nysa Kłodzko(w),71 : 77W,77,17,38,44.7,11,25,44.0,28,63,44.4,10,11,90.9,12,19,31,11,16,16,10,7,0,0,80,Spójnia Stargard,Sezon 2016/2017
2016-10-08 18:00,AZS AGH Kraków(d),76 : 63W,76,17,32,53.1,9,23,39.1,26,55,47.3,15,20,75.0,7,34,41,21,17,22,17,4,4,0,95,Spójnia Stargard,Sezon 2016/2017
2016-10-16 17:00,Biofarm Basket Poznań(w),61 : 70W,70,20,38,52.6,5,16,31.3,25,54,46.3,15,17,88.2,7,28,35,14,14,20,15,5,7,1,85,Spójnia Stargard,Sezon 2016/2017
2016-10-19 18:00,Enea Astoria Bydgoszcz(d),87 : 77W,87,22,33,66.7,9,24,37.5,31,57,54.4,16,22,72.7,5,26,31,17,21,22,16,6,3,1,96,Spójnia Stargard,Sezon 2016/2017
2016-10-22 16:00,Legia Warszawa(w),66 : 83W,83,22,41,53.7,10,20,50.0,32,61,52.5,9,9,100.0,8,25,33,19,18,10,12,7,4,0,105,Spójnia Stargard,Sezon 2016/2017
2016-10-29 18:00,KSK Noteć Inowrocław(d),102 : 97W,102,25,41,61.0,13,32,40.6,38,73,52.1,13,17,76.5,4,31,35,22,20,19,19,9,1,0,111,Spójnia Stargard,Sezon 2016/2017
2016-11-06 18:00,SKK Siedlce(w),74 : 75W,75,24,47,51.1,6,19,31.6,30,66,45.5,9,16,56.3,13,28,41,18,13,13,19,9,1,0,82,Spójnia Stargard,Sezon 2016/2017
2016-11-12 18:00,Jamalex Polonia 1912 Leszno(d),79 : 70W,79,24,49,49.0,6,15,40.0,30,64,46.9,13,18,72.2,6,32,38,18,21,21,16,6,7,2,93,Spójnia Stargard,Sezon 2016/2017
2016-11-16 18:00,Kotwica Kołobrzeg(d),72 : 66W,72,21,43,48.8,7,21,33.3,28,64,43.8,9,13,69.2,10,27,37,14,13,18,14,9,1,0,79,Spójnia Stargard,Sezon 2016/2017
2016-11-19 17:30,Max Elektro Sokół Łańcut(w),73 : 70P,70,23,50,46.0,5,22,22.7,28,72,38.9,9,11,81.8,10,28,38,14,25,19,16,6,1,4,67,Spójnia Stargard,Sezon 2016/2017
2016-11-26 18:00,meritumkredyt Pogoń Prudnik(d),91 : 82W,91,26,45,57.8,11,23,47.8,37,68,54.4,6,12,50.0,7,19,26,19,14,12,12,14,1,1,102,Spójnia Stargard,Sezon 2016/2017
2016-12-03 15:00,ACK UTH Rosa Radom(w),91 : 81P,81,23,43,53.5,7,25,28.0,30,68,44.1,14,15,93.3,8,21,29,14,20,19,11,9,0,4,83,Spójnia Stargard,Sezon 2016/2017
2016-12-11 17:00,MKS Znicz Basket Pruszków(d),85 : 78W,85,17,34,50.0,11,24,45.8,28,58,48.3,18,23,78.3,8,22,30,18,14,19,17,9,7,1,97,Spójnia Stargard,Sezon 2016/2017
2016-12-17 18:00,GTK Gliwice(w),82 : 73P,73,18,35,51.4,7,19,36.8,25,54,46.3,16,22,72.7,5,17,22,12,16,22,16,7,0,0,63,Spójnia Stargard,Sezon 2016/2017
2017-01-07 19:00,GKS Tychy(w),79 : 71P,71,27,51,52.9,3,17,17.6,30,68,44.1,8,9,88.9,11,21,32,10,13,18,17,4,3,5,64,Spójnia Stargard,Sezon 2016/2017
2017-01-14 18:00,Zetkama Doral Nysa Kłodzko(d),70 : 46W,70,23,39,59.0,5,20,25.0,28,59,47.5,9,13,69.2,9,27,36,15,19,19,17,8,6,1,83,Spójnia Stargard,Sezon 2016/2017
2017-01-21 19:30,AZS AGH Kraków(w),72 : 83W,83,26,46,56.5,6,19,31.6,32,65,49.2,13,21,61.9,12,19,31,19,18,19,13,11,3,2,93,Spójnia Stargard,Sezon 2016/2017
2017-01-28 18:00,Biofarm Basket Poznań(d),62 : 71P,62,18,37,48.6,8,22,36.4,26,59,44.1,2,3,66.7,8,22,30,15,19,13,17,5,0,0,61,Spójnia Stargard,Sezon 2016/2017
2017-02-01 19:00,Enea Astoria Bydgoszcz(w),94 : 83P,83,19,42,45.2,9,25,36.0,28,67,41.8,18,24,75.0,11,20,31,19,18,24,10,5,1,2,84,Spójnia Stargard,Sezon 2016/2017
2017-02-04 18:00,Legia Warszawa(d),89 : 101P,89,24,48,50.0,12,22,54.5,36,70,51.4,5,11,45.5,13,21,34,24,22,18,11,1,3,2,100,Spójnia Stargard,Sezon 2016/2017
2017-02-12 18:00,KSK Noteć Inowrocław(w),65 : 92W,92,32,52,61.5,4,20,20.0,36,72,50.0,16,21,76.2,19,28,47,23,20,19,15,7,3,3,116,Spójnia Stargard,Sezon 2016/2017
2017-02-18 18:00,SKK Siedlce(d),104 : 70W,104,33,46,71.7,8,21,38.1,41,67,61.2,14,16,87.5,6,27,33,27,16,20,11,12,6,2,143,Spójnia Stargard,Sezon 2016/2017
2017-02-24 19:30,Jamalex Polonia 1912 Leszno(w),65 : 68W,68,13,27,48.1,7,24,29.2,20,51,39.2,21,27,77.8,6,26,32,10,26,25,22,7,1,2,59,Spójnia Stargard,Sezon 2016/2017
2017-03-01 19:00,Kotwica Kołobrzeg(w),74 : 64P,64,19,40,47.5,6,22,27.3,25,62,40.3,8,10,80.0,7,29,36,15,17,13,18,7,0,1,65,Spójnia Stargard,Sezon 2016/2017
2017-03-04 18:00,Max Elektro Sokół Łańcut(d),85 : 70W,85,19,31,61.3,15,30,50.0,34,61,55.7,2,8,25.0,9,31,40,22,22,13,16,8,3,0,109,Spójnia Stargard,Sezon 2016/2017
2017-03-11 17:30,meritumkredyt Pogoń Prudnik(w),79 : 54P,54,14,37,37.8,7,23,30.4,21,60,35.0,5,7,71.4,5,17,22,10,13,14,11,7,1,1,42,Spójnia Stargard,Sezon 2016/2017
2017-03-19 17:00,ACK UTH Rosa Radom(d),98 : 72W,98,25,48,52.1,13,25,52.0,38,73,52.1,9,15,60.0,14,23,37,24,23,13,14,12,4,2,120,Spójnia Stargard,Sezon 2016/2017
2017-03-25 18:00,MKS Znicz Basket Pruszków(w),87 : 83P,83,22,45,48.9,8,22,36.4,30,67,44.8,15,17,88.2,9,21,30,19,19,19,15,9,3,6,90,Spójnia Stargard,Sezon 2016/2017
2017-04-02 18:00,GTK Gliwice(d),57 : 84P,57,17,41,41.5,3,12,25.0,20,53,37.7,14,18,77.8,10,22,32,4,19,19,22,6,2,0,42,Spójnia Stargard,Sezon 2016/2017
2017-04-08 18:00,GKS Tychy(w),82 : 87W,87,24,35,68.6,6,28,21.4,30,63,47.6,21,22,95.5,10,24,34,15,23,23,15,6,3,1,96,Spójnia Stargard,Sezon 2016/2017
2017-04-09 19:00,GKS Tychy(w),99 : 51P,51,16,38,42.1,3,23,13.0,19,61,31.1,10,15,66.7,8,16,24,6,15,15,18,6,2,3,24,Spójnia Stargard,Sezon 2016/2017
2017-04-22 18:00,GKS Tychy(d),84 : 72W,84,24,41,58.5,9,31,29.0,33,72,45.8,9,13,69.2,12,27,39,18,25,19,16,5,3,1,90,Spójnia Stargard,Sezon 2016/2017
2017-04-23 17:00,GKS Tychy(d),87 : 83W,87,27,47,57.4,7,26,26.9,34,73,46.6,12,21,57.1,9,21,30,16,20,23,3,8,3,3,93,Spójnia Stargard,Sezon 2016/2017
2017-04-28 20:00,Legia Warszawa(w),85 : 75P,75,22,52,42.3,5,21,23.8,27,73,37.0,16,24,66.7,12,19,31,6,22,22,10,12,0,4,60,Spójnia Stargard,Sezon 2016/2017
2017-04-29 18:00,Legia Warszawa(w),104 : 80P,80,27,56,48.2,4,16,25.0,31,72,43.1,14,18,77.8,13,18,31,11,21,15,18,5,0,6,64,Spójnia Stargard,Sezon 2016/2017
2017-05-06 18:30,Legia Warszawa(d),82 : 88P,82,24,49,49.0,5,19,26.3,29,68,42.6,19,22,86.4,9,19,28,15,21,20,10,10,0,5,83,Spójnia Stargard,Sezon 2016/2017
2017-05-13 20:00,Max Elektro Sokół Łańcut(d),96 : 76W,96,31,46,67.4,9,24,37.5,40,70,57.1,7,8,87.5,9,28,37,22,20,15,18,11,4,1,121,Spójnia Stargard,Sezon 2016/2017
2017-05-20 17:30,Max Elektro Sokół Łańcut(w),89 : 76P,76,22,42,52.4,5,16,31.3,27,58,46.6,17,23,73.9,4,25,29,14,24,24,12,7,1,2,78,Spójnia Stargard,Sezon 2016/2017
2016-09-24 18:00,SKK Siedlce(w),65 : 61P,61,19,46,41.3,7,20,35.0,26,66,39.4,2,4,50.0,17,23,40,10,22,17,16,9,3,3,65,Zetkama Doral Nysa Kłodzko,Sezon 2016/2017
2016-10-01 17:00,Spójnia Stargard(d),71 : 77P,71,28,44,63.6,3,20,15.0,31,64,48.4,6,11,54.5,10,24,34,12,16,16,9,7,0,0,77,Zetkama Doral Nysa Kłodzko,Sezon 2016/2017
2016-10-08 18:00,Kotwica Kołobrzeg(w),75 : 54P,54,17,44,38.6,3,12,25.0,20,56,35.7,11,16,68.8,13,26,39,12,22,22,14,4,2,5,56,Zetkama Doral Nysa Kłodzko,Sezon 2016/2017
2016-10-15 17:00,Max Elektro Sokół Łańcut(d),73 : 90P,73,23,48,47.9,6,21,28.6,29,69,42.0,9,14,64.3,14,18,32,19,23,17,15,6,1,2,71,Zetkama Doral Nysa Kłodzko,Sezon 2016/2017
2016-10-19 18:30,meritumkredyt Pogoń Prudnik(w),96 : 70P,70,19,37,51.4,6,17,35.3,25,54,46.3,14,17,82.4,7,19,26,18,16,14,16,6,5,3,77,Zetkama Doral Nysa Kłodzko,Sezon 2016/2017
2016-10-22 17:00,ACK UTH Rosa Radom(d),66 : 60W,66,22,39,56.4,6,22,27.3,28,61,45.9,4,7,57.1,8,14,22,20,19,16,13,10,5,1,74,Zetkama Doral Nysa Kłodzko,Sezon 2016/2017
2016-10-30 17:00,MKS Znicz Basket Pruszków(w),77 : 69P,69,16,34,47.1,10,22,45.5,26,56,46.4,7,10,70.0,3,14,17,10,22,17,13,10,5,2,65,Zetkama Doral Nysa Kłodzko,Sezon 2016/2017
2016-11-05 17:00,GTK Gliwice(d),57 : 72P,57,23,36,63.9,1,7,14.3,24,43,55.8,8,12,66.7,4,20,24,12,19,17,16,5,4,1,63,Zetkama Doral Nysa Kłodzko,Sezon 2016/2017
2016-11-12 18:00,GKS Tychy(w),86 : 74P,74,24,38,63.2,4,17,23.5,28,55,50.9,14,18,77.8,8,24,32,21,20,16,16,4,4,0,88,Zetkama Doral Nysa Kłodzko,Sezon 2016/2017
2016-11-16 19:30,Jamalex Polonia 1912 Leszno(w),64 : 57P,57,18,48,37.5,3,11,27.3,21,59,35.6,12,20,60.0,10,19,29,9,19,19,14,11,2,3,48,Zetkama Doral Nysa Kłodzko,Sezon 2016/2017
2016-11-19 17:00,AZS AGH Kraków(d),64 : 84P,64,20,46,43.5,4,14,28.6,24,60,40.0,12,13,92.3,9,19,28,18,21,19,12,3,3,1,67,Zetkama Doral Nysa Kłodzko,Sezon 2016/2017
2016-11-26 15:45,Biofarm Basket Poznań(w),73 : 60P,60,18,37,48.6,5,15,33.3,23,52,44.2,9,12,75.0,9,16,25,15,19,15,17,3,4,3,58,Zetkama Doral Nysa Kłodzko,Sezon 2016/2017
2016-12-03 17:00,Enea Astoria Bydgoszcz(d),55 : 75P,55,17,34,50.0,4,22,18.2,21,56,37.5,9,19,47.4,4,19,23,14,24,22,15,6,3,0,41,Zetkama Doral Nysa Kłodzko,Sezon 2016/2017
2016-12-10 17:00,Legia Warszawa(d),69 : 87P,69,26,40,65.0,2,10,20.0,28,50,56.0,11,16,68.8,4,22,26,20,24,15,21,6,2,1,75,Zetkama Doral Nysa Kłodzko,Sezon 2016/2017
2016-12-17 17:00,KSK Noteć Inowrocław(d),65 : 71P,65,20,44,45.5,6,21,28.6,26,65,40.0,7,10,70.0,10,29,39,19,21,16,13,5,3,1,76,Zetkama Doral Nysa Kłodzko,Sezon 2016/2017
2017-01-07 17:00,SKK Siedlce(d),79 : 65W,79,23,49,46.9,7,16,43.8,30,65,46.2,12,20,60.0,13,31,44,21,24,23,14,2,5,3,94,Zetkama Doral Nysa Kłodzko,Sezon 2016/2017
2017-01-14 18:00,Spójnia Stargard(w),70 : 46P,46,12,29,41.4,5,27,18.5,17,56,30.4,7,12,58.3,6,20,26,6,20,19,18,4,1,6,21,Zetkama Doral Nysa Kłodzko,Sezon 2016/2017
2017-01-21 17:00,Kotwica Kołobrzeg(d),99 : 65W,99,22,37,59.5,14,32,43.8,36,69,52.2,13,16,81.3,9,37,46,30,29,18,8,5,1,0,137,Zetkama Doral Nysa Kłodzko,Sezon 2016/2017
2017-01-28 17:30,Max Elektro Sokół Łańcut(w),83 : 57P,57,18,42,42.9,4,23,17.4,22,65,33.8,9,12,75.0,11,32,43,9,22,18,16,3,4,2,54,Zetkama Doral Nysa Kłodzko,Sezon 2016/2017
2017-02-01 19:30,meritumkredyt Pogoń Prudnik(d),100 : 83W,100,29,54,53.7,12,24,50.0,41,78,52.6,6,10,60.0,16,19,35,29,17,14,12,8,2,2,121,Zetkama Doral Nysa Kłodzko,Sezon 2016/2017
2017-02-04 18:00,ACK UTH Rosa Radom(w),79 : 58P,58,23,44,52.3,3,27,11.1,26,71,36.6,3,8,37.5,11,25,36,18,16,16,17,10,2,4,57,Zetkama Doral Nysa Kłodzko,Sezon 2016/2017
2017-02-11 17:00,MKS Znicz Basket Pruszków(d),89 : 62W,89,24,38,63.2,10,26,38.5,34,64,53.1,11,11,100.0,7,24,31,26,22,19,15,10,1,2,112,Zetkama Doral Nysa Kłodzko,Sezon 2016/2017
2017-02-18 18:00,GTK Gliwice(w),67 : 60P,60,14,39,35.9,10,26,38.5,24,65,36.9,2,4,50.0,12,23,35,8,17,14,16,6,4,1,54,Zetkama Doral Nysa Kłodzko,Sezon 2016/2017
2017-02-25 17:00,GKS Tychy(d),76 : 78P,76,11,28,39.3,11,31,35.5,22,59,37.3,21,30,70.0,3,22,25,20,24,22,6,7,3,2,79,Zetkama Doral Nysa Kłodzko,Sezon 2016/2017
2017-03-01 19:30,Jamalex Polonia 1912 Leszno(d),94 : 91W,94,21,33,63.6,12,26,46.2,33,59,55.9,16,25,64.0,3,19,22,30,21,25,10,4,3,3,108,Zetkama Doral Nysa Kłodzko,Sezon 2016/2017
2017-03-04 19:30,AZS AGH Kraków(w),67 : 61P,61,14,39,35.9,7,20,35.0,21,59,35.6,12,16,75.0,5,22,27,17,20,23,16,8,2,3,57,Zetkama Doral Nysa Kłodzko,Sezon 2016/2017
2017-03-11 17:00,Biofarm Basket Poznań(d),66 : 71P,66,14,37,37.8,12,32,37.5,26,69,37.7,2,4,50.0,10,19,29,20,16,16,8,6,1,2,69,Zetkama Doral Nysa Kłodzko,Sezon 2016/2017
2017-03-20 17:30,Enea Astoria Bydgoszcz(w),89 : 100W,100,24,45,53.3,11,31,35.5,35,76,46.1,19,24,79.2,12,23,35,26,32,23,7,6,3,1,117,Zetkama Doral Nysa Kłodzko,Sezon 2016/2017
2017-03-25 15:00,Legia Warszawa(w),91 : 54P,54,19,44,43.2,2,22,9.1,21,66,31.8,10,14,71.4,5,19,24,9,28,17,14,7,3,1,34,Zetkama Doral Nysa Kłodzko,Sezon 2016/2017
2017-04-02 18:00,KSK Noteć Inowrocław(w),68 : 78W,78,20,41,48.8,8,22,36.4,28,63,44.4,14,17,82.4,14,29,43,13,24,22,14,7,2,2,91,Zetkama Doral Nysa Kłodzko,Sezon 2016/2017
2017-04-08 18:00,KSK Noteć Inowrocław(w),74 : 78W,78,13,42,31.0,10,25,40.0,23,67,34.3,22,25,88.0,9,22,31,11,22,24,12,12,3,1,76,Zetkama Doral Nysa Kłodzko,Sezon 2016/2017
2017-04-09 18:00,KSK Noteć Inowrocław(w),72 : 79W,79,22,41,53.7,7,15,46.7,29,56,51.8,14,18,77.8,6,31,37,13,27,19,16,6,0,2,88,Zetkama Doral Nysa Kłodzko,Sezon 2016/2017
2017-04-22 17:00,KSK Noteć Inowrocław(d),86 : 89P,86,24,40,60.0,10,28,35.7,34,68,50.0,8,13,61.5,5,24,29,24,20,19,10,11,2,3,103,Zetkama Doral Nysa Kłodzko,Sezon 2016/2017
2017-04-23 17:00,KSK Noteć Inowrocław(d),93 : 79W,93,23,40,57.5,10,23,43.5,33,63,52.4,17,20,85.0,7,27,34,21,24,28,12,6,4,3,113,Zetkama Doral Nysa Kłodzko,Sezon 2016/2017
2015-09-27 17:00,KS Spójnia Stargard(d),76 : 58W,76,20,37,54.1,7,27,25.9,27,64,42.2,15,21,71.4,16,25,41,13,21,21,15,9,5,3,86,ACK UTH Rosa Radom,Sezon 2015/2016
2015-10-03 17:30,Max Elektro Sokół Łańcut(w),82 : 48P,48,13,38,34.2,4,21,19.0,17,59,28.8,10,18,55.6,8,21,29,10,16,17,14,7,2,6,32,ACK UTH Rosa Radom,Sezon 2015/2016
2015-10-11 18:00,KSK Noteć Inowrocław(d),71 : 65W,71,20,36,55.6,6,22,27.3,26,58,44.8,13,19,68.4,9,30,39,14,23,19,20,8,1,1,75,ACK UTH Rosa Radom,Sezon 2015/2016
2015-10-17 18:00,GTK Gliwice(w),76 : 84W,84,18,38,47.4,12,28,42.9,30,66,45.5,12,19,63.2,8,27,35,16,17,24,8,7,0,1,91,ACK UTH Rosa Radom,Sezon 2015/2016
2015-10-21 16:00,SKK Siedlce(d),63 : 71P,63,16,36,44.4,6,29,20.7,22,65,33.8,13,24,54.2,15,22,37,11,18,23,12,12,2,0,59,ACK UTH Rosa Radom,Sezon 2015/2016
2015-10-25 17:00,meritumkredyt Pogoń Prudnik(d),71 : 78P,71,20,41,48.8,5,18,27.8,25,59,42.4,16,18,88.9,12,22,34,12,20,20,13,4,4,4,76,ACK UTH Rosa Radom,Sezon 2015/2016
2015-10-31 19:00,Astoria Bydgoszcz(w),63 : 73W,73,22,39,56.4,7,19,36.8,29,58,50.0,8,11,72.7,6,24,30,15,28,18,18,11,5,2,84,ACK UTH Rosa Radom,Sezon 2015/2016
2015-11-08 17:00,Zetkama Doral Nysa Kłodzko(d),61 : 54W,61,13,34,38.2,7,31,22.6,20,65,30.8,14,17,82.4,16,19,35,15,21,21,13,15,0,7,65,ACK UTH Rosa Radom,Sezon 2015/2016
2015-11-11 15:45,Biofarm Basket Poznań(w),58 : 64W,64,14,31,45.2,9,17,52.9,23,48,47.9,9,19,47.4,9,21,30,15,16,24,20,9,2,1,65,ACK UTH Rosa Radom,Sezon 2015/2016
2015-11-14 15:00,Legia Warszawa(d),69 : 95P,69,19,44,43.2,7,25,28.0,26,69,37.7,10,14,71.4,11,13,24,14,26,13,9,9,2,0,62,ACK UTH Rosa Radom,Sezon 2015/2016
2015-11-22 18:00,AZS AWF Mickiewicz Romus Katowice(w),65 : 67W,67,21,39,53.8,4,21,19.0,25,60,41.7,13,18,72.2,7,17,24,16,18,20,13,13,0,4,67,ACK UTH Rosa Radom,Sezon 2015/2016
2015-11-29 17:00,GKS Tychy(d),59 : 83P,59,16,33,48.5,6,23,26.1,22,56,39.3,9,14,64.3,10,17,27,15,17,18,13,4,0,3,53,ACK UTH Rosa Radom,Sezon 2015/2016
2015-12-06 14:00,Exact Systems Śląsk Wrocław(w),70 : 73W,73,22,39,56.4,5,22,22.7,27,61,44.3,14,22,63.6,7,22,29,9,20,22,16,11,5,3,69,ACK UTH Rosa Radom,Sezon 2015/2016
2015-12-12 15:00,Miasto Szkła Krosno(d),63 : 83P,63,18,33,54.5,6,22,27.3,24,55,43.6,9,16,56.3,9,19,28,9,16,19,13,5,0,3,54,ACK UTH Rosa Radom,Sezon 2015/2016
2015-12-20 17:00,MKS Znicz Basket Pruszków(w),76 : 69P,69,15,35,42.9,10,22,45.5,25,57,43.9,9,17,52.9,7,18,25,13,19,19,11,7,1,3,64,ACK UTH Rosa Radom,Sezon 2015/2016
2016-01-03 17:00,KS Spójnia Stargard(w),76 : 68P,68,19,39,48.7,7,22,31.8,26,61,42.6,9,18,50.0,11,20,31,13,15,18,13,8,1,3,64,ACK UTH Rosa Radom,Sezon 2015/2016
2016-01-09 16:00,Max Elektro Sokół Łańcut(d),58 : 69P,58,17,40,42.5,4,17,23.5,21,57,36.8,12,19,63.2,7,18,25,12,19,19,12,6,4,6,50,ACK UTH Rosa Radom,Sezon 2015/2016
2016-01-17 19:00,KSK Noteć Inowrocław(w),66 : 56P,56,9,35,25.7,10,31,32.3,19,66,28.8,8,15,53.3,15,31,46,11,19,17,17,8,3,9,53,ACK UTH Rosa Radom,Sezon 2015/2016
2016-01-23 16:00,GTK Gliwice(d),86 : 58W,86,20,47,42.6,11,25,44.0,31,72,43.1,13,17,76.5,18,24,42,15,19,18,14,17,1,3,102,ACK UTH Rosa Radom,Sezon 2015/2016
2016-01-27 19:00,SKK Siedlce(w),83 : 76P,76,23,35,65.7,8,24,33.3,31,59,52.5,6,10,60.0,8,21,29,14,20,15,10,5,2,1,84,ACK UTH Rosa Radom,Sezon 2015/2016
2016-01-30 17:30,meritumkredyt Pogoń Prudnik(w),68 : 58P,58,13,30,43.3,6,29,20.7,19,59,32.2,14,18,77.8,9,20,29,8,24,23,13,4,0,3,42,ACK UTH Rosa Radom,Sezon 2015/2016
2016-02-06 15:00,Astoria Bydgoszcz(d),80 : 86P,80,26,41,63.4,5,28,17.9,31,69,44.9,13,15,86.7,7,31,38,17,24,18,15,8,1,3,89,ACK UTH Rosa Radom,Sezon 2015/2016
2016-02-13 17:00,Zetkama Doral Nysa Kłodzko(w),79 : 75P,75,15,31,48.4,10,29,34.5,25,60,41.7,15,17,88.2,8,19,27,27,19,19,15,5,2,4,84,ACK UTH Rosa Radom,Sezon 2015/2016
2016-02-17 15:30,Biofarm Basket Poznań(d),72 : 66W,72,22,50,44.0,6,25,24.0,28,75,37.3,10,13,76.9,23,17,40,15,16,19,6,12,1,3,84,ACK UTH Rosa Radom,Sezon 2015/2016
2016-02-20 18:00,Legia Warszawa(w),87 : 78P,78,17,40,42.5,12,27,44.4,29,67,43.3,8,9,88.9,9,21,30,14,24,19,15,8,1,0,77,ACK UTH Rosa Radom,Sezon 2015/2016
2016-02-27 15:00,AZS AWF Mickiewicz Romus Katowice(d),93 : 71W,93,29,52,55.8,8,24,33.3,37,76,48.7,11,19,57.9,16,30,46,22,23,21,13,7,3,3,111,ACK UTH Rosa Radom,Sezon 2015/2016
2016-03-05 18:00,GKS Tychy(w),102 : 84P,84,23,41,56.1,7,19,36.8,30,60,50.0,17,30,56.7,11,17,28,16,21,25,18,7,4,3,78,ACK UTH Rosa Radom,Sezon 2015/2016
2016-03-13 16:00,Exact Systems Śląsk Wrocław(d),91 : 73W,91,31,50,62.0,6,22,27.3,37,72,51.4,11,19,57.9,11,18,29,13,17,20,8,16,1,2,99,ACK UTH Rosa Radom,Sezon 2015/2016
2016-03-20 17:00,Miasto Szkła Krosno(w),103 : 67P,67,14,32,43.8,12,29,41.4,26,61,42.6,3,6,50.0,7,17,24,10,20,15,13,2,2,1,54,ACK UTH Rosa Radom,Sezon 2015/2016
2016-04-03 18:00,MKS Znicz Basket Pruszków(d),73 : 78P,73,21,36,58.3,9,31,29.0,30,67,44.8,4,4,100.0,7,19,26,11,22,15,13,9,0,1,69,ACK UTH Rosa Radom,Sezon 2015/2016
2016-04-09 16:00,GTK Gliwice(d),82 : 80W,82,25,46,54.3,5,22,22.7,30,68,44.1,17,21,81.0,7,26,33,15,26,22,14,9,4,2,87,ACK UTH Rosa Radom,Sezon 2015/2016
2016-04-10 20:00,GTK Gliwice(d),92 : 88W,92,19,39,48.7,11,27,40.7,30,66,45.5,21,33,63.6,14,21,35,16,20,29,11,7,1,1,92,ACK UTH Rosa Radom,Sezon 2015/2016
2016-04-16 18:00,GTK Gliwice(w),78 : 71P,71,17,35,48.6,7,22,31.8,24,57,42.1,16,19,84.2,10,14,24,13,24,22,15,10,2,3,69,ACK UTH Rosa Radom,Sezon 2015/2016
2016-04-17 20:00,GTK Gliwice(w),83 : 61P,61,16,32,50.0,3,23,13.0,19,55,34.5,20,37,54.1,5,25,30,10,25,28,10,7,2,3,47,ACK UTH Rosa Radom,Sezon 2015/2016
2016-04-20 18:00,GTK Gliwice(d),77 : 45W,77,18,33,54.5,10,33,30.3,28,66,42.4,11,18,61.1,23,33,56,14,16,20,13,7,4,3,100,ACK UTH Rosa Radom,Sezon 2015/2016
2015-09-27 18:00,Miasto Szkła Krosno(w),74 : 54P,54,20,49,40.8,2,13,15.4,22,62,35.5,8,9,88.9,5,24,29,13,19,17,10,5,2,5,52,Astoria Bydgoszcz,Sezon 2015/2016
2015-10-03 19:00,MKS Znicz Basket Pruszków(w),73 : 71P,71,18,41,43.9,9,27,33.3,27,68,39.7,8,13,61.5,7,16,23,13,18,19,13,15,2,3,65,Astoria Bydgoszcz,Sezon 2015/2016
2015-10-10 19:00,KS Spójnia Stargard(d),76 : 67W,76,26,47,55.3,6,20,30.0,32,67,47.8,6,8,75.0,16,27,43,14,23,15,19,12,2,2,91,Astoria Bydgoszcz,Sezon 2015/2016
2015-10-17 17:30,Max Elektro Sokół Łańcut(w),79 : 50P,50,14,34,41.2,3,17,17.6,17,51,33.3,13,20,65.0,9,21,30,3,19,20,15,6,0,3,33,Astoria Bydgoszcz,Sezon 2015/2016
2015-10-21 19:30,KSK Noteć Inowrocław(d),78 : 58W,78,19,55,34.5,9,16,56.3,28,71,39.4,13,15,86.7,11,31,42,19,20,17,14,9,6,3,95,Astoria Bydgoszcz,Sezon 2015/2016
2015-10-24 18:00,GTK Gliwice(w),70 : 75W,75,19,40,47.5,9,23,39.1,28,63,44.4,10,15,66.7,9,26,35,20,20,17,10,7,0,2,87,Astoria Bydgoszcz,Sezon 2015/2016
2015-10-31 19:00,ACK UTH Rosa Radom(d),63 : 73P,63,15,31,48.4,5,24,20.8,20,55,36.4,18,33,54.5,14,22,36,13,18,28,18,10,2,5,56,Astoria Bydgoszcz,Sezon 2015/2016
2015-11-07 17:30,meritumkredyt Pogoń Prudnik(w),87 : 81P,81,28,45,62.2,3,23,13.0,31,68,45.6,16,19,84.2,12,20,32,17,24,22,14,13,1,2,90,Astoria Bydgoszcz,Sezon 2015/2016
2015-11-11 19:00,SKK Siedlce(d),78 : 65W,78,18,40,45.0,10,23,43.5,28,63,44.4,12,19,63.2,11,25,36,20,23,22,16,12,3,0,91,Astoria Bydgoszcz,Sezon 2015/2016
2015-11-14 19:00,Zetkama Doral Nysa Kłodzko(d),70 : 50W,70,23,41,56.1,3,19,15.8,26,60,43.3,15,31,48.4,10,26,36,19,19,28,10,9,3,1,77,Astoria Bydgoszcz,Sezon 2015/2016
2015-11-21 15:45,Biofarm Basket Poznań(w),62 : 71W,71,20,47,42.6,7,19,36.8,27,66,40.9,10,18,55.6,10,26,36,21,22,23,14,15,1,6,83,Astoria Bydgoszcz,Sezon 2015/2016
2015-12-02 19:00,Legia Warszawa(d),73 : 87P,73,24,46,52.2,3,22,13.6,27,68,39.7,16,26,61.5,15,18,33,13,26,25,18,10,2,4,62,Astoria Bydgoszcz,Sezon 2015/2016
2015-12-05 18:00,AZS AWF Mickiewicz Romus Katowice(w),86 : 79P,79,22,36,61.1,6,18,33.3,28,54,51.9,17,27,63.0,7,21,28,10,25,32,20,4,3,1,68,Astoria Bydgoszcz,Sezon 2015/2016
2015-12-12 19:00,GKS Tychy(d),69 : 71P,69,14,37,37.8,10,19,52.6,24,56,42.9,11,15,73.3,7,18,25,21,24,17,16,6,0,2,69,Astoria Bydgoszcz,Sezon 2015/2016
2015-12-19 17:30,Exact Systems Śląsk Wrocław(w),82 : 88W,88,21,35,60.0,10,18,55.6,31,53,58.5,16,23,69.6,6,24,30,15,24,25,15,7,3,3,99,Astoria Bydgoszcz,Sezon 2015/2016
2016-01-03 19:00,Miasto Szkła Krosno(d),71 : 114P,71,26,56,46.4,2,11,18.2,28,67,41.8,13,18,72.2,10,23,33,14,24,23,23,4,0,4,55,Astoria Bydgoszcz,Sezon 2015/2016
2016-01-09 19:00,MKS Znicz Basket Pruszków(d),91 : 88W,91,25,49,51.0,10,27,37.0,35,76,46.1,11,16,68.8,15,20,35,19,29,22,11,9,5,1,102,Astoria Bydgoszcz,Sezon 2015/2016
2016-01-13 18:00,KS Spójnia Stargard(w),68 : 75W,75,22,48,45.8,5,18,27.8,27,66,40.9,16,27,59.3,14,31,45,12,17,24,10,10,0,2,82,Astoria Bydgoszcz,Sezon 2015/2016
2016-01-23 19:00,Max Elektro Sokół Łańcut(d),63 : 71P,63,17,40,42.5,5,16,31.3,22,56,39.3,14,20,70.0,7,26,33,20,22,21,15,5,2,4,68,Astoria Bydgoszcz,Sezon 2015/2016
2016-01-27 18:00,KSK Noteć Inowrocław(w),77 : 64P,64,16,39,41.0,6,23,26.1,22,62,35.5,14,20,70.0,7,26,33,19,22,19,16,12,3,2,69,Astoria Bydgoszcz,Sezon 2015/2016
2016-02-03 19:00,GTK Gliwice(d),78 : 69W,78,21,41,51.2,6,19,31.6,27,60,45.0,18,27,66.7,10,22,32,20,25,24,19,10,0,3,79,Astoria Bydgoszcz,Sezon 2015/2016
2016-02-06 15:00,ACK UTH Rosa Radom(w),80 : 86W,86,24,48,50.0,8,20,40.0,32,68,47.1,14,25,56.0,11,27,38,17,19,24,12,12,3,1,97,Astoria Bydgoszcz,Sezon 2015/2016
2016-02-17 20:00,SKK Siedlce(w),87 : 99W,99,26,45,57.8,8,17,47.1,34,62,54.8,23,30,76.7,1,29,30,22,25,24,12,8,2,3,114,Astoria Bydgoszcz,Sezon 2015/2016
2016-02-20 17:00,Zetkama Doral Nysa Kłodzko(w),72 : 67P,67,15,39,38.5,7,20,35.0,22,59,37.3,16,18,88.9,8,24,32,23,29,22,12,7,0,0,78,Astoria Bydgoszcz,Sezon 2015/2016
2016-03-02 19:00,Biofarm Basket Poznań(d),68 : 76P,68,21,47,44.7,7,20,35.0,28,67,41.8,5,9,55.6,12,25,37,17,21,16,18,6,5,1,72,Astoria Bydgoszcz,Sezon 2015/2016
2016-03-04 19:00,Legia Warszawa(w),109 : 73P,73,20,40,50.0,7,23,30.4,27,63,42.9,12,19,63.2,9,12,21,18,26,22,16,7,0,1,60,Astoria Bydgoszcz,Sezon 2015/2016
2016-03-13 18:00,AZS AWF Mickiewicz Romus Katowice(d),100 : 74W,100,30,50,60.0,9,22,40.9,39,72,54.2,13,20,65.0,12,25,37,22,20,23,17,9,6,5,117,Astoria Bydgoszcz,Sezon 2015/2016
2016-03-19 18:00,GKS Tychy(w),88 : 93W,93,26,47,55.3,9,17,52.9,35,64,54.7,14,21,66.7,9,24,33,24,22,24,15,8,2,4,109,Astoria Bydgoszcz,Sezon 2015/2016
2016-03-23 19:00,meritumkredyt Pogoń Prudnik(d),80 : 69W,80,27,45,60.0,6,21,28.6,33,66,50.0,8,12,66.7,11,26,37,20,23,20,13,10,4,3,101,Astoria Bydgoszcz,Sezon 2015/2016
2016-04-03 18:00,Exact Systems Śląsk Wrocław(d),79 : 76W,79,23,46,50.0,7,18,38.9,30,64,46.9,12,14,85.7,5,19,24,16,19,16,12,10,4,1,85,Astoria Bydgoszcz,Sezon 2015/2016
2016-04-09 20:00,Legia Warszawa(w),87 : 70P,70,24,47,51.1,5,19,26.3,29,66,43.9,7,13,53.8,8,15,23,20,19,19,10,9,2,6,71,Astoria Bydgoszcz,Sezon 2015/2016
2016-04-10 20:00,Legia Warszawa(w),92 : 66P,66,13,41,31.7,10,23,43.5,23,64,35.9,10,18,55.6,15,14,29,12,22,14,14,5,2,5,51,Astoria Bydgoszcz,Sezon 2015/2016
2016-04-16 20:00,Legia Warszawa(d),71 : 87P,71,20,45,44.4,7,26,26.9,27,71,38.0,10,17,58.8,9,17,26,15,22,18,15,12,0,1,58,Astoria Bydgoszcz,Sezon 2015/2016
2015-09-26 18:00,Legia Warszawa(d),67 : 74P,67,17,34,50.0,7,24,29.2,24,58,41.4,12,18,66.7,8,20,28,11,27,22,13,8,1,4,62,AZS AWF Mickiewicz Romus Katowice,Sezon 2015/2016
2015-10-03 18:00,SKK Siedlce(w),73 : 75W,75,19,44,43.2,10,18,55.6,29,62,46.8,7,10,70.0,5,27,32,13,19,16,16,7,1,3,76,AZS AWF Mickiewicz Romus Katowice,Sezon 2015/2016
2015-10-10 18:00,GKS Tychy(d),65 : 69P,65,23,34,67.6,4,18,22.2,27,52,51.9,7,18,38.9,6,32,38,18,22,18,17,6,4,2,78,AZS AWF Mickiewicz Romus Katowice,Sezon 2015/2016
2015-10-17 17:00,Exact Systems Śląsk Wrocław(w),64 : 55P,55,13,35,37.1,7,22,31.8,20,57,35.1,8,16,50.0,10,22,32,10,18,21,14,6,1,5,45,AZS AWF Mickiewicz Romus Katowice,Sezon 2015/2016
2015-10-21 18:00,Miasto Szkła Krosno(d),68 : 84P,68,13,38,34.2,12,32,37.5,25,70,35.7,6,7,85.7,11,17,28,18,18,16,15,10,1,5,64,AZS AWF Mickiewicz Romus Katowice,Sezon 2015/2016
2015-10-25 17:00,MKS Znicz Basket Pruszków(w),75 : 63P,63,14,27,51.9,9,29,31.0,23,56,41.1,8,13,61.5,7,19,26,16,20,14,18,6,3,2,58,AZS AWF Mickiewicz Romus Katowice,Sezon 2015/2016
2015-10-31 18:00,KS Spójnia Stargard(d),65 : 85P,65,22,42,52.4,3,20,15.0,25,62,40.3,12,20,60.0,9,19,28,11,19,18,14,7,2,5,54,AZS AWF Mickiewicz Romus Katowice,Sezon 2015/2016
2015-11-05 18:00,Max Elektro Sokół Łańcut(w),100 : 49P,49,16,49,32.7,3,17,17.6,19,66,28.8,8,18,44.4,7,24,31,11,25,18,13,7,0,5,28,AZS AWF Mickiewicz Romus Katowice,Sezon 2015/2016
2015-11-11 18:00,KSK Noteć Inowrocław(d),62 : 69P,62,25,52,48.1,3,19,15.8,28,71,39.4,3,8,37.5,8,24,32,19,24,15,10,9,1,6,65,AZS AWF Mickiewicz Romus Katowice,Sezon 2015/2016
2015-11-14 18:00,GTK Gliwice(d),73 : 70W,73,21,40,52.5,7,20,35.0,28,60,46.7,10,16,62.5,7,19,26,14,21,19,16,11,0,2,70,AZS AWF Mickiewicz Romus Katowice,Sezon 2015/2016
2015-11-22 18:00,ACK UTH Rosa Radom(d),65 : 67P,65,22,37,59.5,5,22,22.7,27,59,45.8,6,10,60.0,12,28,40,15,20,18,23,9,4,0,74,AZS AWF Mickiewicz Romus Katowice,Sezon 2015/2016
2015-11-28 17:30,meritumkredyt Pogoń Prudnik(w),70 : 54P,54,17,41,41.5,5,15,33.3,22,56,39.3,5,7,71.4,5,19,24,10,24,11,16,5,1,5,42,AZS AWF Mickiewicz Romus Katowice,Sezon 2015/2016
2015-12-05 18:00,Astoria Bydgoszcz(d),86 : 79W,86,26,54,48.1,10,21,47.6,36,75,48.0,4,16,25.0,18,22,40,22,32,24,14,12,1,3,96,AZS AWF Mickiewicz Romus Katowice,Sezon 2015/2016
2015-12-12 17:00,Zetkama Doral Nysa Kłodzko(w),78 : 59P,59,18,41,43.9,3,16,18.8,21,57,36.8,14,19,73.7,7,17,24,21,19,23,15,8,2,3,58,AZS AWF Mickiewicz Romus Katowice,Sezon 2015/2016
2015-12-19 19:00,Biofarm Basket Poznań(d),89 : 78W,89,26,44,59.1,10,19,52.6,36,63,57.1,7,9,77.8,11,18,29,20,19,18,17,7,1,2,100,AZS AWF Mickiewicz Romus Katowice,Sezon 2015/2016
2015-12-23 18:00,Legia Warszawa(w),105 : 70P,70,18,35,51.4,8,23,34.8,26,58,44.8,10,13,76.9,4,15,19,14,23,16,19,10,1,4,60,AZS AWF Mickiewicz Romus Katowice,Sezon 2015/2016
2016-01-09 18:00,SKK Siedlce(d),63 : 86P,63,23,41,56.1,4,22,18.2,27,63,42.9,5,9,55.6,8,21,29,12,19,15,11,9,0,3,62,AZS AWF Mickiewicz Romus Katowice,Sezon 2015/2016
2016-01-16 18:00,GKS Tychy(w),92 : 77P,77,17,37,45.9,8,24,33.3,25,61,41.0,19,25,76.0,7,20,27,15,18,25,12,5,2,8,72,AZS AWF Mickiewicz Romus Katowice,Sezon 2015/2016
2016-01-23 18:00,Exact Systems Śląsk Wrocław(d),84 : 64W,84,19,39,48.7,11,28,39.3,30,67,44.8,13,19,68.4,11,27,38,18,21,19,11,11,5,1,102,AZS AWF Mickiewicz Romus Katowice,Sezon 2015/2016
2016-01-27 18:00,Miasto Szkła Krosno(w),98 : 67P,67,19,45,42.2,7,25,28.0,26,70,37.1,8,11,72.7,13,20,33,11,18,17,15,8,0,4,57,AZS AWF Mickiewicz Romus Katowice,Sezon 2015/2016
2016-01-30 18:00,MKS Znicz Basket Pruszków(d),61 : 88P,61,19,46,41.3,6,23,26.1,25,69,36.2,5,10,50.0,9,18,27,6,24,19,13,11,1,6,44,AZS AWF Mickiewicz Romus Katowice,Sezon 2015/2016
2016-02-06 17:00,KS Spójnia Stargard(w),79 : 85W,85,25,43,58.1,7,22,31.8,32,65,49.2,14,17,82.4,5,20,25,19,21,20,12,11,1,5,93,AZS AWF Mickiewicz Romus Katowice,Sezon 2015/2016
2016-02-13 18:00,Max Elektro Sokół Łańcut(d),60 : 66P,60,14,42,33.3,7,24,29.2,21,66,31.8,11,15,73.3,16,16,32,17,26,19,13,7,1,5,55,AZS AWF Mickiewicz Romus Katowice,Sezon 2015/2016
2016-02-17 18:00,KSK Noteć Inowrocław(w),76 : 72P,72,16,47,34.0,11,29,37.9,27,76,35.5,7,13,53.8,12,20,32,16,28,20,10,6,2,5,63,AZS AWF Mickiewicz Romus Katowice,Sezon 2015/2016
2016-02-20 18:00,GTK Gliwice(w),67 : 89W,89,21,44,47.7,13,31,41.9,34,75,45.3,8,12,66.7,8,25,33,22,25,17,10,15,3,2,107,AZS AWF Mickiewicz Romus Katowice,Sezon 2015/2016
2016-02-27 15:00,ACK UTH Rosa Radom(w),93 : 71P,71,23,44,52.3,4,20,20.0,27,64,42.2,13,26,50.0,5,28,33,12,21,23,12,8,3,3,65,AZS AWF Mickiewicz Romus Katowice,Sezon 2015/2016
2016-03-05 18:00,meritumkredyt Pogoń Prudnik(d),82 : 77W,82,23,44,52.3,9,26,34.6,32,70,45.7,9,13,69.2,9,21,30,18,17,17,9,13,4,3,96,AZS AWF Mickiewicz Romus Katowice,Sezon 2015/2016
2016-03-13 18:00,Astoria Bydgoszcz(w),100 : 74P,74,25,45,55.6,4,18,22.2,29,63,46.0,12,18,66.7,5,18,23,17,23,20,20,10,5,6,69,AZS AWF Mickiewicz Romus Katowice,Sezon 2015/2016
2016-03-19 18:00,Zetkama Doral Nysa Kłodzko(d),80 : 61W,80,22,36,61.1,8,21,38.1,30,57,52.6,12,21,57.1,8,26,34,22,23,22,14,6,1,2,93,AZS AWF Mickiewicz Romus Katowice,Sezon 2015/2016
2016-04-03 18:00,Biofarm Basket Poznań(w),83 : 65P,65,22,44,50.0,4,13,30.8,26,57,45.6,9,17,52.9,5,14,19,15,23,23,17,10,2,4,55,AZS AWF Mickiewicz Romus Katowice,Sezon 2015/2016
2016-04-09 18:00,KSK Noteć Inowrocław(w),76 : 80W,80,21,41,51.2,9,27,33.3,30,68,44.1,11,16,68.8,6,25,31,9,18,21,10,8,6,5,81,AZS AWF Mickiewicz Romus Katowice,Sezon 2015/2016
2016-04-10 13:00,KSK Noteć Inowrocław(w),78 : 68P,68,16,38,42.1,8,25,32.0,24,63,38.1,12,15,80.0,9,24,33,12,19,19,15,9,2,4,67,AZS AWF Mickiewicz Romus Katowice,Sezon 2015/2016
2016-04-16 18:00,KSK Noteć Inowrocław(d),96 : 76W,96,18,40,45.0,14,29,48.3,32,69,46.4,18,26,69.2,8,21,29,26,21,25,10,19,3,1,118,AZS AWF Mickiewicz Romus Katowice,Sezon 2015/2016
2016-04-17 17:00,KSK Noteć Inowrocław(d),78 : 86P,78,18,32,56.3,10,26,38.5,28,58,48.3,12,19,63.2,4,23,27,15,28,21,18,5,0,2,70,AZS AWF Mickiewicz Romus Katowice,Sezon 2015/2016
2016-04-20 18:00,KSK Noteć Inowrocław(w),84 : 71P,71,16,37,43.2,8,23,34.8,24,60,40.0,15,23,65.2,5,21,26,10,28,24,16,14,0,3,61,AZS AWF Mickiewicz Romus Katowice,Sezon 2015/2016
2015-09-26 18:00,GKS Tychy(d),69 : 65W,69,16,36,44.4,8,25,32.0,24,61,39.3,13,18,72.2,11,22,33,12,20,17,15,5,2,6,64,Biofarm Basket Poznań,Sezon 2015/2016
2015-10-04 18:00,Exact Systems Śląsk Wrocław(w),59 : 61W,61,17,42,40.5,4,19,21.1,21,61,34.4,15,26,57.7,13,27,40,6,20,27,16,5,0,5,45,Biofarm Basket Poznań,Sezon 2015/2016
2015-10-10 15:45,Miasto Szkła Krosno(d),51 : 76P,51,17,50,34.0,3,21,14.3,20,71,28.2,8,9,88.9,10,17,27,10,22,16,16,13,1,5,34,Biofarm Basket Poznań,Sezon 2015/2016
2015-10-18 17:00,MKS Znicz Basket Pruszków(w),56 : 50P,50,17,44,38.6,3,21,14.3,20,65,30.8,7,11,63.6,11,17,28,5,24,19,13,10,5,4,36,Biofarm Basket Poznań,Sezon 2015/2016
2015-10-21 18:00,KS Spójnia Stargard(d),62 : 68P,62,18,44,40.9,5,21,23.8,23,65,35.4,11,15,73.3,13,19,32,11,22,17,14,11,4,3,60,Biofarm Basket Poznań,Sezon 2015/2016
2015-10-24 17:30,Max Elektro Sokół Łańcut(w),67 : 51P,51,14,38,36.8,6,13,46.2,20,51,39.2,5,10,50.0,6,24,30,10,18,19,19,6,1,6,43,Biofarm Basket Poznań,Sezon 2015/2016
2015-10-31 15:45,KSK Noteć Inowrocław(d),70 : 64W,70,28,53,52.8,3,16,18.8,31,69,44.9,5,12,41.7,12,22,34,11,20,23,9,9,5,3,75,Biofarm Basket Poznań,Sezon 2015/2016
2015-11-07 18:00,GTK Gliwice(w),61 : 52P,52,16,29,55.2,4,22,18.2,20,51,39.2,8,16,50.0,9,14,23,11,20,20,17,12,2,5,44,Biofarm Basket Poznań,Sezon 2015/2016
2015-11-11 15:45,ACK UTH Rosa Radom(d),58 : 64P,58,14,31,45.2,7,21,33.3,21,52,40.4,9,13,69.2,8,18,26,13,24,16,19,8,1,2,52,Biofarm Basket Poznań,Sezon 2015/2016
2015-11-15 17:00,meritumkredyt Pogoń Prudnik(w),70 : 52P,52,18,41,43.9,1,18,5.6,19,59,32.2,13,19,68.4,9,18,27,4,22,21,22,12,1,1,28,Biofarm Basket Poznań,Sezon 2015/2016
2015-11-21 15:45,Astoria Bydgoszcz(d),62 : 71P,62,20,51,39.2,3,15,20.0,23,66,34.8,13,21,61.9,14,26,40,8,23,21,19,9,6,1,55,Biofarm Basket Poznań,Sezon 2015/2016
2015-11-28 17:00,Zetkama Doral Nysa Kłodzko(w),77 : 66P,66,15,31,48.4,7,22,31.8,22,53,41.5,15,19,78.9,8,13,21,18,21,20,15,10,1,4,66,Biofarm Basket Poznań,Sezon 2015/2016
2015-12-05 18:00,SKK Siedlce(d),81 : 70W,81,25,44,56.8,9,25,36.0,34,69,49.3,4,6,66.7,15,23,38,16,18,15,17,7,2,3,90,Biofarm Basket Poznań,Sezon 2015/2016
2015-12-12 15:45,Legia Warszawa(d),44 : 75P,44,17,52,32.7,1,13,7.7,18,65,27.7,7,15,46.7,11,18,29,5,22,19,16,13,2,4,22,Biofarm Basket Poznań,Sezon 2015/2016
2015-12-19 19:00,AZS AWF Mickiewicz Romus Katowice(w),89 : 78P,78,22,35,62.9,8,23,34.8,30,58,51.7,10,15,66.7,7,16,23,8,18,18,19,10,2,1,69,Biofarm Basket Poznań,Sezon 2015/2016
2016-01-02 18:00,GKS Tychy(w),91 : 59P,59,16,36,44.4,3,15,20.0,19,51,37.3,18,20,90.0,8,21,29,9,19,20,18,4,1,5,50,Biofarm Basket Poznań,Sezon 2015/2016
2016-01-10 17:00,Exact Systems Śląsk Wrocław(d),84 : 73W,84,16,30,53.3,9,23,39.1,25,53,47.2,25,37,67.6,5,25,30,15,22,27,16,10,3,3,86,Biofarm Basket Poznań,Sezon 2015/2016
2016-01-17 17:00,Miasto Szkła Krosno(w),98 : 62P,62,20,47,42.6,4,17,23.5,24,64,37.5,10,14,71.4,12,15,27,11,17,19,17,10,1,3,50,Biofarm Basket Poznań,Sezon 2015/2016
2016-01-23 15:45,MKS Znicz Basket Pruszków(d),60 : 61P,60,16,38,42.1,7,21,33.3,23,59,39.0,7,12,58.3,9,22,31,11,21,20,20,9,6,4,56,Biofarm Basket Poznań,Sezon 2015/2016
2016-01-27 19:00,KS Spójnia Stargard(w),58 : 81W,81,23,42,54.8,8,23,34.8,31,65,47.7,11,14,78.6,9,24,33,11,19,16,6,8,1,3,91,Biofarm Basket Poznań,Sezon 2015/2016
2016-01-31 15:45,Max Elektro Sokół Łańcut(d),56 : 50W,56,17,40,42.5,3,18,16.7,20,58,34.5,13,21,61.9,11,30,41,15,18,19,12,3,3,4,60,Biofarm Basket Poznań,Sezon 2015/2016
2016-02-06 18:00,KSK Noteć Inowrocław(w),73 : 67P,67,14,32,43.8,9,30,30.0,23,62,37.1,12,20,60.0,10,18,28,8,20,21,13,10,3,1,56,Biofarm Basket Poznań,Sezon 2015/2016
2016-02-17 15:30,ACK UTH Rosa Radom(w),72 : 66P,66,18,34,52.9,9,19,47.4,27,53,50.9,3,12,25.0,11,24,35,17,20,16,17,4,3,1,73,Biofarm Basket Poznań,Sezon 2015/2016
2016-02-20 19:30,meritumkredyt Pogoń Prudnik(d),52 : 67P,52,13,30,43.3,5,30,16.7,18,60,30.0,11,15,73.3,9,28,37,9,19,18,17,8,3,4,46,Biofarm Basket Poznań,Sezon 2015/2016
2016-03-02 19:00,Astoria Bydgoszcz(w),68 : 76W,76,26,53,49.1,5,20,25.0,31,73,42.5,9,19,47.4,17,24,41,17,16,21,12,10,1,5,81,Biofarm Basket Poznań,Sezon 2015/2016
2016-03-05 15:45,Zetkama Doral Nysa Kłodzko(d),44 : 51P,44,15,36,41.7,1,19,5.3,16,55,29.1,11,25,44.0,14,27,41,5,24,27,13,7,2,3,33,Biofarm Basket Poznań,Sezon 2015/2016
2016-03-09 19:00,GTK Gliwice(d),61 : 64P,61,18,54,33.3,7,17,41.2,25,71,35.2,4,14,28.6,15,25,40,13,18,20,13,8,5,5,58,Biofarm Basket Poznań,Sezon 2015/2016
2016-03-13 18:00,SKK Siedlce(w),78 : 72P,72,21,50,42.0,6,20,30.0,27,70,38.6,12,22,54.5,12,18,30,13,19,22,8,9,2,4,65,Biofarm Basket Poznań,Sezon 2015/2016
2016-03-18 19:00,Legia Warszawa(w),71 : 74W,74,21,40,52.5,7,19,36.8,28,59,47.5,11,16,68.8,6,24,30,18,19,16,18,10,4,4,82,Biofarm Basket Poznań,Sezon 2015/2016
2016-04-03 18:00,AZS AWF Mickiewicz Romus Katowice(d),83 : 65W,83,24,37,64.9,7,20,35.0,31,57,54.4,14,26,53.8,14,27,41,17,23,23,18,12,4,2,101,Biofarm Basket Poznań,Sezon 2015/2016
2016-04-09 15:00,Exact Systems Śląsk Wrocław(d),74 : 69W,74,22,42,52.4,5,20,25.0,27,62,43.5,15,24,62.5,11,25,36,12,14,24,13,8,3,6,76,Biofarm Basket Poznań,Sezon 2015/2016
2016-04-10 17:00,Exact Systems Śląsk Wrocław(d),64 : 61W,64,11,39,28.2,8,20,40.0,19,59,32.2,18,27,66.7,8,25,33,14,18,21,6,4,8,7,68,Biofarm Basket Poznań,Sezon 2015/2016
2016-04-16 15:00,Exact Systems Śląsk Wrocław(w),76 : 62P,62,15,32,46.9,4,27,14.8,19,59,32.2,20,27,74.1,10,17,27,8,24,25,16,10,2,3,46,Biofarm Basket Poznań,Sezon 2015/2016
2016-04-17 17:00,Exact Systems Śląsk Wrocław(w),73 : 64P,64,18,46,39.1,5,20,25.0,23,66,34.8,13,19,68.4,5,26,31,7,21,21,8,5,2,7,52,Biofarm Basket Poznań,Sezon 2015/2016
2016-04-20 19:30,Exact Systems Śląsk Wrocław(d),66 : 55W,66,17,36,47.2,5,20,25.0,22,56,39.3,17,29,58.6,9,32,41,12,20,29,15,10,4,2,72,Biofarm Basket Poznań,Sezon 2015/2016
2015-09-27 14:00,Zetkama Doral Nysa Kłodzko(d),66 : 54W,66,13,26,50.0,8,25,32.0,21,51,41.2,16,28,57.1,8,22,30,7,23,27,17,14,7,0,65,Exact Systems Śląsk Wrocław,Sezon 2015/2016
2015-10-04 18:00,Biofarm Basket Poznań(d),59 : 61P,59,18,29,62.1,4,31,12.9,22,60,36.7,11,15,73.3,10,28,38,15,27,20,11,9,5,0,73,Exact Systems Śląsk Wrocław,Sezon 2015/2016
2015-10-11 17:00,Legia Warszawa(w),69 : 59P,59,19,47,40.4,5,25,20.0,24,72,33.3,6,9,66.7,13,21,34,8,25,21,10,9,2,2,51,Exact Systems Śląsk Wrocław,Sezon 2015/2016
2015-10-17 17:00,AZS AWF Mickiewicz Romus Katowice(d),64 : 55W,64,27,47,57.4,1,17,5.9,28,64,43.8,7,8,87.5,10,25,35,10,21,18,14,11,5,1,74,Exact Systems Śląsk Wrocław,Sezon 2015/2016
2015-10-21 19:00,GKS Tychy(w),90 : 70P,70,22,32,68.8,3,16,18.8,25,48,52.1,17,23,73.9,3,19,22,14,15,24,18,1,2,1,62,Exact Systems Śląsk Wrocław,Sezon 2015/2016
2015-10-25 17:00,SKK Siedlce(w),69 : 55P,55,13,39,33.3,5,19,26.3,18,58,31.0,14,17,82.4,8,28,36,6,20,21,17,8,2,2,47,Exact Systems Śląsk Wrocław,Sezon 2015/2016
2015-10-30 17:00,Miasto Szkła Krosno(d),54 : 93P,54,13,42,31.0,7,22,31.8,20,64,31.3,7,11,63.6,9,14,23,8,26,19,15,12,1,6,35,Exact Systems Śląsk Wrocław,Sezon 2015/2016
2015-11-08 17:00,MKS Znicz Basket Pruszków(w),75 : 74P,74,24,41,58.5,5,22,22.7,29,63,46.0,11,15,73.3,6,14,20,16,29,21,14,10,4,6,72,Exact Systems Śląsk Wrocław,Sezon 2015/2016
2015-11-11 17:00,KS Spójnia Stargard(d),48 : 67P,48,13,33,39.4,5,12,41.7,18,45,40.0,7,12,58.3,7,14,21,7,17,17,16,6,0,3,34,Exact Systems Śląsk Wrocław,Sezon 2015/2016
2015-11-14 17:30,Max Elektro Sokół Łańcut(w),76 : 54P,54,15,29,51.7,6,16,37.5,21,45,46.7,6,8,75.0,5,16,21,12,16,11,21,8,0,4,48,Exact Systems Śląsk Wrocław,Sezon 2015/2016
2015-11-21 13:00,KSK Noteć Inowrocław(d),74 : 65W,74,16,36,44.4,9,23,39.1,25,59,42.4,15,20,75.0,7,23,30,10,26,25,19,13,2,2,71,Exact Systems Śląsk Wrocław,Sezon 2015/2016
2015-11-29 18:00,GTK Gliwice(w),43 : 56W,56,14,30,46.7,7,25,28.0,21,55,38.2,7,12,58.3,6,20,26,13,21,18,12,10,1,2,55,Exact Systems Śląsk Wrocław,Sezon 2015/2016
2015-12-06 14:00,ACK UTH Rosa Radom(d),70 : 73P,70,18,38,47.4,8,23,34.8,26,61,42.6,10,13,76.9,7,27,34,12,22,20,21,8,3,5,68,Exact Systems Śląsk Wrocław,Sezon 2015/2016
2015-12-12 17:30,meritumkredyt Pogoń Prudnik(w),84 : 64P,64,14,28,50.0,6,28,21.4,20,56,35.7,18,23,78.3,12,18,30,12,22,27,15,2,0,0,52,Exact Systems Śląsk Wrocław,Sezon 2015/2016
2015-12-19 17:30,Astoria Bydgoszcz(d),82 : 88P,82,22,40,55.0,8,26,30.8,30,66,45.5,14,19,73.7,10,16,26,10,25,23,14,6,3,3,72,Exact Systems Śląsk Wrocław,Sezon 2015/2016
2016-01-03 17:00,Zetkama Doral Nysa Kłodzko(w),73 : 65P,65,13,31,41.9,8,23,34.8,21,54,38.9,15,25,60.0,9,17,26,23,22,25,17,9,2,2,65,Exact Systems Śląsk Wrocław,Sezon 2015/2016
2016-01-10 17:00,Biofarm Basket Poznań(w),84 : 73P,73,18,45,40.0,6,18,33.3,24,63,38.1,19,23,82.6,14,22,36,11,27,22,20,12,3,3,72,Exact Systems Śląsk Wrocław,Sezon 2015/2016
2016-01-17 17:00,Legia Warszawa(d),83 : 77W,83,14,35,40.0,13,35,37.1,27,70,38.6,16,21,76.2,16,23,39,16,31,23,13,3,2,5,82,Exact Systems Śląsk Wrocław,Sezon 2015/2016
2016-01-23 18:00,AZS AWF Mickiewicz Romus Katowice(w),84 : 64P,64,16,39,41.0,7,18,38.9,23,57,40.4,11,18,61.1,6,21,27,12,20,20,15,7,1,5,55,Exact Systems Śląsk Wrocław,Sezon 2015/2016
2016-01-27 18:00,GKS Tychy(d),69 : 71P,69,19,39,48.7,9,21,42.9,28,60,46.7,4,6,66.7,5,19,24,13,21,17,16,7,0,1,63,Exact Systems Śląsk Wrocław,Sezon 2015/2016
2016-01-30 16:00,SKK Siedlce(d),69 : 59W,69,15,30,50.0,7,30,23.3,22,60,36.7,18,21,85.7,10,24,34,13,21,23,14,5,1,1,67,Exact Systems Śląsk Wrocław,Sezon 2015/2016
2016-02-07 17:00,Miasto Szkła Krosno(w),81 : 68P,68,14,42,33.3,7,24,29.2,21,66,31.8,19,23,82.6,10,25,35,14,29,25,16,6,1,7,59,Exact Systems Śląsk Wrocław,Sezon 2015/2016
2016-02-17 18:00,KS Spójnia Stargard(w),63 : 69W,69,16,41,39.0,4,28,14.3,20,69,29.0,25,31,80.6,17,23,40,9,19,25,15,10,1,5,59,Exact Systems Śląsk Wrocław,Sezon 2015/2016
2016-02-20 15:30,Max Elektro Sokół Łańcut(d),49 : 74P,49,15,50,30.0,2,13,15.4,17,63,27.0,13,16,81.3,10,22,32,9,14,24,13,3,1,6,32,Exact Systems Śląsk Wrocław,Sezon 2015/2016
2016-03-02 20:00,KSK Noteć Inowrocław(w),62 : 68W,68,15,27,55.6,8,24,33.3,23,51,45.1,14,25,56.0,9,26,35,14,24,25,21,11,2,1,70,Exact Systems Śląsk Wrocław,Sezon 2015/2016
2016-03-05 14:30,GTK Gliwice(d),64 : 69P,64,21,47,44.7,3,16,18.8,24,63,38.1,13,17,76.5,10,24,34,10,22,21,16,8,1,4,58,Exact Systems Śląsk Wrocław,Sezon 2015/2016
2016-03-09 17:00,MKS Znicz Basket Pruszków(d),72 : 76P,72,20,43,46.5,6,25,24.0,26,68,38.2,14,25,56.0,16,16,32,14,28,22,18,12,1,4,60,Exact Systems Śląsk Wrocław,Sezon 2015/2016
2016-03-13 16:00,ACK UTH Rosa Radom(w),91 : 73P,73,16,32,50.0,9,17,52.9,25,49,51.0,14,16,87.5,5,21,26,15,20,17,23,4,2,1,71,Exact Systems Śląsk Wrocław,Sezon 2015/2016
2016-03-19 13:00,meritumkredyt Pogoń Prudnik(d),67 : 61W,67,16,27,59.3,5,24,20.8,21,51,41.2,20,30,66.7,8,24,32,15,23,23,15,13,6,1,78,Exact Systems Śląsk Wrocław,Sezon 2015/2016
2016-04-03 18:00,Astoria Bydgoszcz(w),79 : 76P,76,22,38,57.9,8,19,42.1,30,57,52.6,8,13,61.5,5,26,31,17,16,19,20,5,1,4,78,Exact Systems Śląsk Wrocław,Sezon 2015/2016
2016-04-09 15:00,Biofarm Basket Poznań(w),74 : 69P,69,24,43,55.8,6,16,37.5,30,59,50.8,3,10,30.0,6,22,28,15,25,14,13,10,6,3,79,Exact Systems Śląsk Wrocław,Sezon 2015/2016
2016-04-10 17:00,Biofarm Basket Poznań(w),64 : 61P,61,19,50,38.0,5,14,35.7,24,64,37.5,8,10,80.0,5,27,32,15,22,18,8,3,7,8,68,Exact Systems Śląsk Wrocław,Sezon 2015/2016
2016-04-16 15:00,Biofarm Basket Poznań(d),76 : 62W,76,23,36,63.9,5,13,38.5,28,49,57.1,15,20,75.0,4,27,31,8,25,24,21,5,3,2,76,Exact Systems Śląsk Wrocław,Sezon 2015/2016
2016-04-17 17:00,Biofarm Basket Poznań(d),73 : 64W,73,13,25,52.0,12,34,35.3,25,59,42.4,11,20,55.0,5,33,38,10,21,21,12,4,7,2,77,Exact Systems Śląsk Wrocław,Sezon 2015/2016
2016-04-20 19:30,Biofarm Basket Poznań(w),66 : 55P,55,16,46,34.8,4,20,20.0,20,66,30.3,11,17,64.7,14,23,37,12,29,20,15,7,2,4,46,Exact Systems Śląsk Wrocław,Sezon 2015/2016
2015-09-26 18:00,Biofarm Basket Poznań(w),69 : 65P,65,21,39,53.8,5,20,25.0,26,59,44.1,8,17,47.1,7,24,31,10,19,20,14,5,6,2,61,GKS Tychy,Sezon 2015/2016
2015-10-03 18:00,Legia Warszawa(d),67 : 73P,67,15,38,39.5,10,20,50.0,25,58,43.1,7,9,77.8,3,19,22,15,26,16,12,9,1,0,67,GKS Tychy,Sezon 2015/2016
2015-10-10 18:00,AZS AWF Mickiewicz Romus Katowice(w),65 : 69W,69,14,37,37.8,8,19,42.1,22,56,39.3,17,28,60.7,8,17,25,12,18,22,9,11,2,4,65,GKS Tychy,Sezon 2015/2016
2015-10-17 18:00,SKK Siedlce(w),67 : 71W,71,16,33,48.5,7,20,35.0,23,53,43.4,18,30,60.0,7,22,29,14,16,28,10,6,1,0,69,GKS Tychy,Sezon 2015/2016
2015-10-21 19:00,Exact Systems Śląsk Wrocław(d),90 : 70W,90,25,42,59.5,11,25,44.0,36,67,53.7,7,10,70.0,9,20,29,24,24,14,9,10,1,2,111,GKS Tychy,Sezon 2015/2016
2015-10-25 18:00,Miasto Szkła Krosno(w),78 : 69P,69,18,32,56.3,8,23,34.8,26,55,47.3,9,14,64.3,6,21,27,13,24,21,18,4,0,0,61,GKS Tychy,Sezon 2015/2016
2015-10-31 18:00,MKS Znicz Basket Pruszków(d),87 : 70W,87,24,40,60.0,10,27,37.0,34,67,50.7,9,14,64.3,11,24,35,21,19,17,9,10,1,1,107,GKS Tychy,Sezon 2015/2016
2015-11-08 19:00,KS Spójnia Stargard(w),59 : 85W,85,24,47,51.1,10,25,40.0,34,72,47.2,7,11,63.6,12,25,37,20,18,18,10,15,0,2,105,GKS Tychy,Sezon 2015/2016
2015-11-11 19:00,Max Elektro Sokół Łańcut(d),68 : 71P,68,13,33,39.4,9,26,34.6,22,59,37.3,15,20,75.0,4,25,29,15,24,23,14,8,5,1,69,GKS Tychy,Sezon 2015/2016
2015-11-14 18:00,KSK Noteć Inowrocław(w),75 : 71P,71,21,40,52.5,4,24,16.7,25,64,39.1,17,25,68.0,11,29,40,9,21,24,11,7,3,3,72,GKS Tychy,Sezon 2015/2016
2015-11-21 19:00,GTK Gliwice(d),89 : 68W,89,20,38,52.6,11,19,57.9,31,57,54.4,16,19,84.2,5,30,35,17,26,19,12,7,5,3,112,GKS Tychy,Sezon 2015/2016
2015-11-29 17:00,ACK UTH Rosa Radom(w),59 : 83W,83,29,45,64.4,5,18,27.8,34,63,54.0,10,13,76.9,8,25,33,20,18,17,10,12,3,0,109,GKS Tychy,Sezon 2015/2016
2015-12-05 18:00,meritumkredyt Pogoń Prudnik(d),104 : 71W,104,28,50,56.0,10,26,38.5,38,76,50.0,18,22,81.8,14,19,33,20,19,18,6,17,8,4,134,GKS Tychy,Sezon 2015/2016
2015-12-12 19:00,Astoria Bydgoszcz(w),69 : 71W,71,17,31,54.8,9,26,34.6,26,57,45.6,10,16,62.5,13,23,36,19,17,24,20,10,2,0,81,GKS Tychy,Sezon 2015/2016
2015-12-19 18:00,Zetkama Doral Nysa Kłodzko(d),62 : 47W,62,20,35,57.1,4,21,19.0,24,56,42.9,10,13,76.9,8,27,35,11,18,21,16,14,2,1,73,GKS Tychy,Sezon 2015/2016
2016-01-02 18:00,Biofarm Basket Poznań(d),91 : 59W,91,26,52,50.0,10,23,43.5,36,75,48.0,9,12,75.0,13,24,37,23,20,19,5,14,5,1,123,GKS Tychy,Sezon 2015/2016
2016-01-10 16:00,Legia Warszawa(w),80 : 68P,68,15,38,39.5,8,29,27.6,23,67,34.3,14,20,70.0,13,24,37,14,26,24,14,11,5,2,71,GKS Tychy,Sezon 2015/2016
2016-01-16 18:00,AZS AWF Mickiewicz Romus Katowice(d),92 : 77W,92,34,55,61.8,5,14,35.7,39,69,56.5,9,14,64.3,11,26,37,21,25,18,11,7,8,2,119,GKS Tychy,Sezon 2015/2016
2016-01-23 18:00,SKK Siedlce(d),96 : 84W,96,26,45,57.8,10,17,58.8,36,62,58.1,14,19,73.7,15,26,41,22,22,21,22,11,3,1,120,GKS Tychy,Sezon 2015/2016
2016-01-27 18:00,Exact Systems Śląsk Wrocław(w),69 : 71W,71,18,38,47.4,7,18,38.9,25,56,44.6,14,23,60.9,11,25,36,9,17,21,17,10,1,0,70,GKS Tychy,Sezon 2015/2016
2016-01-30 18:00,Miasto Szkła Krosno(d),51 : 90P,51,18,36,50.0,3,21,14.3,21,57,36.8,6,8,75.0,10,26,36,10,22,18,24,4,6,6,45,GKS Tychy,Sezon 2015/2016
2016-02-06 18:00,MKS Znicz Basket Pruszków(w),61 : 57P,57,14,36,38.9,7,23,30.4,21,59,35.6,8,11,72.7,9,24,33,14,23,18,16,12,2,2,61,GKS Tychy,Sezon 2015/2016
2016-02-13 19:00,KS Spójnia Stargard(d),92 : 75W,92,25,44,56.8,8,20,40.0,33,64,51.6,18,22,81.8,9,20,29,19,22,24,17,11,3,3,102,GKS Tychy,Sezon 2015/2016
2016-02-17 18:00,Max Elektro Sokół Łańcut(w),73 : 67P,67,15,33,45.5,9,25,36.0,24,58,41.4,10,12,83.3,8,22,30,16,22,19,21,12,9,3,77,GKS Tychy,Sezon 2015/2016
2016-02-20 19:00,KSK Noteć Inowrocław(d),94 : 70W,94,25,45,55.6,9,24,37.5,34,69,49.3,17,20,85.0,10,24,34,24,30,21,17,22,5,3,124,GKS Tychy,Sezon 2015/2016
2016-02-27 18:00,GTK Gliwice(w),78 : 53P,53,11,43,25.6,6,23,26.1,17,66,25.8,13,26,50.0,14,19,33,8,21,26,10,11,3,6,36,GKS Tychy,Sezon 2015/2016
2016-03-05 18:00,ACK UTH Rosa Radom(d),102 : 84W,102,28,51,54.9,11,22,50.0,39,73,53.4,13,17,76.5,18,21,39,32,25,21,13,14,3,4,139,GKS Tychy,Sezon 2015/2016
2016-03-12 17:30,meritumkredyt Pogoń Prudnik(w),78 : 75P,75,14,30,46.7,10,30,33.3,24,60,40.0,17,20,85.0,13,23,36,16,25,25,18,13,3,4,86,GKS Tychy,Sezon 2015/2016
2016-03-19 18:00,Astoria Bydgoszcz(d),88 : 93P,88,23,44,52.3,9,28,32.1,32,72,44.4,15,19,78.9,13,21,34,19,24,22,14,10,4,2,97,GKS Tychy,Sezon 2015/2016
2016-04-03 18:00,Zetkama Doral Nysa Kłodzko(w),87 : 81P,81,15,35,42.9,6,25,24.0,21,60,35.0,33,37,89.2,9,26,35,16,34,32,15,7,2,2,83,GKS Tychy,Sezon 2015/2016
2016-04-09 18:00,MKS Znicz Basket Pruszków(w),79 : 71P,71,13,34,38.2,11,31,35.5,24,65,36.9,12,19,63.2,11,22,33,18,19,21,9,13,1,9,79,GKS Tychy,Sezon 2015/2016
2016-04-10 18:00,MKS Znicz Basket Pruszków(w),46 : 87W,87,20,41,48.8,12,26,46.2,32,67,47.8,11,15,73.3,12,20,32,17,23,20,10,16,2,2,105,GKS Tychy,Sezon 2015/2016
2016-04-16 16:00,MKS Znicz Basket Pruszków(d),83 : 78W,83,24,47,51.1,2,13,15.4,26,60,43.3,29,34,85.3,11,19,30,14,22,27,11,11,3,4,91,GKS Tychy,Sezon 2015/2016
2016-04-17 18:00,MKS Znicz Basket Pruszków(d),93 : 82W,93,24,45,53.3,10,25,40.0,34,70,48.6,15,17,88.2,11,27,38,21,29,20,14,9,4,5,113,GKS Tychy,Sezon 2015/2016
2016-04-23 18:00,Miasto Szkła Krosno(w),105 : 75P,75,19,35,54.3,11,23,47.8,30,58,51.7,4,14,28.6,5,22,27,15,24,21,23,8,0,3,64,GKS Tychy,Sezon 2015/2016
2016-04-24 18:00,Miasto Szkła Krosno(w),84 : 69P,69,19,37,51.4,8,29,27.6,27,66,40.9,7,11,63.6,9,22,31,16,27,20,13,5,1,4,66,GKS Tychy,Sezon 2015/2016
2016-04-30 16:00,Miasto Szkła Krosno(d),82 : 105P,82,24,38,63.2,5,23,21.7,29,61,47.5,19,21,90.5,7,13,20,9,30,21,17,7,1,3,68,GKS Tychy,Sezon 2015/2016
2016-05-07 18:00,Max Elektro Sokół Łańcut(d),69 : 92P,69,17,34,50.0,7,22,31.8,24,56,42.9,14,17,82.4,9,20,29,17,22,20,18,6,3,1,71,GKS Tychy,Sezon 2015/2016
2016-05-14 17:30,Max Elektro Sokół Łańcut(w),86 : 92W,92,20,34,58.8,10,23,43.5,30,57,52.6,22,32,68.8,3,23,26,21,22,28,11,10,2,1,103,GKS Tychy,Sezon 2015/2016
2015-09-26 18:00,Max Elektro Sokół Łańcut(d),55 : 72P,55,20,44,45.5,2,15,13.3,22,59,37.3,9,14,64.3,11,20,31,10,21,19,16,4,1,1,43,GTK Gliwice,Sezon 2015/2016
2015-10-03 18:00,KSK Noteć Inowrocław(w),76 : 79W,79,14,42,33.3,13,33,39.4,27,75,36.0,12,17,70.6,10,23,33,14,21,20,7,10,0,3,76,GTK Gliwice,Sezon 2015/2016
2015-10-10 18:00,SKK Siedlce(d),73 : 54W,73,18,43,41.9,9,21,42.9,27,64,42.2,10,12,83.3,11,27,38,15,19,14,8,11,4,0,94,GTK Gliwice,Sezon 2015/2016
2015-10-17 18:00,ACK UTH Rosa Radom(d),76 : 84P,76,17,35,48.6,11,26,42.3,28,61,45.9,9,18,50.0,7,28,35,17,24,16,11,3,2,0,80,GTK Gliwice,Sezon 2015/2016
2015-10-21 18:30,meritumkredyt Pogoń Prudnik(w),69 : 60P,60,22,37,59.5,3,17,17.6,25,54,46.3,7,9,77.8,5,24,29,13,18,17,18,3,2,2,58,GTK Gliwice,Sezon 2015/2016
2015-10-24 18:00,Astoria Bydgoszcz(d),70 : 75P,70,20,38,52.6,5,23,21.7,25,61,41.0,15,22,68.2,10,26,36,17,17,19,14,6,3,0,75,GTK Gliwice,Sezon 2015/2016
2015-10-31 17:00,Zetkama Doral Nysa Kłodzko(w),59 : 57P,57,9,27,33.3,9,27,33.3,18,54,33.3,12,16,75.0,9,25,34,19,19,22,16,4,3,1,61,GTK Gliwice,Sezon 2015/2016
2015-11-07 18:00,Biofarm Basket Poznań(d),61 : 52W,61,18,33,54.5,6,18,33.3,24,51,47.1,7,13,53.8,9,21,30,16,20,20,20,5,5,2,64,GTK Gliwice,Sezon 2015/2016
2015-11-11 18:00,Legia Warszawa(d),77 : 83P,77,20,29,69.0,8,18,44.4,28,47,59.6,13,21,61.9,2,23,25,20,23,23,18,6,1,1,84,GTK Gliwice,Sezon 2015/2016
2015-11-14 18:00,AZS AWF Mickiewicz Romus Katowice(w),73 : 70P,70,14,36,38.9,8,20,40.0,22,56,39.3,18,19,94.7,9,22,31,14,19,21,19,12,2,0,75,GTK Gliwice,Sezon 2015/2016
2015-11-21 19:00,GKS Tychy(w),89 : 68P,68,15,37,40.5,5,13,38.5,20,50,40.0,23,30,76.7,3,17,20,14,19,26,12,5,3,4,61,GTK Gliwice,Sezon 2015/2016
2015-11-29 18:00,Exact Systems Śląsk Wrocław(d),43 : 56P,43,10,28,35.7,2,19,10.5,12,47,25.5,17,23,73.9,9,23,32,8,18,20,17,7,2,1,34,GTK Gliwice,Sezon 2015/2016
2015-12-05 18:00,Miasto Szkła Krosno(d),47 : 88P,47,12,36,33.3,5,17,29.4,17,53,32.1,8,14,57.1,6,15,21,10,27,21,18,4,1,1,23,GTK Gliwice,Sezon 2015/2016
2015-12-12 18:00,MKS Znicz Basket Pruszków(d),54 : 65P,54,17,36,47.2,4,19,21.1,21,55,38.2,8,22,36.4,10,32,42,13,18,23,18,5,5,3,53,GTK Gliwice,Sezon 2015/2016
2015-12-19 17:00,KS Spójnia Stargard(w),86 : 74P,74,22,48,45.8,6,22,27.3,28,70,40.0,12,15,80.0,12,18,30,18,19,21,14,11,2,1,76,GTK Gliwice,Sezon 2015/2016
2016-01-02 17:30,Max Elektro Sokół Łańcut(w),80 : 63P,63,13,34,38.2,7,25,28.0,20,59,33.9,16,24,66.7,14,22,36,6,25,21,16,7,1,3,50,GTK Gliwice,Sezon 2015/2016
2016-01-09 18:00,KSK Noteć Inowrocław(d),74 : 77P,74,21,43,48.8,5,21,23.8,26,64,40.6,17,22,77.3,13,19,32,17,29,20,16,10,1,4,75,GTK Gliwice,Sezon 2015/2016
2016-01-17 18:00,SKK Siedlce(w),72 : 70P,70,17,37,45.9,8,29,27.6,25,66,37.9,12,19,63.2,9,22,31,11,26,21,14,8,1,2,59,GTK Gliwice,Sezon 2015/2016
2016-01-23 16:00,ACK UTH Rosa Radom(w),86 : 58P,58,17,28,60.7,5,25,20.0,22,53,41.5,9,12,75.0,6,22,28,16,18,19,20,6,3,1,57,GTK Gliwice,Sezon 2015/2016
2016-01-27 20:00,meritumkredyt Pogoń Prudnik(d),73 : 65W,73,19,35,54.3,8,18,44.4,27,53,50.9,11,15,73.3,6,28,34,17,26,19,15,4,2,2,85,GTK Gliwice,Sezon 2015/2016
2016-02-03 19:00,Astoria Bydgoszcz(w),78 : 69P,69,14,28,50.0,9,26,34.6,23,54,42.6,14,22,63.6,8,23,31,14,24,25,22,12,3,0,68,GTK Gliwice,Sezon 2015/2016
2016-02-06 18:00,Zetkama Doral Nysa Kłodzko(d),74 : 57W,74,20,44,45.5,7,25,28.0,27,69,39.1,13,19,68.4,20,21,41,14,23,20,14,10,4,4,81,GTK Gliwice,Sezon 2015/2016
2016-02-17 20:00,Legia Warszawa(w),88 : 77P,77,20,37,54.1,9,26,34.6,29,63,46.0,10,14,71.4,11,22,33,14,24,21,20,7,3,3,76,GTK Gliwice,Sezon 2015/2016
2016-02-20 18:00,AZS AWF Mickiewicz Romus Katowice(d),67 : 89P,67,16,37,43.2,5,23,21.7,21,60,35.0,20,22,90.9,7,33,40,13,17,25,21,1,2,3,61,GTK Gliwice,Sezon 2015/2016
2016-02-27 18:00,GKS Tychy(d),78 : 53W,78,15,33,45.5,12,19,63.2,27,52,51.9,12,13,92.3,5,33,38,18,26,20,22,5,6,3,97,GTK Gliwice,Sezon 2015/2016
2016-03-05 14:30,Exact Systems Śląsk Wrocław(w),64 : 69W,69,18,38,47.4,7,20,35.0,25,58,43.1,12,19,63.2,10,24,34,12,22,22,18,9,4,1,70,GTK Gliwice,Sezon 2015/2016
2016-03-09 19:00,Biofarm Basket Poznań(w),61 : 64W,64,23,36,63.9,4,19,21.1,27,55,49.1,6,13,46.2,5,28,33,14,20,18,12,7,5,5,76,GTK Gliwice,Sezon 2015/2016
2016-03-12 17:00,Miasto Szkła Krosno(w),102 : 58P,58,13,40,32.5,7,22,31.8,20,62,32.3,11,15,73.3,7,14,21,15,21,20,13,9,2,7,46,GTK Gliwice,Sezon 2015/2016
2016-03-19 18:00,MKS Znicz Basket Pruszków(w),79 : 67P,67,18,42,42.9,7,21,33.3,25,63,39.7,10,15,66.7,12,20,32,9,27,21,22,14,3,1,60,GTK Gliwice,Sezon 2015/2016
2016-04-03 18:00,KS Spójnia Stargard(d),86 : 72W,86,24,48,50.0,9,23,39.1,33,71,46.5,11,18,61.1,13,22,35,18,24,23,10,5,3,5,92,GTK Gliwice,Sezon 2015/2016
2016-04-09 16:00,ACK UTH Rosa Radom(w),82 : 80P,80,17,41,41.5,8,26,30.8,25,67,37.3,22,29,75.9,14,30,44,12,22,26,21,8,2,4,76,GTK Gliwice,Sezon 2015/2016
2016-04-10 20:00,ACK UTH Rosa Radom(w),92 : 88P,88,24,41,58.5,9,26,34.6,33,67,49.3,13,18,72.2,12,27,39,18,29,20,16,5,1,1,96,GTK Gliwice,Sezon 2015/2016
2016-04-16 18:00,ACK UTH Rosa Radom(d),78 : 71W,78,15,28,53.6,8,18,44.4,23,46,50.0,24,27,88.9,5,21,26,16,22,24,18,8,3,2,87,GTK Gliwice,Sezon 2015/2016
2016-04-17 20:00,ACK UTH Rosa Radom(d),83 : 61W,83,16,33,48.5,9,26,34.6,25,59,42.4,24,29,82.8,9,33,42,18,29,25,13,7,3,2,101,GTK Gliwice,Sezon 2015/2016
2016-04-20 18:00,ACK UTH Rosa Radom(w),77 : 45P,45,13,35,37.1,5,25,20.0,18,60,30.0,4,4,100.0,7,17,24,9,20,16,11,5,3,4,33,GTK Gliwice,Sezon 2015/2016
2015-09-27 17:00,ACK UTH Rosa Radom(w),76 : 58P,58,12,36,33.3,6,19,31.6,18,55,32.7,16,23,69.6,9,24,33,5,21,21,20,5,3,5,40,KS Spójnia Stargard,Sezon 2015/2016
2015-10-03 17:30,meritumkredyt Pogoń Prudnik(d),57 : 73P,57,19,43,44.2,2,21,9.5,21,64,32.8,13,16,81.3,14,19,33,11,23,18,15,10,5,4,55,KS Spójnia Stargard,Sezon 2015/2016
2015-10-10 19:00,Astoria Bydgoszcz(w),76 : 67P,67,19,35,54.3,6,22,27.3,25,57,43.9,11,17,64.7,7,19,26,11,15,23,15,10,2,2,63,KS Spójnia Stargard,Sezon 2015/2016
2015-10-17 17:30,Zetkama Doral Nysa Kłodzko(d),78 : 65W,78,19,30,63.3,10,27,37.0,29,57,50.9,10,13,76.9,10,31,41,19,25,20,23,15,2,1,101,KS Spójnia Stargard,Sezon 2015/2016
2015-10-21 18:00,Biofarm Basket Poznań(w),62 : 68W,68,13,25,52.0,9,29,31.0,22,54,40.7,15,18,83.3,9,18,27,12,17,22,18,8,3,4,65,KS Spójnia Stargard,Sezon 2015/2016
2015-10-24 17:00,Legia Warszawa(d),82 : 80W,82,18,37,48.6,8,22,36.4,26,59,44.1,22,26,84.6,4,32,36,15,18,21,16,7,3,2,90,KS Spójnia Stargard,Sezon 2015/2016
2015-10-31 18:00,AZS AWF Mickiewicz Romus Katowice(w),65 : 85W,85,28,42,66.7,5,15,33.3,33,57,57.9,14,22,63.6,3,29,32,14,18,19,17,10,5,2,97,KS Spójnia Stargard,Sezon 2015/2016
2015-11-08 19:00,GKS Tychy(d),59 : 85P,59,13,30,43.3,8,24,33.3,21,54,38.9,9,12,75.0,9,21,30,11,19,18,20,4,2,0,50,KS Spójnia Stargard,Sezon 2015/2016
2015-11-11 17:00,Exact Systems Śląsk Wrocław(w),48 : 67W,67,18,36,50.0,8,24,33.3,26,60,43.3,7,10,70.0,12,16,28,11,17,17,12,10,3,0,70,KS Spójnia Stargard,Sezon 2015/2016
2015-11-14 17:00,Miasto Szkła Krosno(d),80 : 96P,80,25,41,61.0,9,24,37.5,34,65,52.3,3,4,75.0,4,20,24,15,22,13,13,10,2,2,86,KS Spójnia Stargard,Sezon 2015/2016
2015-11-22 17:00,MKS Znicz Basket Pruszków(w),78 : 81W,81,20,44,45.5,8,22,36.4,28,66,42.4,17,21,81.0,11,28,39,13,24,21,16,7,3,3,85,KS Spójnia Stargard,Sezon 2015/2016
2015-11-28 17:00,SKK Siedlce(w),71 : 73W,73,18,41,43.9,8,28,28.6,26,69,37.7,13,15,86.7,6,19,25,9,18,18,8,10,1,4,65,KS Spójnia Stargard,Sezon 2015/2016
2015-12-05 17:00,Max Elektro Sokół Łańcut(d),61 : 93P,61,15,34,44.1,7,25,28.0,22,59,37.3,10,13,76.9,9,21,30,11,23,15,19,5,1,3,49,KS Spójnia Stargard,Sezon 2015/2016
2015-12-12 18:00,KSK Noteć Inowrocław(w),84 : 75P,75,21,39,53.8,8,27,29.6,29,66,43.9,9,10,90.0,6,26,32,19,23,17,12,2,7,4,85,KS Spójnia Stargard,Sezon 2015/2016
2015-12-19 17:00,GTK Gliwice(d),86 : 74W,86,26,42,61.9,6,16,37.5,32,58,55.2,16,19,84.2,7,24,31,13,21,19,19,12,1,2,95,KS Spójnia Stargard,Sezon 2015/2016
2016-01-03 17:00,ACK UTH Rosa Radom(d),76 : 68W,76,17,33,51.5,12,33,36.4,29,66,43.9,6,6,100.0,12,26,38,22,19,15,13,8,3,1,97,KS Spójnia Stargard,Sezon 2015/2016
2016-01-09 17:30,meritumkredyt Pogoń Prudnik(w),65 : 61P,61,23,35,65.7,3,26,11.5,26,61,42.6,6,6,100.0,6,25,31,13,19,15,17,8,2,1,63,KS Spójnia Stargard,Sezon 2015/2016
2016-01-13 18:00,Astoria Bydgoszcz(d),68 : 75P,68,18,35,51.4,7,30,23.3,25,65,38.5,11,14,78.6,8,24,32,10,24,17,14,8,2,0,63,KS Spójnia Stargard,Sezon 2015/2016
2016-01-23 17:00,Zetkama Doral Nysa Kłodzko(w),85 : 75P,75,18,28,64.3,7,25,28.0,25,53,47.2,18,19,94.7,4,16,20,27,21,22,17,6,1,3,83,KS Spójnia Stargard,Sezon 2015/2016
2016-01-27 19:00,Biofarm Basket Poznań(d),58 : 81P,58,17,39,43.6,5,28,17.9,22,67,32.8,9,13,69.2,16,24,40,14,17,19,11,4,3,1,59,KS Spójnia Stargard,Sezon 2015/2016
2016-01-31 16:45,Legia Warszawa(w),92 : 77P,77,27,53,50.9,6,19,31.6,33,72,45.8,5,7,71.4,12,21,33,14,23,18,14,8,2,1,79,KS Spójnia Stargard,Sezon 2015/2016
2016-02-06 17:00,AZS AWF Mickiewicz Romus Katowice(d),79 : 85P,79,21,40,52.5,8,20,40.0,29,60,48.3,13,18,72.2,11,25,36,21,21,21,19,5,5,1,91,KS Spójnia Stargard,Sezon 2015/2016
2016-02-13 19:00,GKS Tychy(w),92 : 75P,75,18,34,52.9,9,23,39.1,27,57,47.4,12,15,80.0,10,19,29,14,25,22,18,5,3,3,75,KS Spójnia Stargard,Sezon 2015/2016
2016-02-17 18:00,Exact Systems Śląsk Wrocław(d),63 : 69P,63,21,39,53.8,2,21,9.5,23,60,38.3,15,15,100.0,10,28,38,5,25,19,16,5,5,1,63,KS Spójnia Stargard,Sezon 2015/2016
2016-02-21 16:45,Miasto Szkła Krosno(w),88 : 58P,58,19,50,38.0,4,17,23.5,23,67,34.3,8,13,61.5,9,27,36,10,25,16,16,3,1,6,43,KS Spójnia Stargard,Sezon 2015/2016
2016-02-27 18:00,MKS Znicz Basket Pruszków(d),81 : 76W,81,20,36,55.6,8,17,47.1,28,53,52.8,17,19,89.5,6,15,21,11,19,23,8,6,3,1,87,KS Spójnia Stargard,Sezon 2015/2016
2016-03-05 17:00,SKK Siedlce(d),81 : 76W,81,19,36,52.8,8,25,32.0,27,61,44.3,19,22,86.4,6,22,28,14,15,20,11,8,1,3,84,KS Spójnia Stargard,Sezon 2015/2016
2016-03-12 16:00,Max Elektro Sokół Łańcut(w),84 : 63P,63,14,32,43.8,10,25,40.0,24,57,42.1,5,10,50.0,11,21,32,8,19,20,17,3,1,2,52,KS Spójnia Stargard,Sezon 2015/2016
2016-03-19 17:00,KSK Noteć Inowrocław(d),87 : 71W,87,20,33,60.6,13,29,44.8,33,62,53.2,8,12,66.7,9,30,39,17,19,18,19,4,6,1,101,KS Spójnia Stargard,Sezon 2015/2016
2016-04-03 18:00,GTK Gliwice(w),86 : 72P,72,16,36,44.4,7,27,25.9,23,63,36.5,19,24,79.2,11,26,37,9,23,24,14,3,5,3,67,KS Spójnia Stargard,Sezon 2015/2016
2015-09-26 18:00,SKK Siedlce(d),79 : 58W,79,25,47,53.2,6,22,27.3,31,69,44.9,11,17,64.7,13,29,42,17,20,19,15,14,0,3,93,KSK Noteć Inowrocław,Sezon 2015/2016
2015-10-03 18:00,GTK Gliwice(d),76 : 79P,76,18,36,50.0,8,19,42.1,26,55,47.3,16,22,72.7,5,35,40,19,20,21,19,2,3,0,86,KSK Noteć Inowrocław,Sezon 2015/2016
2015-10-11 18:00,ACK UTH Rosa Radom(w),71 : 65P,65,14,36,38.9,7,25,28.0,21,61,34.4,16,26,61.5,10,24,34,16,19,23,14,9,1,1,61,KSK Noteć Inowrocław,Sezon 2015/2016
2015-10-17 18:00,meritumkredyt Pogoń Prudnik(d),62 : 67P,62,19,44,43.2,5,18,27.8,24,62,38.7,9,17,52.9,14,25,39,9,19,24,18,9,0,1,55,KSK Noteć Inowrocław,Sezon 2015/2016
2015-10-21 19:30,Astoria Bydgoszcz(w),78 : 58P,58,19,44,43.2,3,23,13.0,22,67,32.8,11,16,68.8,10,29,39,10,17,20,17,8,3,6,51,KSK Noteć Inowrocław,Sezon 2015/2016
2015-10-24 18:00,Zetkama Doral Nysa Kłodzko(d),79 : 51W,79,24,42,57.1,7,21,33.3,31,63,49.2,10,14,71.4,9,28,37,19,20,18,7,9,6,1,107,KSK Noteć Inowrocław,Sezon 2015/2016
2015-10-31 15:45,Biofarm Basket Poznań(w),70 : 64P,64,12,26,46.2,11,26,42.3,23,52,44.2,7,15,46.7,5,23,28,17,23,20,17,3,3,5,61,KSK Noteć Inowrocław,Sezon 2015/2016
2015-11-07 18:00,Legia Warszawa(d),66 : 87P,66,17,37,45.9,7,23,30.4,24,60,40.0,11,15,73.3,12,19,31,14,23,19,17,7,5,0,66,KSK Noteć Inowrocław,Sezon 2015/2016
2015-11-11 18:00,AZS AWF Mickiewicz Romus Katowice(w),62 : 69W,69,19,41,46.3,6,18,33.3,25,59,42.4,13,26,50.0,10,28,38,11,15,24,14,6,6,1,69,KSK Noteć Inowrocław,Sezon 2015/2016
2015-11-14 18:00,GKS Tychy(d),75 : 71W,75,21,42,50.0,7,18,38.9,28,60,46.7,12,22,54.5,3,30,33,17,24,20,13,3,3,3,76,KSK Noteć Inowrocław,Sezon 2015/2016
2015-11-21 13:00,Exact Systems Śląsk Wrocław(w),74 : 65P,65,15,39,38.5,7,22,31.8,22,61,36.1,14,24,58.3,16,24,40,13,25,26,25,7,2,2,53,KSK Noteć Inowrocław,Sezon 2015/2016
2015-11-28 18:00,Miasto Szkła Krosno(d),69 : 77P,69,21,41,51.2,5,16,31.3,26,57,45.6,12,16,75.0,7,30,37,10,21,18,16,9,3,3,77,KSK Noteć Inowrocław,Sezon 2015/2016
2015-12-06 18:00,MKS Znicz Basket Pruszków(w),76 : 73P,73,16,40,40.0,11,30,36.7,27,70,38.6,8,13,61.5,9,26,35,15,24,16,16,13,5,4,77,KSK Noteć Inowrocław,Sezon 2015/2016
2015-12-12 18:00,KS Spójnia Stargard(d),84 : 75W,84,20,45,44.4,9,22,40.9,29,67,43.3,17,25,68.0,10,28,38,16,17,23,8,6,4,7,94,KSK Noteć Inowrocław,Sezon 2015/2016
2015-12-19 17:30,Max Elektro Sokół Łańcut(w),78 : 64P,64,12,32,37.5,10,28,35.7,22,60,36.7,10,10,100.0,9,23,32,16,23,18,19,5,3,3,63,KSK Noteć Inowrocław,Sezon 2015/2016
2016-01-02 17:00,SKK Siedlce(w),75 : 62P,62,10,32,31.3,11,26,42.3,21,58,36.2,9,17,52.9,8,17,25,15,19,20,20,9,3,4,49,KSK Noteć Inowrocław,Sezon 2015/2016
2016-01-09 18:00,GTK Gliwice(w),74 : 77W,77,21,37,56.8,5,17,29.4,26,54,48.1,20,29,69.0,11,25,36,11,20,29,21,6,4,1,76,KSK Noteć Inowrocław,Sezon 2015/2016
2016-01-17 19:00,ACK UTH Rosa Radom(d),66 : 56W,66,11,34,32.4,10,34,29.4,21,68,30.9,14,18,77.8,16,32,48,14,17,19,15,7,9,3,78,KSK Noteć Inowrocław,Sezon 2015/2016
2016-01-23 17:30,meritumkredyt Pogoń Prudnik(w),95 : 60P,60,21,43,48.8,4,22,18.2,25,65,38.5,6,12,50.0,10,15,25,12,13,20,14,9,0,1,46,KSK Noteć Inowrocław,Sezon 2015/2016
2016-01-27 18:00,Astoria Bydgoszcz(d),77 : 64W,77,24,51,47.1,6,21,28.6,30,72,41.7,11,19,57.9,13,35,48,22,19,22,15,11,2,3,95,KSK Noteć Inowrocław,Sezon 2015/2016
2016-01-30 17:00,Zetkama Doral Nysa Kłodzko(w),78 : 62P,62,19,35,54.3,5,19,26.3,24,54,44.4,9,14,64.3,8,12,20,22,18,17,17,11,1,5,64,KSK Noteć Inowrocław,Sezon 2015/2016
2016-02-06 18:00,Biofarm Basket Poznań(d),73 : 67W,73,21,42,50.0,7,25,28.0,28,67,41.8,10,15,66.7,17,28,45,17,21,20,16,7,1,3,83,KSK Noteć Inowrocław,Sezon 2015/2016
2016-02-12 19:30,Legia Warszawa(w),116 : 68P,68,15,38,39.5,6,19,31.6,21,57,36.8,20,30,66.7,13,18,31,14,24,25,24,6,3,1,52,KSK Noteć Inowrocław,Sezon 2015/2016
2016-02-17 18:00,AZS AWF Mickiewicz Romus Katowice(d),76 : 72W,76,20,41,48.8,4,16,25.0,24,57,42.1,24,34,70.6,10,32,42,19,20,28,15,5,5,2,89,KSK Noteć Inowrocław,Sezon 2015/2016
2016-02-20 19:00,GKS Tychy(w),94 : 70P,70,15,40,37.5,6,22,27.3,21,62,33.9,22,29,75.9,11,22,33,14,22,29,25,9,3,5,56,KSK Noteć Inowrocław,Sezon 2015/2016
2016-03-02 20:00,Exact Systems Śląsk Wrocław(d),62 : 68P,62,14,40,35.0,7,20,35.0,21,60,35.0,13,17,76.5,11,23,34,15,25,24,20,13,1,2,62,KSK Noteć Inowrocław,Sezon 2015/2016
2016-03-05 17:00,Miasto Szkła Krosno(w),112 : 82P,82,25,49,51.0,6,19,31.6,31,68,45.6,14,17,82.4,8,23,31,23,23,18,18,9,2,4,89,KSK Noteć Inowrocław,Sezon 2015/2016
2016-03-13 18:00,MKS Znicz Basket Pruszków(d),75 : 80P,75,21,47,44.7,8,24,33.3,29,71,40.8,9,15,60.0,13,29,42,21,24,20,21,11,3,4,83,KSK Noteć Inowrocław,Sezon 2015/2016
2016-03-19 17:00,KS Spójnia Stargard(w),87 : 71P,71,22,55,40.0,3,17,17.6,25,72,34.7,18,23,78.3,12,18,30,13,18,19,8,13,1,6,68,KSK Noteć Inowrocław,Sezon 2015/2016
2016-04-03 18:00,Max Elektro Sokół Łańcut(d),56 : 70P,56,16,40,40.0,2,15,13.3,18,55,32.7,18,24,75.0,12,21,33,11,22,23,19,7,2,0,47,KSK Noteć Inowrocław,Sezon 2015/2016
2016-04-09 18:00,AZS AWF Mickiewicz Romus Katowice(d),76 : 80P,76,23,52,44.2,7,23,30.4,30,75,40.0,9,11,81.8,11,31,42,15,21,18,13,6,5,6,84,KSK Noteć Inowrocław,Sezon 2015/2016
2016-04-10 13:00,AZS AWF Mickiewicz Romus Katowice(d),78 : 68W,78,22,45,48.9,6,19,31.6,28,64,43.8,16,21,76.2,12,26,38,13,19,18,15,10,4,2,87,KSK Noteć Inowrocław,Sezon 2015/2016
2016-04-16 18:00,AZS AWF Mickiewicz Romus Katowice(w),96 : 76P,76,20,39,51.3,8,24,33.3,28,63,44.4,12,19,63.2,11,27,38,21,25,21,24,6,1,3,76,KSK Noteć Inowrocław,Sezon 2015/2016
2016-04-17 17:00,AZS AWF Mickiewicz Romus Katowice(w),78 : 86W,86,24,48,50.0,4,17,23.5,28,65,43.1,26,35,74.3,15,25,40,13,21,28,12,11,2,0,94,KSK Noteć Inowrocław,Sezon 2015/2016
2016-04-20 18:00,AZS AWF Mickiewicz Romus Katowice(d),84 : 71W,84,27,44,61.4,3,16,18.8,30,60,50.0,21,35,60.0,14,30,44,16,24,28,20,8,3,0,91,KSK Noteć Inowrocław,Sezon 2015/2016
2015-09-26 18:00,AZS AWF Mickiewicz Romus Katowice(w),67 : 74W,74,20,42,47.6,4,17,23.5,24,59,40.7,22,30,73.3,16,26,42,17,22,26,15,9,4,1,88,Legia Warszawa,Sezon 2015/2016
2015-10-03 18:00,GKS Tychy(w),67 : 73W,73,15,32,46.9,9,21,42.9,24,53,45.3,16,22,72.7,9,26,35,15,16,26,18,6,0,1,76,Legia Warszawa,Sezon 2015/2016
2015-10-11 17:00,Exact Systems Śląsk Wrocław(d),69 : 59W,69,14,35,40.0,8,24,33.3,22,59,37.3,17,29,58.6,15,32,47,18,21,25,18,7,2,2,76,Legia Warszawa,Sezon 2015/2016
2015-10-18 18:00,Miasto Szkła Krosno(w),88 : 73P,73,19,41,46.3,6,23,26.1,25,64,39.1,17,32,53.1,11,21,32,17,23,26,9,8,3,7,70,Legia Warszawa,Sezon 2015/2016
2015-10-21 20:00,MKS Znicz Basket Pruszków(w),71 : 56P,56,14,39,35.9,6,23,26.1,20,62,32.3,10,15,66.7,6,22,28,13,23,22,15,11,2,4,48,Legia Warszawa,Sezon 2015/2016
2015-10-24 17:00,KS Spójnia Stargard(w),82 : 80P,80,22,46,47.8,9,33,27.3,31,79,39.2,9,13,69.2,13,23,36,19,22,18,15,6,2,3,76,Legia Warszawa,Sezon 2015/2016
2015-10-30 20:00,Max Elektro Sokół Łańcut(d),70 : 61W,70,18,31,58.1,7,22,31.8,25,53,47.2,13,24,54.2,11,33,44,13,23,22,26,11,3,3,76,Legia Warszawa,Sezon 2015/2016
2015-11-07 18:00,KSK Noteć Inowrocław(w),66 : 87W,87,20,40,50.0,11,24,45.8,31,64,48.4,14,20,70.0,12,21,33,21,20,23,12,9,0,5,99,Legia Warszawa,Sezon 2015/2016
2015-11-11 18:00,GTK Gliwice(w),77 : 83W,83,14,29,48.3,14,30,46.7,28,59,47.5,13,17,76.5,6,14,20,18,24,22,13,9,1,1,83,Legia Warszawa,Sezon 2015/2016
2015-11-14 15:00,ACK UTH Rosa Radom(w),69 : 95W,95,25,42,59.5,8,16,50.0,33,58,56.9,21,29,72.4,14,31,45,23,14,26,16,7,0,2,121,Legia Warszawa,Sezon 2015/2016
2015-11-21 17:30,meritumkredyt Pogoń Prudnik(w),76 : 59P,59,19,39,48.7,5,27,18.5,24,66,36.4,6,9,66.7,7,25,32,15,22,15,11,6,0,4,56,Legia Warszawa,Sezon 2015/2016
2015-12-02 19:00,Astoria Bydgoszcz(w),73 : 87W,87,21,33,63.6,9,18,50.0,30,51,58.8,18,26,69.2,5,21,26,19,26,26,21,6,4,2,92,Legia Warszawa,Sezon 2015/2016
2015-12-05 18:00,Zetkama Doral Nysa Kłodzko(d),84 : 51W,84,17,35,48.6,10,21,47.6,27,56,48.2,20,29,69.0,9,23,32,28,22,25,16,13,1,0,104,Legia Warszawa,Sezon 2015/2016
2015-12-12 15:45,Biofarm Basket Poznań(w),44 : 75W,75,19,41,46.3,6,16,37.5,25,57,43.9,19,23,82.6,11,25,36,11,20,22,16,13,4,2,87,Legia Warszawa,Sezon 2015/2016
2015-12-19 15:00,SKK Siedlce(d),76 : 69W,76,15,34,44.1,9,28,32.1,24,62,38.7,19,21,90.5,6,26,32,12,18,23,14,9,3,4,78,Legia Warszawa,Sezon 2015/2016
2015-12-23 18:00,AZS AWF Mickiewicz Romus Katowice(d),105 : 70W,105,37,50,74.0,7,21,33.3,44,71,62.0,10,15,66.7,13,23,36,28,16,22,16,10,4,1,135,Legia Warszawa,Sezon 2015/2016
2016-01-10 16:00,GKS Tychy(d),80 : 68W,80,20,34,58.8,7,21,33.3,27,55,49.1,19,33,57.6,4,29,33,18,24,26,16,6,2,5,81,Legia Warszawa,Sezon 2015/2016
2016-01-17 17:00,Exact Systems Śląsk Wrocław(w),83 : 77P,77,17,35,48.6,4,25,16.0,21,60,35.0,31,37,83.8,12,23,35,13,24,31,14,8,5,2,79,Legia Warszawa,Sezon 2015/2016
2016-01-23 19:45,Miasto Szkła Krosno(d),63 : 73P,63,8,27,29.6,12,34,35.3,20,61,32.8,11,19,57.9,11,33,44,15,18,19,22,8,4,0,63,Legia Warszawa,Sezon 2015/2016
2016-01-27 19:45,MKS Znicz Basket Pruszków(d),76 : 70W,76,20,32,62.5,8,28,28.6,28,60,46.7,12,16,75.0,11,18,29,16,18,20,11,10,0,4,84,Legia Warszawa,Sezon 2015/2016
2016-01-31 16:45,KS Spójnia Stargard(d),92 : 77W,92,25,44,56.8,8,22,36.4,33,66,50.0,18,23,78.3,11,24,35,21,18,23,11,8,1,2,108,Legia Warszawa,Sezon 2015/2016
2016-02-06 17:30,Max Elektro Sokół Łańcut(w),73 : 54P,54,15,31,48.4,5,24,20.8,20,55,36.4,9,13,69.2,11,19,30,13,22,22,19,7,0,3,46,Legia Warszawa,Sezon 2015/2016
2016-02-12 19:30,KSK Noteć Inowrocław(d),116 : 68W,116,30,45,66.7,13,27,48.1,43,72,59.7,17,24,70.8,12,27,39,28,25,24,11,13,1,3,150,Legia Warszawa,Sezon 2015/2016
2016-02-17 20:00,GTK Gliwice(d),88 : 77W,88,25,40,62.5,7,20,35.0,32,60,53.3,17,24,70.8,8,19,27,13,21,24,13,11,3,3,94,Legia Warszawa,Sezon 2015/2016
2016-02-20 18:00,ACK UTH Rosa Radom(d),87 : 78W,87,19,40,47.5,9,19,47.4,28,59,47.5,22,26,84.6,7,24,31,14,19,24,13,7,0,1,91,Legia Warszawa,Sezon 2015/2016
2016-02-26 19:30,meritumkredyt Pogoń Prudnik(d),84 : 75W,84,24,45,53.3,9,25,36.0,33,70,47.1,9,14,64.3,8,23,31,23,21,19,16,5,4,1,89,Legia Warszawa,Sezon 2015/2016
2016-03-04 19:00,Astoria Bydgoszcz(d),109 : 73W,109,25,39,64.1,13,28,46.4,38,67,56.7,20,25,80.0,12,23,35,25,23,24,13,11,1,0,134,Legia Warszawa,Sezon 2015/2016
2016-03-12 17:00,Zetkama Doral Nysa Kłodzko(w),82 : 107W,107,22,31,71.0,20,37,54.1,42,68,61.8,3,3,100.0,8,17,25,37,15,13,14,11,0,0,140,Legia Warszawa,Sezon 2015/2016
2016-03-18 19:00,Biofarm Basket Poznań(d),71 : 74P,71,22,42,52.4,2,23,8.7,24,65,36.9,21,23,91.3,14,20,34,11,16,19,16,7,4,4,68,Legia Warszawa,Sezon 2015/2016
2016-04-03 18:00,SKK Siedlce(w),91 : 83P,83,23,46,50.0,6,21,28.6,29,67,43.3,19,25,76.0,5,25,30,15,22,21,11,11,3,6,87,Legia Warszawa,Sezon 2015/2016
2016-04-09 20:00,Astoria Bydgoszcz(d),87 : 70W,87,21,36,58.3,11,27,40.7,32,63,50.8,12,17,70.6,10,23,33,20,19,19,12,6,6,2,104,Legia Warszawa,Sezon 2015/2016
2016-04-10 20:00,Astoria Bydgoszcz(d),92 : 66W,92,23,38,60.5,8,20,40.0,31,58,53.4,22,26,84.6,8,25,33,21,15,22,11,8,5,2,117,Legia Warszawa,Sezon 2015/2016
2016-04-16 20:00,Astoria Bydgoszcz(w),71 : 87W,87,25,40,62.5,7,21,33.3,32,61,52.5,16,21,76.2,10,33,43,22,18,22,19,9,1,0,109,Legia Warszawa,Sezon 2015/2016
2016-04-23 17:30,Max Elektro Sokół Łańcut(w),84 : 76P,76,15,40,37.5,8,21,38.1,23,61,37.7,22,27,81.5,9,18,27,14,22,26,13,8,0,3,69,Legia Warszawa,Sezon 2015/2016
2016-04-24 17:30,Max Elektro Sokół Łańcut(w),47 : 77W,77,18,34,52.9,11,30,36.7,29,64,45.3,8,12,66.7,12,29,41,14,18,15,13,9,5,2,94,Legia Warszawa,Sezon 2015/2016
2016-04-30 18:00,Max Elektro Sokół Łańcut(d),68 : 54W,68,17,41,41.5,8,22,36.4,25,63,39.7,10,11,90.9,8,25,33,15,19,21,9,6,2,2,76,Legia Warszawa,Sezon 2015/2016
2016-05-01 17:00,Max Elektro Sokół Łańcut(d),88 : 78W,88,14,31,45.2,15,23,65.2,29,54,53.7,15,24,62.5,7,20,27,16,20,27,15,8,4,4,94,Legia Warszawa,Sezon 2015/2016
2016-05-07 19:00,Miasto Szkła Krosno(w),70 : 84W,84,14,29,48.3,10,26,38.5,24,55,43.6,26,30,86.7,9,30,39,10,21,26,12,6,7,4,99,Legia Warszawa,Sezon 2015/2016
2016-05-08 18:00,Miasto Szkła Krosno(w),85 : 62P,62,15,32,46.9,6,28,21.4,21,60,35.0,14,18,77.8,8,31,39,15,19,20,16,3,2,2,62,Legia Warszawa,Sezon 2015/2016
2016-05-14 18:00,Miasto Szkła Krosno(d),85 : 57W,85,17,31,54.8,11,29,37.9,28,60,46.7,18,21,85.7,8,29,37,13,23,19,20,10,8,1,98,Legia Warszawa,Sezon 2015/2016
2016-05-15 13:00,Miasto Szkła Krosno(d),54 : 86P,54,15,40,37.5,6,24,25.0,21,64,32.8,6,12,50.0,11,26,37,7,22,18,17,2,2,6,36,Legia Warszawa,Sezon 2015/2016
2016-05-18 18:00,Miasto Szkła Krosno(w),88 : 78P,78,18,37,48.6,6,24,25.0,24,61,39.3,24,31,77.4,7,23,30,15,24,27,9,6,1,7,77,Legia Warszawa,Sezon 2015/2016
2015-09-26 18:00,GTK Gliwice(w),55 : 72W,72,25,43,58.1,3,15,20.0,28,58,48.3,13,18,72.2,8,24,32,13,19,21,9,8,1,1,82,Max Elektro Sokół Łańcut,Sezon 2015/2016
2015-10-03 17:30,ACK UTH Rosa Radom(d),82 : 48W,82,26,47,55.3,8,22,36.4,34,69,49.3,6,12,50.0,15,33,48,23,18,16,15,12,6,2,115,Max Elektro Sokół Łańcut,Sezon 2015/2016
2015-10-10 17:30,meritumkredyt Pogoń Prudnik(w),67 : 76W,76,23,40,57.5,3,25,12.0,26,65,40.0,21,25,84.0,17,17,34,8,25,25,14,7,1,1,69,Max Elektro Sokół Łańcut,Sezon 2015/2016
2015-10-17 17:30,Astoria Bydgoszcz(d),79 : 50W,79,17,45,37.8,10,28,35.7,27,73,37.0,15,22,68.2,24,26,50,18,20,19,9,10,3,0,98,Max Elektro Sokół Łańcut,Sezon 2015/2016
2015-10-21 19:30,Zetkama Doral Nysa Kłodzko(w),82 : 79P,79,19,42,45.2,10,23,43.5,29,65,44.6,11,18,61.1,11,23,34,25,27,21,16,11,3,0,93,Max Elektro Sokół Łańcut,Sezon 2015/2016
2015-10-24 17:30,Biofarm Basket Poznań(d),67 : 51W,67,20,43,46.5,7,24,29.2,27,67,40.3,6,7,85.7,12,26,38,17,19,17,9,15,6,1,93,Max Elektro Sokół Łańcut,Sezon 2015/2016
2015-10-30 20:00,Legia Warszawa(w),70 : 61P,61,16,42,38.1,5,23,21.7,21,65,32.3,14,21,66.7,9,21,30,6,22,23,16,16,3,3,49,Max Elektro Sokół Łańcut,Sezon 2015/2016
2015-11-05 18:00,AZS AWF Mickiewicz Romus Katowice(d),100 : 49W,100,30,49,61.2,6,21,28.6,36,70,51.4,22,25,88.0,12,38,50,27,18,25,11,7,5,0,141,Max Elektro Sokół Łańcut,Sezon 2015/2016
2015-11-11 19:00,GKS Tychy(w),68 : 71W,71,21,41,51.2,5,16,31.3,26,57,45.6,14,16,87.5,3,30,33,11,24,24,14,11,1,5,80,Max Elektro Sokół Łańcut,Sezon 2015/2016
2015-11-14 17:30,Exact Systems Śląsk Wrocław(d),76 : 54W,76,25,45,55.6,4,15,26.7,29,60,48.3,14,16,87.5,13,20,33,19,11,16,16,13,4,0,96,Max Elektro Sokół Łańcut,Sezon 2015/2016
2015-11-22 17:00,Miasto Szkła Krosno(w),72 : 85W,85,18,41,43.9,13,24,54.2,31,65,47.7,10,14,71.4,5,28,33,17,25,21,14,11,0,2,94,Max Elektro Sokół Łańcut,Sezon 2015/2016
2015-11-28 17:30,MKS Znicz Basket Pruszków(d),78 : 63W,78,18,40,45.0,8,24,33.3,26,64,40.6,18,21,85.7,9,28,37,19,23,22,8,10,5,1,100,Max Elektro Sokół Łańcut,Sezon 2015/2016
2015-12-05 17:00,KS Spójnia Stargard(w),61 : 93W,93,26,49,53.1,9,21,42.9,35,70,50.0,14,26,53.8,13,26,39,16,15,22,9,13,3,1,108,Max Elektro Sokół Łańcut,Sezon 2015/2016
2015-12-12 16:00,SKK Siedlce(w),69 : 84W,84,23,53,43.4,8,21,38.1,31,74,41.9,14,15,93.3,12,22,34,15,21,24,9,12,3,2,95,Max Elektro Sokół Łańcut,Sezon 2015/2016
2015-12-19 17:30,KSK Noteć Inowrocław(d),78 : 64W,78,23,40,57.5,7,22,31.8,30,62,48.4,11,19,57.9,8,27,35,18,18,22,11,13,4,3,97,Max Elektro Sokół Łańcut,Sezon 2015/2016
2016-01-02 17:30,GTK Gliwice(d),80 : 63W,80,25,42,59.5,4,21,19.0,29,63,46.0,18,22,81.8,11,28,39,13,22,25,12,10,3,1,95,Max Elektro Sokół Łańcut,Sezon 2015/2016
2016-01-09 16:00,ACK UTH Rosa Radom(w),58 : 69W,69,21,40,52.5,5,15,33.3,26,55,47.3,12,20,60.0,14,28,42,15,19,18,19,8,6,4,84,Max Elektro Sokół Łańcut,Sezon 2015/2016
2016-01-16 17:30,meritumkredyt Pogoń Prudnik(d),69 : 61W,69,17,31,54.8,8,25,32.0,25,56,44.6,11,19,57.9,9,22,31,17,18,23,15,10,7,1,80,Max Elektro Sokół Łańcut,Sezon 2015/2016
2016-01-23 19:00,Astoria Bydgoszcz(w),63 : 71W,71,21,44,47.7,6,24,25.0,27,68,39.7,11,16,68.8,14,24,38,13,21,22,11,12,4,2,81,Max Elektro Sokół Łańcut,Sezon 2015/2016
2016-01-27 18:00,Zetkama Doral Nysa Kłodzko(d),72 : 42W,72,19,36,52.8,8,22,36.4,27,58,46.6,10,13,76.9,15,36,51,18,19,21,20,6,3,0,96,Max Elektro Sokół Łańcut,Sezon 2015/2016
2016-01-31 15:45,Biofarm Basket Poznań(w),56 : 50P,50,14,34,41.2,5,28,17.9,19,62,30.6,7,15,46.7,12,24,36,9,19,18,9,5,4,2,44,Max Elektro Sokół Łańcut,Sezon 2015/2016
2016-02-06 17:30,Legia Warszawa(d),73 : 54W,73,19,39,48.7,7,26,26.9,26,65,40.0,14,20,70.0,19,25,44,16,22,21,15,13,3,0,89,Max Elektro Sokół Łańcut,Sezon 2015/2016
2016-02-13 18:00,AZS AWF Mickiewicz Romus Katowice(w),60 : 66W,66,13,35,37.1,7,21,33.3,20,56,35.7,19,26,73.1,12,27,39,15,19,26,15,7,5,1,74,Max Elektro Sokół Łańcut,Sezon 2015/2016
2016-02-17 18:00,GKS Tychy(d),73 : 67W,73,25,51,49.0,4,15,26.7,29,66,43.9,11,15,73.3,15,22,37,5,19,22,16,12,3,9,73,Max Elektro Sokół Łańcut,Sezon 2015/2016
2016-02-20 15:30,Exact Systems Śląsk Wrocław(w),49 : 74W,74,23,49,46.9,8,16,50.0,31,65,47.7,4,5,80.0,11,34,45,13,24,14,14,7,6,1,96,Max Elektro Sokół Łańcut,Sezon 2015/2016
2016-02-27 17:30,Miasto Szkła Krosno(d),80 : 84P,80,20,43,46.5,6,22,27.3,26,65,40.0,22,26,84.6,17,16,33,15,24,21,11,9,5,2,88,Max Elektro Sokół Łańcut,Sezon 2015/2016
2016-03-05 18:00,MKS Znicz Basket Pruszków(w),72 : 68P,68,16,35,45.7,8,22,36.4,24,57,42.1,12,13,92.3,10,22,32,7,19,20,21,10,4,1,66,Max Elektro Sokół Łańcut,Sezon 2015/2016
2016-03-12 16:00,KS Spójnia Stargard(d),84 : 63W,84,29,53,54.7,6,15,40.0,35,68,51.5,8,11,72.7,12,23,35,18,20,19,9,11,2,1,105,Max Elektro Sokół Łańcut,Sezon 2015/2016
2016-03-19 17:30,SKK Siedlce(d),93 : 87W,93,22,39,56.4,10,24,41.7,32,63,50.8,19,26,73.1,6,19,25,19,22,22,5,11,1,1,106,Max Elektro Sokół Łańcut,Sezon 2015/2016
2016-04-03 18:00,KSK Noteć Inowrocław(w),56 : 70W,70,14,30,46.7,9,24,37.5,23,54,42.6,15,18,83.3,7,24,31,15,23,22,15,10,0,2,77,Max Elektro Sokół Łańcut,Sezon 2015/2016
2016-04-09 18:00,meritumkredyt Pogoń Prudnik(d),83 : 62W,83,20,33,60.6,9,23,39.1,29,56,51.8,16,20,80.0,8,27,35,19,22,20,11,8,4,0,107,Max Elektro Sokół Łańcut,Sezon 2015/2016
2016-04-10 18:00,meritumkredyt Pogoń Prudnik(d),67 : 58W,67,18,35,51.4,6,19,31.6,24,54,44.4,13,17,76.5,7,29,36,10,19,20,13,4,4,4,74,Max Elektro Sokół Łańcut,Sezon 2015/2016
2016-04-16 17:30,meritumkredyt Pogoń Prudnik(w),74 : 65P,65,19,37,51.4,6,29,20.7,25,66,37.9,9,13,69.2,7,17,24,11,20,22,12,8,0,3,51,Max Elektro Sokół Łańcut,Sezon 2015/2016
2016-04-17 17:30,meritumkredyt Pogoń Prudnik(w),71 : 73W,73,24,46,52.2,7,29,24.1,31,75,41.3,4,5,80.0,15,21,36,14,25,14,11,8,2,3,77,Max Elektro Sokół Łańcut,Sezon 2015/2016
2016-04-23 17:30,Legia Warszawa(d),84 : 76W,84,24,45,53.3,6,14,42.9,30,59,50.8,18,20,90.0,6,30,36,17,26,22,12,9,3,0,106,Max Elektro Sokół Łańcut,Sezon 2015/2016
2016-04-24 17:30,Legia Warszawa(d),47 : 77P,47,10,42,23.8,5,19,26.3,15,61,24.6,12,13,92.3,12,19,31,7,15,18,15,8,2,5,33,Max Elektro Sokół Łańcut,Sezon 2015/2016
2016-04-30 18:00,Legia Warszawa(w),68 : 54P,54,15,44,34.1,4,17,23.5,19,61,31.1,12,15,80.0,13,24,37,8,21,19,15,5,2,2,46,Max Elektro Sokół Łańcut,Sezon 2015/2016
2016-05-01 17:00,Legia Warszawa(w),88 : 78P,78,9,30,30.0,16,30,53.3,25,60,41.7,12,14,85.7,7,18,25,9,27,19,15,6,4,4,70,Max Elektro Sokół Łańcut,Sezon 2015/2016
2016-05-07 18:00,GKS Tychy(w),69 : 92W,92,29,53,54.7,6,20,30.0,35,73,47.9,16,20,80.0,16,21,37,23,20,21,12,12,1,3,111,Max Elektro Sokół Łańcut,Sezon 2015/2016
2016-05-14 17:30,GKS Tychy(d),86 : 92P,86,24,41,58.5,8,28,28.6,32,69,46.4,14,24,58.3,16,28,44,17,28,22,14,5,1,2,92,Max Elektro Sokół Łańcut,Sezon 2015/2016
2015-09-27 17:00,MKS Znicz Basket Pruszków(w),80 : 62P,62,20,48,41.7,5,14,35.7,25,62,40.3,7,14,50.0,13,17,30,9,23,17,16,6,2,5,49,meritumkredyt Pogoń Prudnik,Sezon 2015/2016
2015-10-03 17:30,KS Spójnia Stargard(w),57 : 73W,73,21,39,53.8,5,13,38.5,26,52,50.0,16,21,76.2,6,23,29,17,18,23,17,9,4,5,84,meritumkredyt Pogoń Prudnik,Sezon 2015/2016
2015-10-10 17:30,Max Elektro Sokół Łańcut(d),67 : 76P,67,12,32,37.5,6,17,35.3,18,49,36.7,25,29,86.2,6,15,21,8,25,24,17,9,1,1,54,meritumkredyt Pogoń Prudnik,Sezon 2015/2016
2015-10-17 18:00,KSK Noteć Inowrocław(w),62 : 67W,67,14,39,35.9,7,20,35.0,21,59,35.6,18,25,72.0,14,21,35,15,24,18,14,11,1,0,70,meritumkredyt Pogoń Prudnik,Sezon 2015/2016
2015-10-21 18:30,GTK Gliwice(d),69 : 60W,69,18,43,41.9,6,18,33.3,24,61,39.3,15,17,88.2,7,21,28,15,17,18,12,9,2,2,72,meritumkredyt Pogoń Prudnik,Sezon 2015/2016
2015-10-25 17:00,ACK UTH Rosa Radom(w),71 : 78W,78,14,33,42.4,11,17,64.7,25,50,50.0,17,22,77.3,3,19,22,15,20,20,9,4,4,4,84,meritumkredyt Pogoń Prudnik,Sezon 2015/2016
2015-10-31 17:30,SKK Siedlce(d),63 : 68P,63,15,37,40.5,7,26,26.9,22,63,34.9,12,15,80.0,8,26,34,14,24,21,10,9,1,0,67,meritumkredyt Pogoń Prudnik,Sezon 2015/2016
2015-11-07 17:30,Astoria Bydgoszcz(d),87 : 81W,87,21,39,53.8,9,21,42.9,30,60,50.0,18,25,72.0,9,15,24,22,22,23,16,7,2,1,89,meritumkredyt Pogoń Prudnik,Sezon 2015/2016
2015-11-11 17:00,Zetkama Doral Nysa Kłodzko(w),73 : 59P,59,15,28,53.6,6,26,23.1,21,54,38.9,11,13,84.6,7,15,22,20,19,20,19,14,2,1,63,meritumkredyt Pogoń Prudnik,Sezon 2015/2016
2015-11-15 17:00,Biofarm Basket Poznań(d),70 : 52W,70,17,34,50.0,6,19,31.6,23,53,43.4,18,21,85.7,8,28,36,16,21,22,21,16,1,1,85,meritumkredyt Pogoń Prudnik,Sezon 2015/2016
2015-11-21 17:30,Legia Warszawa(d),76 : 59W,76,21,46,45.7,5,18,27.8,26,64,40.6,19,21,90.5,13,28,41,14,15,21,8,6,4,0,93,meritumkredyt Pogoń Prudnik,Sezon 2015/2016
2015-11-28 17:30,AZS AWF Mickiewicz Romus Katowice(d),70 : 54W,70,16,39,41.0,7,23,30.4,23,62,37.1,17,21,81.0,10,24,34,12,11,24,13,9,5,1,74,meritumkredyt Pogoń Prudnik,Sezon 2015/2016
2015-12-05 18:00,GKS Tychy(w),104 : 71P,71,22,43,51.2,4,13,30.8,26,56,46.4,15,16,93.8,8,24,32,9,21,18,20,4,4,8,69,meritumkredyt Pogoń Prudnik,Sezon 2015/2016
2015-12-12 17:30,Exact Systems Śląsk Wrocław(d),84 : 64W,84,12,26,46.2,15,34,44.1,27,60,45.0,15,20,75.0,13,18,31,18,27,22,11,5,0,0,89,meritumkredyt Pogoń Prudnik,Sezon 2015/2016
2015-12-20 17:00,Miasto Szkła Krosno(w),79 : 58P,58,19,35,54.3,4,18,22.2,23,53,43.4,8,11,72.7,4,26,30,16,15,20,22,7,1,3,57,meritumkredyt Pogoń Prudnik,Sezon 2015/2016
2016-01-03 17:00,MKS Znicz Basket Pruszków(d),74 : 69W,74,20,38,52.6,7,21,33.3,27,59,45.8,13,17,76.5,9,22,31,19,18,17,8,5,2,0,87,meritumkredyt Pogoń Prudnik,Sezon 2015/2016
2016-01-09 17:30,KS Spójnia Stargard(d),65 : 61W,65,21,41,51.2,4,21,19.0,25,62,40.3,11,17,64.7,9,23,32,14,15,19,15,8,1,2,62,meritumkredyt Pogoń Prudnik,Sezon 2015/2016
2016-01-16 17:30,Max Elektro Sokół Łańcut(w),69 : 61P,61,15,33,45.5,8,23,34.8,23,56,41.1,7,12,58.3,8,23,31,17,23,18,17,8,1,7,63,meritumkredyt Pogoń Prudnik,Sezon 2015/2016
2016-01-23 17:30,KSK Noteć Inowrocław(d),95 : 60W,95,21,33,63.6,16,31,51.6,37,64,57.8,5,7,71.4,9,29,38,25,20,13,17,6,1,0,119,meritumkredyt Pogoń Prudnik,Sezon 2015/2016
2016-01-27 20:00,GTK Gliwice(w),73 : 65P,65,17,33,51.5,4,20,20.0,21,53,39.6,19,28,67.9,7,22,29,8,19,26,10,10,2,2,63,meritumkredyt Pogoń Prudnik,Sezon 2015/2016
2016-01-30 17:30,ACK UTH Rosa Radom(d),68 : 58W,68,19,35,54.3,2,16,12.5,21,51,41.2,24,27,88.9,7,27,34,16,24,24,12,4,4,0,81,meritumkredyt Pogoń Prudnik,Sezon 2015/2016
2016-02-06 19:00,SKK Siedlce(w),88 : 82P,82,23,45,51.1,8,22,36.4,31,67,46.3,12,18,66.7,6,28,34,11,24,22,12,9,3,2,85,meritumkredyt Pogoń Prudnik,Sezon 2015/2016
2016-02-17 18:30,Zetkama Doral Nysa Kłodzko(d),80 : 59W,80,21,34,61.8,8,24,33.3,29,58,50.0,14,16,87.5,2,23,25,22,18,20,10,7,1,0,94,meritumkredyt Pogoń Prudnik,Sezon 2015/2016
2016-02-20 19:30,Biofarm Basket Poznań(w),52 : 67W,67,17,39,43.6,7,18,38.9,24,57,42.1,12,17,70.6,6,28,34,17,18,19,12,11,4,3,83,meritumkredyt Pogoń Prudnik,Sezon 2015/2016
2016-02-26 19:30,Legia Warszawa(w),84 : 75P,75,21,44,47.7,7,20,35.0,28,64,43.8,12,16,75.0,8,20,28,12,21,21,15,10,1,4,71,meritumkredyt Pogoń Prudnik,Sezon 2015/2016
2016-03-05 18:00,AZS AWF Mickiewicz Romus Katowice(w),82 : 77P,77,19,37,51.4,9,23,39.1,28,60,46.7,12,16,75.0,9,27,36,20,17,16,19,6,3,4,87,meritumkredyt Pogoń Prudnik,Sezon 2015/2016
2016-03-12 17:30,GKS Tychy(d),78 : 75W,78,12,27,44.4,11,26,42.3,23,53,43.4,21,25,84.0,5,17,22,14,25,25,16,11,4,3,79,meritumkredyt Pogoń Prudnik,Sezon 2015/2016
2016-03-19 13:00,Exact Systems Śląsk Wrocław(w),67 : 61P,61,13,36,36.1,7,22,31.8,20,58,34.5,14,22,63.6,12,21,33,9,23,23,21,6,1,6,43,meritumkredyt Pogoń Prudnik,Sezon 2015/2016
2016-03-23 19:00,Astoria Bydgoszcz(w),80 : 69P,69,14,36,38.9,9,23,39.1,23,59,39.0,14,20,70.0,10,19,29,10,21,23,17,8,3,4,60,meritumkredyt Pogoń Prudnik,Sezon 2015/2016
2016-04-03 18:00,Miasto Szkła Krosno(d),57 : 66P,57,20,33,60.6,4,22,18.2,24,55,43.6,5,6,83.3,9,22,31,11,21,17,16,4,1,0,56,meritumkredyt Pogoń Prudnik,Sezon 2015/2016
2016-04-09 18:00,Max Elektro Sokół Łańcut(w),83 : 62P,62,12,35,34.3,9,17,52.9,21,52,40.4,11,13,84.6,3,20,23,13,20,22,16,8,0,4,57,meritumkredyt Pogoń Prudnik,Sezon 2015/2016
2016-04-10 18:00,Max Elektro Sokół Łańcut(w),67 : 58P,58,16,35,45.7,5,19,26.3,21,54,38.9,11,19,57.9,7,19,26,6,20,19,13,5,4,4,45,meritumkredyt Pogoń Prudnik,Sezon 2015/2016
2016-04-16 17:30,Max Elektro Sokół Łańcut(d),74 : 65W,74,24,38,63.2,3,17,17.6,27,55,49.1,17,20,85.0,9,28,37,13,22,20,20,8,3,0,84,meritumkredyt Pogoń Prudnik,Sezon 2015/2016
2016-04-17 17:30,Max Elektro Sokół Łańcut(d),71 : 73P,71,16,28,57.1,4,21,19.0,20,49,40.8,27,30,90.0,6,22,28,10,14,25,13,3,3,2,70,meritumkredyt Pogoń Prudnik,Sezon 2015/2016
2015-09-27 18:00,Astoria Bydgoszcz(d),74 : 54W,74,23,47,48.9,8,24,33.3,31,71,43.7,4,9,44.4,15,32,47,19,17,18,15,1,5,2,86,Miasto Szkła Krosno,Sezon 2015/2016
2015-10-04 18:00,Zetkama Doral Nysa Kłodzko(d),93 : 43W,93,26,41,63.4,11,25,44.0,37,66,56.1,8,13,61.5,8,29,37,24,13,20,16,9,3,1,116,Miasto Szkła Krosno,Sezon 2015/2016
2015-10-10 15:45,Biofarm Basket Poznań(w),51 : 76W,76,23,37,62.2,5,20,25.0,28,57,49.1,15,18,83.3,9,38,47,14,17,22,23,11,5,1,98,Miasto Szkła Krosno,Sezon 2015/2016
2015-10-18 18:00,Legia Warszawa(d),88 : 73W,88,21,41,51.2,10,28,35.7,31,69,44.9,16,22,72.7,15,32,47,14,26,22,12,3,7,3,103,Miasto Szkła Krosno,Sezon 2015/2016
2015-10-21 18:00,AZS AWF Mickiewicz Romus Katowice(w),68 : 84W,84,25,42,59.5,7,15,46.7,32,57,56.1,13,16,81.3,7,26,33,23,16,18,16,8,5,1,109,Miasto Szkła Krosno,Sezon 2015/2016
2015-10-25 18:00,GKS Tychy(d),78 : 69W,78,19,36,52.8,8,27,29.6,27,63,42.9,16,24,66.7,13,22,35,19,21,24,16,5,0,0,77,Miasto Szkła Krosno,Sezon 2015/2016
2015-10-30 17:00,Exact Systems Śląsk Wrocław(w),54 : 93W,93,13,26,50.0,15,29,51.7,28,55,50.9,22,29,75.9,11,33,44,12,19,26,21,6,6,1,106,Miasto Szkła Krosno,Sezon 2015/2016
2015-11-07 18:00,SKK Siedlce(w),69 : 100W,100,26,38,68.4,12,28,42.9,38,66,57.6,12,13,92.3,4,23,27,21,9,20,8,10,1,0,122,Miasto Szkła Krosno,Sezon 2015/2016
2015-11-11 18:00,MKS Znicz Basket Pruszków(d),83 : 67W,83,20,36,55.6,13,29,44.8,33,65,50.8,4,6,66.7,10,26,36,26,15,16,12,5,5,1,109,Miasto Szkła Krosno,Sezon 2015/2016
2015-11-14 17:00,KS Spójnia Stargard(w),80 : 96W,96,21,42,50.0,13,24,54.2,34,66,51.5,15,18,83.3,12,20,32,23,13,22,12,9,2,2,115,Miasto Szkła Krosno,Sezon 2015/2016
2015-11-22 17:00,Max Elektro Sokół Łańcut(d),72 : 85P,72,18,34,52.9,5,24,20.8,23,58,39.7,21,27,77.8,9,27,36,12,22,25,15,7,2,0,73,Miasto Szkła Krosno,Sezon 2015/2016
2015-11-28 18:00,KSK Noteć Inowrocław(w),69 : 77W,77,19,44,43.2,11,27,40.7,30,71,42.3,6,8,75.0,7,23,30,17,18,20,13,9,3,3,80,Miasto Szkła Krosno,Sezon 2015/2016
2015-12-05 18:00,GTK Gliwice(w),47 : 88W,88,23,38,60.5,8,23,34.8,31,61,50.8,18,23,78.3,14,27,41,12,21,27,12,9,1,1,104,Miasto Szkła Krosno,Sezon 2015/2016
2015-12-12 15:00,ACK UTH Rosa Radom(w),63 : 83W,83,18,33,54.5,13,23,56.5,31,56,55.4,8,12,66.7,9,21,30,17,20,16,13,8,3,0,99,Miasto Szkła Krosno,Sezon 2015/2016
2015-12-20 17:00,meritumkredyt Pogoń Prudnik(d),79 : 58W,79,22,36,61.1,10,31,32.3,32,67,47.8,5,8,62.5,10,23,33,21,20,15,14,16,3,1,100,Miasto Szkła Krosno,Sezon 2015/2016
2016-01-03 19:00,Astoria Bydgoszcz(w),71 : 114W,114,27,41,65.9,15,36,41.7,42,77,54.5,15,22,68.2,12,28,40,31,23,24,11,17,4,0,153,Miasto Szkła Krosno,Sezon 2015/2016
2016-01-09 17:00,Zetkama Doral Nysa Kłodzko(w),61 : 104W,104,24,36,66.7,15,32,46.9,39,68,57.4,11,18,61.1,15,25,40,34,20,21,14,9,3,2,140,Miasto Szkła Krosno,Sezon 2015/2016
2016-01-17 17:00,Biofarm Basket Poznań(d),98 : 62W,98,26,33,78.8,12,30,40.0,38,63,60.3,10,12,83.3,6,26,32,27,19,17,15,12,3,1,130,Miasto Szkła Krosno,Sezon 2015/2016
2016-01-23 19:45,Legia Warszawa(w),63 : 73W,73,18,40,45.0,8,33,24.2,26,73,35.6,13,21,61.9,12,28,40,12,19,18,15,9,0,4,64,Miasto Szkła Krosno,Sezon 2015/2016
2016-01-27 18:00,AZS AWF Mickiewicz Romus Katowice(d),98 : 67W,98,29,49,59.2,9,29,31.0,38,78,48.7,13,17,76.5,19,28,47,22,17,18,11,6,4,0,122,Miasto Szkła Krosno,Sezon 2015/2016
2016-01-30 18:00,GKS Tychy(w),51 : 90W,90,21,37,56.8,12,29,41.4,33,66,50.0,12,13,92.3,6,23,29,26,18,22,11,15,6,6,121,Miasto Szkła Krosno,Sezon 2015/2016
2016-02-07 17:00,Exact Systems Śląsk Wrocław(d),81 : 68W,81,17,38,44.7,7,21,33.3,24,59,40.7,26,34,76.5,8,26,34,17,25,28,9,7,7,1,94,Miasto Szkła Krosno,Sezon 2015/2016
2016-02-14 17:00,SKK Siedlce(d),86 : 59W,86,18,41,43.9,11,30,36.7,29,71,40.8,17,19,89.5,13,25,38,27,17,21,9,11,4,1,113,Miasto Szkła Krosno,Sezon 2015/2016
2016-02-17 19:00,MKS Znicz Basket Pruszków(w),59 : 70W,70,21,42,50.0,6,23,26.1,27,65,41.5,10,10,100.0,10,28,38,15,20,18,14,8,3,6,82,Miasto Szkła Krosno,Sezon 2015/2016
2016-02-21 16:45,KS Spójnia Stargard(d),88 : 58W,88,25,42,59.5,7,25,28.0,32,67,47.8,17,26,65.4,9,33,42,22,16,25,7,7,6,1,114,Miasto Szkła Krosno,Sezon 2015/2016
2016-02-27 17:30,Max Elektro Sokół Łańcut(w),80 : 84W,84,14,28,50.0,11,20,55.0,25,48,52.1,23,30,76.7,7,22,29,17,21,24,15,5,2,5,92,Miasto Szkła Krosno,Sezon 2015/2016
2016-03-05 17:00,KSK Noteć Inowrocław(d),112 : 82W,112,25,42,59.5,14,34,41.2,39,76,51.3,20,24,83.3,9,28,37,31,18,23,12,13,4,2,144,Miasto Szkła Krosno,Sezon 2015/2016
2016-03-12 17:00,GTK Gliwice(d),102 : 58W,102,26,36,72.2,12,29,41.4,38,65,58.5,14,18,77.8,12,33,45,28,20,21,16,8,7,2,143,Miasto Szkła Krosno,Sezon 2015/2016
2016-03-20 17:00,ACK UTH Rosa Radom(d),103 : 67W,103,26,34,76.5,12,29,41.4,38,63,60.3,15,21,71.4,6,25,31,29,15,20,5,5,4,2,136,Miasto Szkła Krosno,Sezon 2015/2016
2016-04-03 18:00,meritumkredyt Pogoń Prudnik(w),57 : 66W,66,14,25,56.0,8,31,25.8,22,56,39.3,14,20,70.0,8,21,29,17,17,21,10,7,1,0,70,Miasto Szkła Krosno,Sezon 2015/2016
2016-04-09 18:00,Zetkama Doral Nysa Kłodzko(d),80 : 70W,80,22,36,61.1,9,25,36.0,31,61,50.8,9,14,64.3,5,32,37,22,16,18,9,6,2,2,103,Miasto Szkła Krosno,Sezon 2015/2016
2016-04-10 18:00,Zetkama Doral Nysa Kłodzko(d),100 : 62W,100,15,21,71.4,18,38,47.4,33,59,55.9,16,18,88.9,5,25,30,24,18,22,12,7,4,1,125,Miasto Szkła Krosno,Sezon 2015/2016
2016-04-16 17:00,Zetkama Doral Nysa Kłodzko(w),58 : 85W,85,21,39,53.8,7,23,30.4,28,62,45.2,22,25,88.0,10,29,39,19,20,22,13,13,2,0,108,Miasto Szkła Krosno,Sezon 2015/2016
2016-04-23 18:00,GKS Tychy(d),105 : 75W,105,18,30,60.0,16,34,47.1,34,64,53.1,21,25,84.0,8,25,33,20,21,23,14,12,3,0,125,Miasto Szkła Krosno,Sezon 2015/2016
2016-04-24 18:00,GKS Tychy(d),84 : 69W,84,13,25,52.0,12,27,44.4,25,52,48.1,22,29,75.9,5,30,35,13,20,27,13,5,4,1,94,Miasto Szkła Krosno,Sezon 2015/2016
2016-04-30 16:00,GKS Tychy(w),82 : 105W,105,29,42,69.0,7,16,43.8,36,58,62.1,26,29,89.7,6,23,29,17,21,30,17,8,3,1,120,Miasto Szkła Krosno,Sezon 2015/2016
2016-05-07 19:00,Legia Warszawa(d),70 : 84P,70,20,48,41.7,7,25,28.0,27,73,37.0,9,15,60.0,12,21,33,14,26,21,9,6,4,7,66,Miasto Szkła Krosno,Sezon 2015/2016
2016-05-08 18:00,Legia Warszawa(d),85 : 62W,85,20,41,48.8,10,29,34.5,30,70,42.9,15,18,83.3,6,29,35,16,20,18,6,8,2,2,97,Miasto Szkła Krosno,Sezon 2015/2016
2016-05-14 18:00,Legia Warszawa(w),85 : 57P,57,9,32,28.1,8,29,27.6,17,61,27.9,15,19,78.9,9,19,28,9,19,23,19,10,1,8,38,Miasto Szkła Krosno,Sezon 2015/2016
2016-05-15 13:00,Legia Warszawa(w),54 : 86W,86,18,39,46.2,11,33,33.3,29,72,40.3,17,21,81.0,14,28,42,22,18,22,7,10,6,2,112,Miasto Szkła Krosno,Sezon 2015/2016
2016-05-18 18:00,Legia Warszawa(d),88 : 78W,88,21,40,52.5,9,18,50.0,30,58,51.7,19,25,76.0,5,31,36,16,27,24,10,3,6,1,105,Miasto Szkła Krosno,Sezon 2015/2016
2015-09-27 17:00,meritumkredyt Pogoń Prudnik(d),80 : 62W,80,19,33,57.6,8,20,40.0,27,53,50.9,18,24,75.0,8,22,30,18,17,23,11,11,5,2,101,MKS Znicz Basket Pruszków,Sezon 2015/2016
2015-10-03 19:00,Astoria Bydgoszcz(d),73 : 71W,73,19,39,48.7,9,23,39.1,28,62,45.2,8,13,61.5,16,27,43,18,19,18,23,8,3,2,83,MKS Znicz Basket Pruszków,Sezon 2015/2016
2015-10-18 17:00,Biofarm Basket Poznań(d),56 : 50W,56,16,39,41.0,4,21,19.0,20,60,33.3,12,16,75.0,16,28,44,8,19,24,20,3,4,5,51,MKS Znicz Basket Pruszków,Sezon 2015/2016
2015-10-21 20:00,Legia Warszawa(d),71 : 56W,71,12,37,32.4,11,26,42.3,23,63,36.5,14,20,70.0,15,28,43,14,22,22,20,11,4,2,77,MKS Znicz Basket Pruszków,Sezon 2015/2016
2015-10-25 17:00,AZS AWF Mickiewicz Romus Katowice(d),75 : 63W,75,26,49,53.1,3,17,17.6,29,66,43.9,14,18,77.8,15,24,39,13,14,19,12,13,2,3,89,MKS Znicz Basket Pruszków,Sezon 2015/2016
2015-10-28 19:30,Zetkama Doral Nysa Kłodzko(w),71 : 79W,79,30,53,56.6,4,17,23.5,34,70,48.6,7,9,77.8,12,25,37,29,12,19,16,10,2,3,103,MKS Znicz Basket Pruszków,Sezon 2015/2016
2015-10-31 18:00,GKS Tychy(w),87 : 70P,70,20,43,46.5,7,17,41.2,27,60,45.0,9,14,64.3,9,21,30,9,18,18,12,4,1,1,64,MKS Znicz Basket Pruszków,Sezon 2015/2016
2015-11-08 17:00,Exact Systems Śląsk Wrocław(d),75 : 74W,75,16,35,45.7,6,13,46.2,22,48,45.8,25,34,73.5,12,24,36,11,21,29,22,8,6,4,79,MKS Znicz Basket Pruszków,Sezon 2015/2016
2015-11-11 18:00,Miasto Szkła Krosno(w),83 : 67P,67,22,56,39.3,4,16,25.0,26,72,36.1,11,15,73.3,14,20,34,12,16,15,12,9,1,5,61,MKS Znicz Basket Pruszków,Sezon 2015/2016
2015-11-14 19:00,SKK Siedlce(w),79 : 75P,75,17,39,43.6,11,22,50.0,28,61,45.9,8,13,61.5,7,28,35,11,23,18,18,1,3,3,69,MKS Znicz Basket Pruszków,Sezon 2015/2016
2015-11-22 17:00,KS Spójnia Stargard(d),78 : 81P,78,20,46,43.5,6,20,30.0,26,66,39.4,20,29,69.0,12,24,36,17,21,24,13,12,3,3,84,MKS Znicz Basket Pruszków,Sezon 2015/2016
2015-11-28 17:30,Max Elektro Sokół Łańcut(w),78 : 63P,63,16,39,41.0,7,21,33.3,23,60,38.3,10,20,50.0,11,27,38,8,23,23,19,4,1,4,48,MKS Znicz Basket Pruszków,Sezon 2015/2016
2015-12-06 18:00,KSK Noteć Inowrocław(d),76 : 73W,76,20,43,46.5,8,24,33.3,28,67,41.8,12,22,54.5,15,29,44,9,16,24,18,9,4,5,75,MKS Znicz Basket Pruszków,Sezon 2015/2016
2015-12-12 18:00,GTK Gliwice(w),54 : 65W,65,20,49,40.8,4,25,16.0,24,74,32.4,13,18,72.2,15,30,45,11,23,18,10,12,3,5,71,MKS Znicz Basket Pruszków,Sezon 2015/2016
2015-12-20 17:00,ACK UTH Rosa Radom(d),76 : 69W,76,17,33,51.5,10,29,34.5,27,62,43.5,12,18,66.7,15,25,40,16,19,19,18,9,3,1,85,MKS Znicz Basket Pruszków,Sezon 2015/2016
2016-01-03 17:00,meritumkredyt Pogoń Prudnik(w),74 : 69P,69,22,42,52.4,5,18,27.8,27,60,45.0,10,16,62.5,9,23,32,15,18,18,10,4,0,2,71,MKS Znicz Basket Pruszków,Sezon 2015/2016
2016-01-09 19:00,Astoria Bydgoszcz(w),91 : 88P,88,18,34,52.9,9,21,42.9,27,55,49.1,25,36,69.4,10,25,35,20,22,28,19,4,1,5,90,MKS Znicz Basket Pruszków,Sezon 2015/2016
2016-01-17 17:00,Zetkama Doral Nysa Kłodzko(d),69 : 56W,69,14,36,38.9,8,18,44.4,22,54,40.7,17,27,63.0,12,22,34,14,14,23,15,13,4,3,77,MKS Znicz Basket Pruszków,Sezon 2015/2016
2016-01-23 15:45,Biofarm Basket Poznań(w),60 : 61W,61,17,40,42.5,6,18,33.3,23,58,39.7,9,15,60.0,13,23,36,18,20,21,19,8,4,6,67,MKS Znicz Basket Pruszków,Sezon 2015/2016
2016-01-27 19:45,Legia Warszawa(w),76 : 70P,70,16,31,51.6,9,25,36.0,25,56,44.6,11,17,64.7,13,21,34,17,20,17,17,6,4,0,77,MKS Znicz Basket Pruszków,Sezon 2015/2016
2016-01-30 18:00,AZS AWF Mickiewicz Romus Katowice(w),61 : 88W,88,20,32,62.5,11,26,42.3,31,58,53.4,15,23,65.2,12,31,43,22,19,24,18,9,6,1,115,MKS Znicz Basket Pruszków,Sezon 2015/2016
2016-02-06 18:00,GKS Tychy(d),61 : 57W,61,14,37,37.8,6,18,33.3,20,55,36.4,15,23,65.2,9,27,36,13,18,23,17,8,2,2,60,MKS Znicz Basket Pruszków,Sezon 2015/2016
2016-02-17 19:00,Miasto Szkła Krosno(d),59 : 70P,59,18,37,48.6,3,19,15.8,21,56,37.5,14,20,70.0,6,22,28,8,19,19,15,9,7,3,55,MKS Znicz Basket Pruszków,Sezon 2015/2016
2016-02-20 18:00,SKK Siedlce(d),78 : 86P,78,20,41,48.8,7,25,28.0,27,66,40.9,17,28,60.7,13,18,31,15,19,23,13,11,1,3,73,MKS Znicz Basket Pruszków,Sezon 2015/2016
2016-02-27 18:00,KS Spójnia Stargard(w),81 : 76P,76,23,44,52.3,7,23,30.4,30,67,44.8,9,13,69.2,20,18,38,12,23,19,13,4,1,3,77,MKS Znicz Basket Pruszków,Sezon 2015/2016
2016-03-05 18:00,Max Elektro Sokół Łańcut(d),72 : 68W,72,21,41,51.2,6,18,33.3,27,59,45.8,12,16,75.0,6,21,27,15,20,19,17,13,1,4,75,MKS Znicz Basket Pruszków,Sezon 2015/2016
2016-03-09 17:00,Exact Systems Śląsk Wrocław(w),72 : 76W,76,26,44,59.1,2,10,20.0,28,54,51.9,18,32,56.3,12,24,36,14,23,27,21,9,4,1,78,MKS Znicz Basket Pruszków,Sezon 2015/2016
2016-03-13 18:00,KSK Noteć Inowrocław(w),75 : 80W,80,19,45,42.2,9,24,37.5,28,69,40.6,15,22,68.2,13,27,40,13,20,24,19,14,4,3,84,MKS Znicz Basket Pruszków,Sezon 2015/2016
2016-03-19 18:00,GTK Gliwice(d),79 : 67W,79,28,48,58.3,2,9,22.2,30,57,52.6,17,30,56.7,9,26,35,17,21,26,22,15,1,3,85,MKS Znicz Basket Pruszków,Sezon 2015/2016
2016-04-03 18:00,ACK UTH Rosa Radom(w),73 : 78W,78,27,40,67.5,5,19,26.3,32,59,54.2,9,17,52.9,9,26,35,21,15,21,13,8,1,0,95,MKS Znicz Basket Pruszków,Sezon 2015/2016
2016-04-09 18:00,GKS Tychy(d),79 : 71W,79,19,34,55.9,10,29,34.5,29,63,46.0,11,15,73.3,9,26,35,15,21,19,14,5,9,1,91,MKS Znicz Basket Pruszków,Sezon 2015/2016
2016-04-10 18:00,GKS Tychy(d),46 : 87P,46,13,26,50.0,3,20,15.0,16,46,34.8,11,22,50.0,8,23,31,11,20,23,26,5,2,2,28,MKS Znicz Basket Pruszków,Sezon 2015/2016
2016-04-16 16:00,GKS Tychy(w),83 : 78P,78,19,44,43.2,8,21,38.1,27,65,41.5,16,18,88.9,14,16,30,13,27,22,21,5,4,3,69,MKS Znicz Basket Pruszków,Sezon 2015/2016
2016-04-17 18:00,GKS Tychy(w),93 : 82P,82,24,42,57.1,2,19,10.5,26,61,42.6,28,36,77.8,9,19,28,12,21,29,11,7,5,4,80,MKS Znicz Basket Pruszków,Sezon 2015/2016
2015-09-26 18:00,KSK Noteć Inowrocław(w),79 : 58P,58,16,35,45.7,6,23,26.1,22,58,37.9,8,14,57.1,4,25,29,7,20,20,17,8,3,0,46,SKK Siedlce,Sezon 2015/2016
2015-10-03 18:00,AZS AWF Mickiewicz Romus Katowice(d),73 : 75P,73,19,37,51.4,8,21,38.1,27,58,46.6,11,17,64.7,6,23,29,14,18,19,11,8,3,1,79,SKK Siedlce,Sezon 2015/2016
2015-10-10 18:00,GTK Gliwice(w),73 : 54P,54,18,37,48.6,3,22,13.6,21,59,35.6,9,16,56.3,10,26,36,11,15,18,18,3,0,4,41,SKK Siedlce,Sezon 2015/2016
2015-10-17 18:00,GKS Tychy(d),67 : 71P,67,14,30,46.7,10,27,37.0,24,57,42.1,9,11,81.8,7,30,37,12,28,16,15,7,0,1,73,SKK Siedlce,Sezon 2015/2016
2015-10-21 16:00,ACK UTH Rosa Radom(w),63 : 71W,71,20,34,58.8,8,25,32.0,28,59,47.5,7,10,70.0,7,31,38,22,23,18,19,7,0,2,85,SKK Siedlce,Sezon 2015/2016
2015-10-25 17:00,Exact Systems Śląsk Wrocław(d),69 : 55W,69,21,40,52.5,6,22,27.3,27,62,43.5,9,12,75.0,7,28,35,16,22,20,13,9,2,2,80,SKK Siedlce,Sezon 2015/2016
2015-10-31 17:30,meritumkredyt Pogoń Prudnik(w),63 : 68W,68,13,28,46.4,7,26,26.9,20,54,37.0,21,26,80.8,5,31,36,11,22,24,13,6,0,1,69,SKK Siedlce,Sezon 2015/2016
2015-11-07 18:00,Miasto Szkła Krosno(d),69 : 100P,69,21,33,63.6,8,26,30.8,29,59,49.2,3,5,60.0,7,19,26,10,20,9,21,7,0,1,59,SKK Siedlce,Sezon 2015/2016
2015-11-11 19:00,Astoria Bydgoszcz(w),78 : 65P,65,22,42,52.4,4,20,20.0,26,62,41.9,9,19,47.4,13,21,34,19,23,23,22,8,0,3,58,SKK Siedlce,Sezon 2015/2016
2015-11-14 19:00,MKS Znicz Basket Pruszków(d),79 : 75W,79,21,43,48.8,8,24,33.3,29,67,43.3,13,23,56.5,9,23,32,13,19,23,8,12,3,3,83,SKK Siedlce,Sezon 2015/2016
2015-11-21 17:00,Zetkama Doral Nysa Kłodzko(w),83 : 81P,81,10,29,34.5,16,32,50.0,26,61,42.6,13,17,76.5,9,23,32,26,23,20,13,9,2,2,98,SKK Siedlce,Sezon 2015/2016
2015-11-28 17:00,KS Spójnia Stargard(d),71 : 73P,71,26,41,63.4,4,17,23.5,30,58,51.7,7,12,58.3,4,32,36,15,18,17,18,2,4,1,77,SKK Siedlce,Sezon 2015/2016
2015-12-05 18:00,Biofarm Basket Poznań(w),81 : 70P,70,13,31,41.9,11,22,50.0,24,53,45.3,11,15,73.3,4,18,22,12,16,18,18,11,3,2,67,SKK Siedlce,Sezon 2015/2016
2015-12-12 16:00,Max Elektro Sokół Łańcut(d),69 : 84P,69,17,33,51.5,8,23,34.8,25,56,44.6,11,14,78.6,7,28,35,13,24,21,22,4,2,3,67,SKK Siedlce,Sezon 2015/2016
2015-12-19 15:00,Legia Warszawa(w),76 : 69P,69,18,41,43.9,8,24,33.3,26,65,40.0,9,14,64.3,11,26,37,19,23,18,17,7,4,3,75,SKK Siedlce,Sezon 2015/2016
2016-01-02 17:00,KSK Noteć Inowrocław(d),75 : 62W,75,14,27,51.9,11,27,40.7,25,54,46.3,14,21,66.7,9,27,36,15,20,19,21,12,4,3,85,SKK Siedlce,Sezon 2015/2016
2016-01-09 18:00,AZS AWF Mickiewicz Romus Katowice(w),63 : 86W,86,25,36,69.4,9,24,37.5,34,60,56.7,9,20,45.0,10,26,36,23,15,18,13,5,3,0,103,SKK Siedlce,Sezon 2015/2016
2016-01-17 18:00,GTK Gliwice(d),72 : 70W,72,19,42,45.2,4,18,22.2,23,60,38.3,22,30,73.3,15,29,44,14,21,26,16,8,2,1,79,SKK Siedlce,Sezon 2015/2016
2016-01-23 18:00,GKS Tychy(w),96 : 84P,84,23,46,50.0,9,22,40.9,32,68,47.1,11,14,78.6,8,13,21,23,22,22,14,9,1,3,85,SKK Siedlce,Sezon 2015/2016
2016-01-27 19:00,ACK UTH Rosa Radom(d),83 : 76W,83,21,39,53.8,9,23,39.1,30,62,48.4,14,17,82.4,11,17,28,18,15,20,12,8,1,2,91,SKK Siedlce,Sezon 2015/2016
2016-01-30 16:00,Exact Systems Śląsk Wrocław(w),69 : 59P,59,14,31,45.2,6,28,21.4,20,59,33.9,13,18,72.2,5,23,28,10,23,21,11,11,1,1,54,SKK Siedlce,Sezon 2015/2016
2016-02-06 19:00,meritumkredyt Pogoń Prudnik(d),88 : 82W,88,18,35,51.4,10,20,50.0,28,55,50.9,22,34,64.7,4,30,34,15,22,24,17,6,2,3,89,SKK Siedlce,Sezon 2015/2016
2016-02-14 17:00,Miasto Szkła Krosno(w),86 : 59P,59,17,40,42.5,5,20,25.0,22,60,36.7,10,12,83.3,7,26,33,10,21,17,21,4,1,4,46,SKK Siedlce,Sezon 2015/2016
2016-02-17 20:00,Astoria Bydgoszcz(d),87 : 99P,87,17,38,44.7,13,25,52.0,30,63,47.6,14,25,56.0,6,22,28,16,25,24,14,3,3,2,79,SKK Siedlce,Sezon 2015/2016
2016-02-20 18:00,MKS Znicz Basket Pruszków(w),78 : 86W,86,22,33,66.7,10,25,40.0,32,58,55.2,12,16,75.0,7,25,32,17,23,19,16,8,3,1,100,SKK Siedlce,Sezon 2015/2016
2016-02-27 15:00,Zetkama Doral Nysa Kłodzko(d),76 : 78P,76,12,35,34.3,14,28,50.0,26,63,41.3,10,14,71.4,9,23,32,12,17,18,11,5,1,3,74,SKK Siedlce,Sezon 2015/2016
2016-03-05 17:00,KS Spójnia Stargard(w),81 : 76P,76,19,39,48.7,11,29,37.9,30,68,44.1,5,6,83.3,11,28,39,17,21,15,16,6,3,1,86,SKK Siedlce,Sezon 2015/2016
2016-03-13 18:00,Biofarm Basket Poznań(d),78 : 72W,78,23,44,52.3,7,17,41.2,30,61,49.2,11,14,78.6,11,29,40,20,22,19,16,5,4,2,97,SKK Siedlce,Sezon 2015/2016
2016-03-19 17:30,Max Elektro Sokół Łańcut(w),93 : 87P,87,17,28,60.7,13,23,56.5,30,51,58.8,14,20,70.0,3,24,27,21,23,22,15,3,1,1,97,SKK Siedlce,Sezon 2015/2016
2016-04-03 18:00,Legia Warszawa(d),91 : 83W,91,21,44,47.7,12,27,44.4,33,71,46.5,13,20,65.0,12,36,48,17,21,22,17,6,6,3,106,SKK Siedlce,Sezon 2015/2016
2015-09-27 14:00,Exact Systems Śląsk Wrocław(w),66 : 54P,54,18,39,46.2,4,15,26.7,22,54,40.7,6,18,33.3,9,23,32,10,27,23,21,5,0,7,36,Zetkama Doral Nysa Kłodzko,Sezon 2015/2016
2015-10-04 18:00,Miasto Szkła Krosno(w),93 : 43P,43,14,44,31.8,3,19,15.8,17,63,27.0,6,8,75.0,13,20,33,12,20,13,23,9,1,3,27,Zetkama Doral Nysa Kłodzko,Sezon 2015/2016
2015-10-17 17:30,KS Spójnia Stargard(w),78 : 65P,65,14,41,34.1,5,17,29.4,19,58,32.8,22,37,59.5,13,16,29,16,20,25,17,12,1,2,52,Zetkama Doral Nysa Kłodzko,Sezon 2015/2016
2015-10-21 19:30,Max Elektro Sokół Łańcut(d),82 : 79W,82,20,39,51.3,7,22,31.8,27,61,44.3,21,25,84.0,10,25,35,23,21,26,15,4,0,3,91,Zetkama Doral Nysa Kłodzko,Sezon 2015/2016
2015-10-24 18:00,KSK Noteć Inowrocław(w),79 : 51P,51,15,36,41.7,4,18,22.2,19,54,35.2,9,18,50.0,9,23,32,12,18,20,14,3,1,6,41,Zetkama Doral Nysa Kłodzko,Sezon 2015/2016
2015-10-28 19:30,MKS Znicz Basket Pruszków(d),71 : 79P,71,19,41,46.3,9,33,27.3,28,74,37.8,6,6,100.0,14,21,35,24,19,12,15,8,3,2,80,Zetkama Doral Nysa Kłodzko,Sezon 2015/2016
2015-10-31 17:00,GTK Gliwice(d),59 : 57W,59,18,49,36.7,3,21,14.3,21,70,30.0,14,17,82.4,19,22,41,22,23,19,10,5,1,3,66,Zetkama Doral Nysa Kłodzko,Sezon 2015/2016
2015-11-08 17:00,ACK UTH Rosa Radom(w),61 : 54P,54,12,35,34.3,5,13,38.5,17,48,35.4,15,21,71.4,12,25,37,13,24,21,22,9,7,0,61,Zetkama Doral Nysa Kłodzko,Sezon 2015/2016
2015-11-11 17:00,meritumkredyt Pogoń Prudnik(d),73 : 59W,73,20,40,50.0,7,17,41.2,27,57,47.4,12,16,75.0,12,24,36,25,20,19,20,16,1,2,97,Zetkama Doral Nysa Kłodzko,Sezon 2015/2016
2015-11-14 19:00,Astoria Bydgoszcz(w),70 : 50P,50,17,44,38.6,3,18,16.7,20,62,32.3,7,11,63.6,12,26,38,12,28,19,21,3,1,3,37,Zetkama Doral Nysa Kłodzko,Sezon 2015/2016
2015-11-21 17:00,SKK Siedlce(d),83 : 81W,83,27,47,57.4,6,16,37.5,33,63,52.4,11,16,68.8,10,26,36,31,20,23,11,6,3,2,113,Zetkama Doral Nysa Kłodzko,Sezon 2015/2016
2015-11-28 17:00,Biofarm Basket Poznań(d),77 : 66W,77,24,41,58.5,7,20,35.0,31,61,50.8,8,8,100.0,13,24,37,30,21,21,19,6,4,1,105,Zetkama Doral Nysa Kłodzko,Sezon 2015/2016
2015-12-05 18:00,Legia Warszawa(w),84 : 51P,51,12,42,28.6,6,17,35.3,18,59,30.5,9,14,64.3,13,21,34,9,25,22,24,11,0,1,35,Zetkama Doral Nysa Kłodzko,Sezon 2015/2016
2015-12-12 17:00,AZS AWF Mickiewicz Romus Katowice(d),78 : 59W,78,18,35,51.4,12,25,48.0,30,60,50.0,6,10,60.0,13,28,41,28,24,18,18,8,3,2,106,Zetkama Doral Nysa Kłodzko,Sezon 2015/2016
2015-12-19 18:00,GKS Tychy(w),62 : 47P,47,14,30,46.7,5,21,23.8,19,51,37.3,4,8,50.0,6,22,28,14,21,18,21,11,1,2,44,Zetkama Doral Nysa Kłodzko,Sezon 2015/2016
2016-01-03 17:00,Exact Systems Śląsk Wrocław(d),73 : 65W,73,23,46,50.0,3,15,20.0,26,61,42.6,18,22,81.8,13,22,35,31,26,22,14,13,2,2,101,Zetkama Doral Nysa Kłodzko,Sezon 2015/2016
2016-01-09 17:00,Miasto Szkła Krosno(d),61 : 104P,61,20,52,38.5,4,15,26.7,24,67,35.8,9,12,75.0,15,17,32,23,21,20,17,9,2,3,64,Zetkama Doral Nysa Kłodzko,Sezon 2015/2016
2016-01-17 17:00,MKS Znicz Basket Pruszków(w),69 : 56P,56,20,45,44.4,4,23,17.4,24,68,35.3,4,5,80.0,18,17,35,11,23,14,15,10,3,4,55,Zetkama Doral Nysa Kłodzko,Sezon 2015/2016
2016-01-23 17:00,KS Spójnia Stargard(d),85 : 75W,85,26,52,50.0,4,12,33.3,30,64,46.9,21,23,91.3,17,20,37,32,22,21,15,8,3,1,114,Zetkama Doral Nysa Kłodzko,Sezon 2015/2016
2016-01-27 18:00,Max Elektro Sokół Łańcut(w),72 : 42P,42,9,39,23.1,3,16,18.8,12,55,21.8,15,24,62.5,10,15,25,8,21,19,12,11,0,3,22,Zetkama Doral Nysa Kłodzko,Sezon 2015/2016
2016-01-30 17:00,KSK Noteć Inowrocław(d),78 : 62W,78,28,49,57.1,5,14,35.7,33,63,52.4,7,8,87.5,13,22,35,31,19,18,13,11,5,1,116,Zetkama Doral Nysa Kłodzko,Sezon 2015/2016
2016-02-06 18:00,GTK Gliwice(w),74 : 57P,57,17,46,37.0,4,14,28.6,21,60,35.0,11,20,55.0,10,19,29,12,22,21,17,8,4,4,45,Zetkama Doral Nysa Kłodzko,Sezon 2015/2016
2016-02-13 17:00,ACK UTH Rosa Radom(d),79 : 75W,79,23,48,47.9,6,12,50.0,29,60,48.3,15,20,75.0,11,22,33,34,19,19,11,8,4,2,111,Zetkama Doral Nysa Kłodzko,Sezon 2015/2016
2016-02-17 18:30,meritumkredyt Pogoń Prudnik(w),80 : 59P,59,20,37,54.1,3,23,13.0,23,60,38.3,10,12,83.3,11,23,34,12,21,18,18,7,0,1,55,Zetkama Doral Nysa Kłodzko,Sezon 2015/2016
2016-02-20 17:00,Astoria Bydgoszcz(d),72 : 67W,72,21,39,53.8,4,19,21.1,25,58,43.1,18,31,58.1,10,28,38,26,22,29,10,3,0,0,83,Zetkama Doral Nysa Kłodzko,Sezon 2015/2016
2016-02-27 15:00,SKK Siedlce(w),76 : 78W,78,21,40,52.5,8,21,38.1,29,61,47.5,12,15,80.0,7,26,33,14,19,17,10,9,3,1,92,Zetkama Doral Nysa Kłodzko,Sezon 2015/2016
2016-03-05 15:45,Biofarm Basket Poznań(w),44 : 51W,51,11,40,27.5,4,14,28.6,15,54,27.8,17,27,63.0,15,27,42,13,27,24,16,7,3,2,51,Zetkama Doral Nysa Kłodzko,Sezon 2015/2016
2016-03-12 17:00,Legia Warszawa(d),82 : 107P,82,28,41,68.3,5,14,35.7,33,55,60.0,11,14,78.6,3,16,19,23,13,15,21,7,0,0,85,Zetkama Doral Nysa Kłodzko,Sezon 2015/2016
2016-03-19 18:00,AZS AWF Mickiewicz Romus Katowice(w),80 : 61P,61,11,29,37.9,8,23,34.8,19,52,36.5,15,26,57.7,6,19,25,9,22,23,18,7,2,1,42,Zetkama Doral Nysa Kłodzko,Sezon 2015/2016
2016-04-03 18:00,GKS Tychy(d),87 : 81W,87,23,50,46.0,5,15,33.3,28,65,43.1,26,37,70.3,14,20,34,26,33,33,12,4,2,2,93,Zetkama Doral Nysa Kłodzko,Sezon 2015/2016
2016-04-09 18:00,Miasto Szkła Krosno(w),80 : 70P,70,14,40,35.0,12,28,42.9,26,68,38.2,6,9,66.7,11,26,37,17,19,16,9,8,2,2,80,Zetkama Doral Nysa Kłodzko,Sezon 2015/2016
2016-04-10 18:00,Miasto Szkła Krosno(w),100 : 62P,62,18,38,47.4,5,22,22.7,23,60,38.3,11,17,64.7,10,20,30,16,22,18,19,6,1,4,53,Zetkama Doral Nysa Kłodzko,Sezon 2015/2016
2016-04-16 17:00,Miasto Szkła Krosno(d),58 : 85P,58,17,46,37.0,5,15,33.3,22,61,36.1,9,15,60.0,5,23,28,19,22,19,16,7,0,2,51,Zetkama Doral Nysa Kłodzko,Sezon 2015/2016
2014-09-27 17:30,PTG Sokół Łańcut(w),77 : 52P,52,17,36,47.2,2,15,13.3,19,51,37.3,12,17,70.6,3,21,24,5,21,23,23,7,0,5,28,ACK UTH Rosa Radom,Sezon 2014/2015
2014-10-04 19:00,GTK Fluor Gliwice(d),84 : 69W,84,17,39,43.6,11,30,36.7,28,69,40.6,17,22,77.3,16,23,39,18,21,24,10,5,1,3,91,ACK UTH Rosa Radom,Sezon 2014/2015
2014-10-12 18:00,Astoria Bydgoszcz(w),72 : 71P,71,19,44,43.2,6,20,30.0,25,64,39.1,15,20,75.0,8,19,27,12,18,17,11,15,1,2,71,ACK UTH Rosa Radom,Sezon 2014/2015
2014-10-18 17:00,KS Spójnia Stargard Szczeciński(w),71 : 55P,55,15,37,40.5,6,29,20.7,21,66,31.8,7,8,87.5,14,18,32,10,16,13,8,9,3,2,55,ACK UTH Rosa Radom,Sezon 2014/2015
2014-10-26 17:00,KKK Krosno(d),75 : 90P,75,22,35,62.9,7,26,26.9,29,61,47.5,10,12,83.3,10,14,24,10,17,16,14,9,1,2,71,ACK UTH Rosa Radom,Sezon 2014/2015
2014-11-02 17:00,MKS Znicz Basket Pruszków(w),82 : 81P,81,21,37,56.8,7,26,26.9,28,63,44.4,18,22,81.8,11,17,28,19,30,22,15,6,3,3,83,ACK UTH Rosa Radom,Sezon 2014/2015
2014-11-08 19:00,BASKET ZAGŁĘBIE S.A.(d),103 : 85W,103,24,40,60.0,12,25,48.0,36,65,55.4,19,25,76.0,8,22,30,21,28,24,17,9,1,2,112,ACK UTH Rosa Radom,Sezon 2014/2015
2014-11-16 18:00,SKK Siedlce(w),64 : 86W,86,23,38,60.5,9,33,27.3,32,71,45.1,13,14,92.9,10,27,37,0,20,16,5,6,3,2,99,ACK UTH Rosa Radom,Sezon 2014/2015
2014-11-22 19:00,GKS Tychy(d),71 : 76P,71,14,36,38.9,8,25,32.0,22,61,36.1,19,23,82.6,11,17,28,14,20,21,11,12,0,2,71,ACK UTH Rosa Radom,Sezon 2014/2015
2014-11-30 19:45,AZS Politechnika Poznań(w),51 : 58W,58,20,41,48.8,3,14,21.4,23,55,41.8,9,15,60.0,9,34,43,10,24,19,27,13,2,2,61,ACK UTH Rosa Radom,Sezon 2014/2015
2014-12-06 19:00,Intermarche Bricomarche BM SlamStal Ostrów(d),100 : 96W,100,27,51,52.9,10,28,35.7,37,79,46.8,16,23,69.6,13,23,36,20,25,22,7,7,1,2,108,ACK UTH Rosa Radom,Sezon 2014/2015
2014-12-14 18:00,KS Pogoń Prudnik(w),61 : 55P,55,17,34,50.0,4,27,14.8,21,61,34.4,9,13,69.2,10,23,33,8,19,19,10,13,1,0,56,ACK UTH Rosa Radom,Sezon 2014/2015
2014-12-20 17:00,Legia Warszawa(d),87 : 72W,87,18,34,52.9,9,24,37.5,27,58,46.6,24,27,88.9,5,24,29,14,23,23,13,14,1,2,98,ACK UTH Rosa Radom,Sezon 2014/2015
2015-01-03 17:00,PTG Sokół Łańcut(d),92 : 73W,92,22,47,46.8,11,21,52.4,33,68,48.5,15,19,78.9,7,18,25,18,25,18,10,11,1,6,98,ACK UTH Rosa Radom,Sezon 2014/2015
2015-01-10 18:00,GTK Fluor Gliwice(w),71 : 72W,72,17,34,50.0,8,20,40.0,25,54,46.3,14,18,77.8,8,18,26,17,26,22,14,4,0,2,72,ACK UTH Rosa Radom,Sezon 2014/2015
2015-01-18 17:00,Astoria Bydgoszcz(d),92 : 75W,92,29,50,58.0,9,21,42.9,38,71,53.5,7,11,63.6,10,22,32,23,18,13,15,17,3,1,115,ACK UTH Rosa Radom,Sezon 2014/2015
2015-01-25 17:00,KS Spójnia Stargard Szczeciński(d),96 : 75W,96,21,32,65.6,10,24,41.7,31,56,55.4,24,30,80.0,9,22,31,20,25,27,17,15,0,3,114,ACK UTH Rosa Radom,Sezon 2014/2015
2015-02-01 18:00,KKK Krosno(w),101 : 73P,73,21,44,47.7,7,25,28.0,28,69,40.6,10,16,62.5,6,23,29,15,20,19,8,6,0,3,68,ACK UTH Rosa Radom,Sezon 2014/2015
2015-02-08 17:00,MKS Znicz Basket Pruszków(d),65 : 85P,65,16,35,45.7,10,30,33.3,26,65,40.0,3,5,60.0,10,27,37,13,23,9,16,4,1,2,63,ACK UTH Rosa Radom,Sezon 2014/2015
2015-02-15 19:00,BASKET ZAGŁĘBIE S.A.(w),77 : 68P,68,13,30,43.3,12,34,35.3,25,64,39.1,6,14,42.9,7,20,27,17,23,17,10,8,1,3,64,ACK UTH Rosa Radom,Sezon 2014/2015
2015-02-22 17:00,SKK Siedlce(d),87 : 79W,87,26,43,60.5,8,24,33.3,34,67,50.7,11,12,91.7,10,20,30,20,20,18,8,8,1,1,104,ACK UTH Rosa Radom,Sezon 2014/2015
2015-02-28 18:00,GKS Tychy(w),78 : 56P,56,14,29,48.3,4,23,17.4,18,52,34.6,16,19,84.2,8,19,27,8,23,24,16,5,0,0,43,ACK UTH Rosa Radom,Sezon 2014/2015
2015-03-08 17:00,AZS Politechnika Poznań(d),78 : 66W,78,21,30,70.0,10,32,31.3,31,62,50.0,6,10,60.0,6,18,24,20,17,14,14,14,7,2,94,ACK UTH Rosa Radom,Sezon 2014/2015
2015-03-14 18:30,Intermarche Bricomarche BM SlamStal Ostrów(w),80 : 62P,62,21,41,51.2,5,22,22.7,26,63,41.3,5,5,100.0,8,21,29,5,20,12,24,7,2,1,44,ACK UTH Rosa Radom,Sezon 2014/2015
2015-03-22 17:00,KS Pogoń Prudnik(d),87 : 74W,87,28,47,59.6,8,26,30.8,36,73,49.3,7,12,58.3,11,22,33,19,20,18,8,16,3,3,108,ACK UTH Rosa Radom,Sezon 2014/2015
2015-03-29 18:00,Legia Warszawa(w),63 : 73W,73,15,26,57.7,8,33,24.2,23,59,39.0,19,29,65.5,8,27,35,18,18,22,8,8,2,2,82,ACK UTH Rosa Radom,Sezon 2014/2015
2015-04-11 17:30,PTG Sokół Łańcut(w),80 : 74P,74,17,36,47.2,4,24,16.7,21,60,35.0,28,33,84.8,9,29,38,12,24,23,14,8,1,5,75,ACK UTH Rosa Radom,Sezon 2014/2015
2015-04-12 17:30,PTG Sokół Łańcut(w),84 : 59P,59,21,44,47.7,1,22,4.5,22,66,33.3,14,17,82.4,16,16,32,9,17,17,12,7,2,2,50,ACK UTH Rosa Radom,Sezon 2014/2015
2015-04-18 15:00,PTG Sokół Łańcut(d),60 : 88P,60,12,38,31.6,7,21,33.3,19,59,32.2,15,18,83.3,9,21,30,13,20,18,15,7,2,3,54,ACK UTH Rosa Radom,Sezon 2014/2015
2014-09-27 18:00,GTK Fluor Gliwice(w),83 : 68P,68,19,40,47.5,6,22,27.3,25,62,40.3,12,21,57.1,8,24,32,13,29,19,18,3,1,2,53,Astoria Bydgoszcz,Sezon 2014/2015
2014-10-04 17:00,KS Spójnia Stargard Szczeciński(w),67 : 49P,49,18,42,42.9,3,21,14.3,21,63,33.3,4,7,57.1,10,19,29,6,23,16,13,7,1,1,34,Astoria Bydgoszcz,Sezon 2014/2015
2014-10-12 18:00,ACK UTH Rosa Radom(d),72 : 71W,72,23,41,56.1,6,20,30.0,29,61,47.5,8,13,61.5,10,26,36,17,17,18,19,7,2,1,78,Astoria Bydgoszcz,Sezon 2014/2015
2014-10-18 18:00,KKK Krosno(w),90 : 38P,38,15,45,33.3,1,25,4.0,16,70,22.9,5,5,100.0,11,19,30,5,16,14,17,8,5,6,15,Astoria Bydgoszcz,Sezon 2014/2015
2014-10-26 18:00,MKS Znicz Basket Pruszków(d),83 : 57W,83,24,49,49.0,7,21,33.3,31,70,44.3,14,18,77.8,9,25,34,15,16,23,12,19,3,1,99,Astoria Bydgoszcz,Sezon 2014/2015
2014-11-02 19:00,BASKET ZAGŁĘBIE S.A.(w),106 : 76P,76,21,45,46.7,7,22,31.8,28,67,41.8,13,18,72.2,8,14,22,17,26,21,13,5,3,3,66,Astoria Bydgoszcz,Sezon 2014/2015
2014-11-08 19:00,SKK Siedlce(d),78 : 88P,78,22,47,46.8,7,25,28.0,29,72,40.3,13,19,68.4,12,23,35,19,21,21,13,8,5,2,83,Astoria Bydgoszcz,Sezon 2014/2015
2014-11-15 18:00,GKS Tychy(w),79 : 83W,83,25,44,56.8,5,18,27.8,30,62,48.4,18,26,69.2,11,20,31,11,21,27,12,9,2,1,84,Astoria Bydgoszcz,Sezon 2014/2015
2014-11-22 19:00,AZS Politechnika Poznań(d),78 : 75W,78,21,40,52.5,8,26,30.8,29,66,43.9,12,20,60.0,15,22,37,16,18,19,17,13,1,1,83,Astoria Bydgoszcz,Sezon 2014/2015
2014-11-29 18:30,Intermarche Bricomarche BM SlamStal Ostrów(w),78 : 57P,57,17,47,36.2,7,26,26.9,24,73,32.9,2,5,40.0,8,22,30,11,26,19,15,9,0,3,40,Astoria Bydgoszcz,Sezon 2014/2015
2014-12-06 18:00,KS Pogoń Prudnik(d),76 : 64W,76,27,51,52.9,4,16,25.0,31,67,46.3,10,16,62.5,8,23,31,13,19,21,9,10,2,4,81,Astoria Bydgoszcz,Sezon 2014/2015
2014-12-12 19:45,Legia Warszawa(w),82 : 74P,74,15,42,35.7,8,21,38.1,23,63,36.5,20,27,74.1,13,19,32,11,22,23,16,5,1,3,60,Astoria Bydgoszcz,Sezon 2014/2015
2014-12-20 19:00,PTG Sokół Łańcut(d),75 : 60W,75,18,43,41.9,10,20,50.0,28,63,44.4,9,12,75.0,7,21,28,20,19,14,18,10,2,6,79,Astoria Bydgoszcz,Sezon 2014/2015
2015-01-03 19:00,GTK Fluor Gliwice(d),62 : 73P,62,10,39,25.6,12,28,42.9,22,67,32.8,6,8,75.0,9,22,31,13,21,17,11,4,3,3,55,Astoria Bydgoszcz,Sezon 2014/2015
2015-01-13 19:00,KS Spójnia Stargard Szczeciński(d),53 : 71P,53,15,32,46.9,4,21,19.0,19,53,35.8,11,20,55.0,11,28,39,9,19,23,26,9,3,1,44,Astoria Bydgoszcz,Sezon 2014/2015
2015-01-18 17:00,ACK UTH Rosa Radom(w),92 : 75P,75,24,46,52.2,7,21,33.3,31,67,46.3,6,9,66.7,13,22,35,12,14,18,23,7,1,3,68,Astoria Bydgoszcz,Sezon 2014/2015
2015-01-25 19:00,KKK Krosno(d),71 : 73P,71,21,48,43.8,7,21,33.3,28,69,40.6,8,9,88.9,5,18,23,20,22,17,8,12,1,2,77,Astoria Bydgoszcz,Sezon 2014/2015
2015-02-04 19:00,MKS Znicz Basket Pruszków(w),92 : 68P,68,23,42,54.8,4,22,18.2,27,64,42.2,10,15,66.7,11,21,32,11,25,21,26,11,1,5,55,Astoria Bydgoszcz,Sezon 2014/2015
2015-02-08 19:00,BASKET ZAGŁĘBIE S.A.(d),63 : 73P,63,21,45,46.7,4,18,22.2,25,63,39.7,9,13,69.2,7,21,28,12,22,16,18,9,3,4,55,Astoria Bydgoszcz,Sezon 2014/2015
2015-02-15 17:00,SKK Siedlce(w),76 : 64P,64,25,48,52.1,2,10,20.0,27,58,46.6,8,17,47.1,7,21,28,12,24,20,18,10,1,2,57,Astoria Bydgoszcz,Sezon 2014/2015
2015-02-25 19:00,GKS Tychy(d),74 : 71W,74,17,34,50.0,7,25,28.0,24,59,40.7,19,28,67.9,16,23,39,13,25,28,20,13,2,6,77,Astoria Bydgoszcz,Sezon 2014/2015
2015-02-28 18:00,AZS Politechnika Poznań(w),62 : 73W,73,18,37,48.6,8,16,50.0,26,53,49.1,13,21,61.9,6,21,27,20,19,20,22,15,0,1,78,Astoria Bydgoszcz,Sezon 2014/2015
2015-03-08 19:00,Intermarche Bricomarche BM SlamStal Ostrów(d),73 : 89P,73,26,42,61.9,5,16,31.3,31,58,53.4,6,11,54.5,7,19,26,18,27,17,21,6,0,1,70,Astoria Bydgoszcz,Sezon 2014/2015
2015-03-14 17:30,KS Pogoń Prudnik(w),90 : 62P,62,21,38,55.3,3,20,15.0,24,58,41.4,11,27,40.7,6,22,28,18,31,26,19,9,0,0,48,Astoria Bydgoszcz,Sezon 2014/2015
2015-03-21 20:00,Legia Warszawa(d),59 : 101P,59,20,53,37.7,4,16,25.0,24,69,34.8,7,13,53.8,15,17,32,14,18,16,15,12,3,8,54,Astoria Bydgoszcz,Sezon 2014/2015
2015-03-28 17:30,PTG Sokół Łańcut(w),71 : 51P,51,20,54,37.0,2,14,14.3,22,68,32.4,5,10,50.0,13,24,37,8,16,18,15,7,4,6,41,Astoria Bydgoszcz,Sezon 2014/2015
2015-04-12 19:00,SKK Siedlce(d),77 : 65W,77,20,40,50.0,8,20,40.0,28,60,46.7,13,23,56.5,6,23,29,19,21,21,12,11,1,3,83,Astoria Bydgoszcz,Sezon 2014/2015
2015-04-18 18:00,SKK Siedlce(w),88 : 85P,85,23,50,46.0,7,20,35.0,30,70,42.9,18,24,75.0,10,20,30,13,23,25,17,9,0,1,74,Astoria Bydgoszcz,Sezon 2014/2015
2015-04-22 19:00,SKK Siedlce(d),69 : 49W,69,19,45,42.2,6,16,37.5,25,61,41.0,13,18,72.2,10,27,37,16,18,18,14,8,5,2,80,Astoria Bydgoszcz,Sezon 2014/2015
2014-09-27 18:00,SKK Siedlce(d),65 : 61W,65,20,48,41.7,4,14,28.6,24,62,38.7,13,18,72.2,8,19,27,14,21,21,11,11,2,0,65,AZS Politechnika Poznań,Sezon 2014/2015
2014-10-04 19:00,GKS Tychy(w),73 : 60P,60,18,40,45.0,7,16,43.8,25,56,44.6,3,11,27.3,3,18,21,11,21,19,24,7,0,0,36,AZS Politechnika Poznań,Sezon 2014/2015
2014-10-11 19:30,KS Spójnia Stargard Szczeciński(d),43 : 76P,43,14,42,33.3,5,14,35.7,19,56,33.9,0,6,0.0,9,19,28,8,15,13,14,12,2,0,36,AZS Politechnika Poznań,Sezon 2014/2015
2014-10-18 18:00,Intermarche Bricomarche BM SlamStal Ostrów(d),60 : 71P,60,21,40,52.5,4,14,28.6,25,54,46.3,6,11,54.5,5,22,27,11,23,19,13,4,4,2,59,AZS Politechnika Poznań,Sezon 2014/2015
2014-10-25 17:30,KS Pogoń Prudnik(w),82 : 65P,65,18,46,39.1,6,16,37.5,24,62,38.7,11,16,68.8,12,17,29,14,18,20,16,4,0,0,53,AZS Politechnika Poznań,Sezon 2014/2015
2014-11-02 18:00,Legia Warszawa(d),60 : 76P,60,16,41,39.0,7,24,29.2,23,65,35.4,7,17,41.2,10,23,33,15,17,21,12,6,3,0,53,AZS Politechnika Poznań,Sezon 2014/2015
2014-11-08 17:30,PTG Sokół Łańcut(w),89 : 64P,64,23,51,45.1,5,13,38.5,28,64,43.8,3,10,30.0,14,24,38,13,16,16,23,8,0,4,57,AZS Politechnika Poznań,Sezon 2014/2015
2014-11-16 18:00,GTK Fluor Gliwice(d),68 : 66W,68,17,39,43.6,7,22,31.8,24,61,39.3,13,19,68.4,11,22,33,12,22,23,15,6,6,0,67,AZS Politechnika Poznań,Sezon 2014/2015
2014-11-22 19:00,Astoria Bydgoszcz(w),78 : 75P,75,22,40,55.0,7,19,36.8,29,59,49.2,10,17,58.8,10,23,33,16,19,18,20,9,1,1,77,AZS Politechnika Poznań,Sezon 2014/2015
2014-11-30 19:45,ACK UTH Rosa Radom(d),51 : 58P,51,18,45,40.0,2,22,9.1,20,67,29.9,9,22,40.9,11,25,36,13,20,24,22,14,2,2,34,AZS Politechnika Poznań,Sezon 2014/2015
2014-12-06 18:00,KKK Krosno(w),99 : 71P,71,24,52,46.2,5,19,26.3,29,71,40.8,8,11,72.7,13,15,28,14,17,20,16,10,3,8,65,AZS Politechnika Poznań,Sezon 2014/2015
2014-12-13 19:00,MKS Znicz Basket Pruszków(d),74 : 100P,74,20,45,44.4,7,24,29.2,27,69,39.1,13,17,76.5,12,28,40,16,25,17,16,9,2,4,79,AZS Politechnika Poznań,Sezon 2014/2015
2014-12-21 17:00,BASKET ZAGŁĘBIE S.A.(w),95 : 67P,67,15,43,34.9,10,20,50.0,25,63,39.7,7,13,53.8,13,17,30,14,18,13,12,10,2,4,67,AZS Politechnika Poznań,Sezon 2014/2015
2015-01-04 18:00,SKK Siedlce(w),74 : 67P,67,23,54,42.6,3,20,15.0,26,74,35.1,12,17,70.6,14,16,30,10,27,15,8,9,0,1,55,AZS Politechnika Poznań,Sezon 2014/2015
2015-01-10 19:00,GKS Tychy(d),75 : 73W,75,23,42,54.8,7,23,30.4,30,65,46.2,8,21,38.1,12,18,30,15,26,24,18,16,4,3,74,AZS Politechnika Poznań,Sezon 2014/2015
2015-01-17 17:00,KS Spójnia Stargard Szczeciński(w),78 : 59P,59,13,38,34.2,8,23,34.8,21,61,34.4,9,19,47.4,14,21,35,12,19,17,18,10,1,3,49,AZS Politechnika Poznań,Sezon 2014/2015
2015-01-24 18:30,Intermarche Bricomarche BM SlamStal Ostrów(w),107 : 66P,66,17,45,37.8,9,21,42.9,26,66,39.4,5,7,71.4,8,13,21,11,24,13,13,10,3,0,56,AZS Politechnika Poznań,Sezon 2014/2015
2015-02-01 16:00,KS Pogoń Prudnik(d),61 : 55W,61,14,32,43.8,6,22,27.3,20,54,37.0,15,21,71.4,12,26,38,14,16,23,19,10,3,2,67,AZS Politechnika Poznań,Sezon 2014/2015
2015-02-08 17:45,Legia Warszawa(w),99 : 41P,41,13,46,28.3,4,20,20.0,17,66,25.8,3,8,37.5,7,24,31,10,21,13,16,10,4,2,26,AZS Politechnika Poznań,Sezon 2014/2015
2015-02-14 20:00,PTG Sokół Łańcut(d),45 : 64P,45,17,39,43.6,2,12,16.7,19,51,37.3,5,8,62.5,6,24,30,13,19,15,22,9,1,3,41,AZS Politechnika Poznań,Sezon 2014/2015
2015-02-18 20:00,MKS Znicz Basket Pruszków(w),75 : 54P,54,14,35,40.0,7,27,25.9,21,62,33.9,5,10,50.0,16,31,47,13,21,16,26,12,0,5,54,AZS Politechnika Poznań,Sezon 2014/2015
2015-02-21 18:00,GTK Fluor Gliwice(w),65 : 60P,60,13,33,39.4,11,28,39.3,24,61,39.3,1,3,33.3,12,20,32,15,19,11,18,14,1,3,65,AZS Politechnika Poznań,Sezon 2014/2015
2015-02-28 18:00,Astoria Bydgoszcz(d),62 : 73P,62,19,35,54.3,5,19,26.3,24,54,44.4,9,17,52.9,9,22,31,12,20,19,27,16,1,0,57,AZS Politechnika Poznań,Sezon 2014/2015
2015-03-08 17:00,ACK UTH Rosa Radom(w),78 : 66P,66,16,36,44.4,8,17,47.1,24,53,45.3,10,17,58.8,10,23,33,12,14,17,24,7,2,7,60,AZS Politechnika Poznań,Sezon 2014/2015
2015-03-15 18:00,KKK Krosno(d),58 : 110P,58,22,55,40.0,3,12,25.0,25,67,37.3,5,11,45.5,10,18,28,16,17,17,10,5,6,4,55,AZS Politechnika Poznań,Sezon 2014/2015
2015-03-29 18:00,BASKET ZAGŁĘBIE S.A.(d),59 : 83P,59,19,49,38.8,4,12,33.3,23,61,37.7,9,22,40.9,11,22,33,14,21,19,23,10,3,0,45,AZS Politechnika Poznań,Sezon 2014/2015
2015-04-11 17:30,KS Pogoń Prudnik(w),68 : 59P,59,15,36,41.7,8,25,32.0,23,61,37.7,5,6,83.3,6,20,26,10,23,12,9,9,3,0,59,AZS Politechnika Poznań,Sezon 2014/2015
2015-04-18 19:00,KS Pogoń Prudnik(d),77 : 82P,77,13,35,37.1,12,23,52.2,25,58,43.1,15,21,71.4,7,19,26,14,28,23,12,8,1,0,75,AZS Politechnika Poznań,Sezon 2014/2015
2015-04-25 19:00,SKK Siedlce(w),80 : 84W,84,23,41,56.1,7,23,30.4,30,64,46.9,17,21,81.0,10,20,30,15,21,22,13,12,0,6,90,AZS Politechnika Poznań,Sezon 2014/2015
2015-04-26 16:00,SKK Siedlce(w),72 : 45P,45,9,36,25.0,6,29,20.7,15,65,23.1,9,15,60.0,7,25,32,6,17,15,8,5,1,7,25,AZS Politechnika Poznań,Sezon 2014/2015
2015-05-02 18:00,SKK Siedlce(d),81 : 65W,81,27,47,57.4,7,20,35.0,34,67,50.7,6,12,50.0,8,24,32,17,17,12,4,5,2,2,94,AZS Politechnika Poznań,Sezon 2014/2015
2015-05-03 18:00,SKK Siedlce(d),75 : 87P,75,18,39,46.2,9,25,36.0,27,64,42.2,12,15,80.0,9,26,35,15,23,18,14,8,2,2,81,AZS Politechnika Poznań,Sezon 2014/2015
2015-05-06 18:00,SKK Siedlce(w),78 : 69P,69,22,39,56.4,6,18,33.3,28,57,49.1,7,12,58.3,7,20,27,12,16,19,15,7,1,1,67,AZS Politechnika Poznań,Sezon 2014/2015
2014-09-27 18:30,Intermarche Bricomarche BM SlamStal Ostrów(w),83 : 50P,50,17,40,42.5,3,14,21.4,20,54,37.0,7,9,77.8,8,24,32,7,18,17,19,3,0,1,37,BASKET ZAGŁĘBIE S.A.,Sezon 2014/2015
2014-10-05 17:00,KS Pogoń Prudnik(d),55 : 62P,55,21,42,50.0,1,18,5.6,22,60,36.7,10,21,47.6,11,33,44,11,21,22,12,7,1,2,57,BASKET ZAGŁĘBIE S.A.,Sezon 2014/2015
2014-10-10 19:16,Legia Warszawa(w),88 : 57P,57,13,48,27.1,5,14,35.7,18,62,29.0,16,18,88.9,14,13,27,10,20,24,17,3,3,7,37,BASKET ZAGŁĘBIE S.A.,Sezon 2014/2015
2014-10-19 19:00,PTG Sokół Łańcut(d),58 : 74P,58,19,51,37.3,3,13,23.1,22,64,34.4,11,29,37.9,17,22,39,15,20,21,14,8,2,5,48,BASKET ZAGŁĘBIE S.A.,Sezon 2014/2015
2014-10-25 18:00,GTK Fluor Gliwice(w),60 : 96W,96,27,45,60.0,11,22,50.0,38,67,56.7,9,19,47.4,5,23,28,21,17,20,8,12,8,1,118,BASKET ZAGŁĘBIE S.A.,Sezon 2014/2015
2014-11-02 19:00,Astoria Bydgoszcz(d),106 : 76W,106,33,53,62.3,5,18,27.8,38,71,53.5,25,31,80.6,15,26,41,22,21,26,12,7,3,3,128,BASKET ZAGŁĘBIE S.A.,Sezon 2014/2015
2014-11-08 19:00,ACK UTH Rosa Radom(w),103 : 85P,85,25,46,54.3,5,16,31.3,30,62,48.4,20,30,66.7,11,23,34,21,24,28,19,9,2,1,90,BASKET ZAGŁĘBIE S.A.,Sezon 2014/2015
2014-11-16 19:00,KKK Krosno(d),78 : 96P,78,27,49,55.1,4,15,26.7,31,64,48.4,12,18,66.7,9,20,29,17,16,20,9,4,3,0,83,BASKET ZAGŁĘBIE S.A.,Sezon 2014/2015
2014-11-23 17:00,MKS Znicz Basket Pruszków(w),95 : 79P,79,20,42,47.6,10,29,34.5,30,71,42.3,9,16,56.3,8,14,22,17,20,18,12,11,2,3,71,BASKET ZAGŁĘBIE S.A.,Sezon 2014/2015
2014-11-29 17:00,KS Spójnia Stargard Szczeciński(w),58 : 60W,60,17,36,47.2,6,19,31.6,23,55,41.8,8,14,57.1,12,24,36,7,20,16,19,6,6,2,58,BASKET ZAGŁĘBIE S.A.,Sezon 2014/2015
2014-12-06 17:00,SKK Siedlce(d),85 : 69W,85,23,42,54.8,11,21,52.4,34,63,54.0,6,13,46.2,4,24,28,29,15,19,11,12,4,0,111,BASKET ZAGŁĘBIE S.A.,Sezon 2014/2015
2014-12-13 18:00,GKS Tychy(w),76 : 84W,84,29,51,56.9,6,20,30.0,35,71,49.3,8,13,61.5,10,19,29,15,21,22,11,7,2,2,85,BASKET ZAGŁĘBIE S.A.,Sezon 2014/2015
2014-12-21 17:00,AZS Politechnika Poznań(d),95 : 67W,95,26,43,60.5,12,28,42.9,38,71,53.5,7,12,58.3,15,26,41,36,14,17,14,9,5,2,134,BASKET ZAGŁĘBIE S.A.,Sezon 2014/2015
2015-01-04 17:00,Intermarche Bricomarche BM SlamStal Ostrów(d),79 : 67W,79,29,44,65.9,5,16,31.3,34,60,56.7,6,7,85.7,10,24,34,22,19,14,15,6,4,1,103,BASKET ZAGŁĘBIE S.A.,Sezon 2014/2015
2015-01-10 17:30,KS Pogoń Prudnik(w),72 : 84W,84,25,39,64.1,8,17,47.1,33,56,58.9,10,13,76.9,4,17,21,20,16,17,13,9,4,0,99,BASKET ZAGŁĘBIE S.A.,Sezon 2014/2015
2015-01-16 17:30,Legia Warszawa(d),78 : 75W,78,20,46,43.5,9,21,42.9,29,67,43.3,11,17,64.7,14,21,35,17,21,18,11,11,8,0,94,BASKET ZAGŁĘBIE S.A.,Sezon 2014/2015
2015-01-24 17:30,PTG Sokół Łańcut(w),87 : 81P,81,26,61,42.6,8,16,50.0,34,77,44.2,5,9,55.6,11,24,35,16,23,11,21,13,3,6,80,BASKET ZAGŁĘBIE S.A.,Sezon 2014/2015
2015-01-31 18:00,GTK Fluor Gliwice(d),75 : 70W,75,21,45,46.7,6,16,37.5,27,61,44.3,15,25,60.0,12,30,42,17,18,26,14,9,4,1,89,BASKET ZAGŁĘBIE S.A.,Sezon 2014/2015
2015-02-08 19:00,Astoria Bydgoszcz(w),63 : 73W,73,24,43,55.8,4,16,25.0,28,59,47.5,13,22,59.1,11,28,39,17,17,22,14,14,4,3,93,BASKET ZAGŁĘBIE S.A.,Sezon 2014/2015
2015-02-15 19:00,ACK UTH Rosa Radom(d),77 : 68W,77,25,51,49.0,5,14,35.7,30,65,46.2,12,22,54.5,16,34,50,19,17,23,12,6,3,1,98,BASKET ZAGŁĘBIE S.A.,Sezon 2014/2015
2015-02-21 18:00,KKK Krosno(w),83 : 75P,75,23,51,45.1,7,15,46.7,30,66,45.5,8,17,47.1,8,13,21,17,18,20,11,13,2,4,72,BASKET ZAGŁĘBIE S.A.,Sezon 2014/2015
2015-02-28 18:00,MKS Znicz Basket Pruszków(d),71 : 60W,71,17,40,42.5,8,18,44.4,25,58,43.1,13,15,86.7,11,30,41,18,18,16,21,11,2,1,87,BASKET ZAGŁĘBIE S.A.,Sezon 2014/2015
2015-03-08 19:00,KS Spójnia Stargard Szczeciński(d),72 : 73P,72,23,42,54.8,5,14,35.7,28,56,50.0,11,19,57.9,9,20,29,16,16,16,13,8,0,0,76,BASKET ZAGŁĘBIE S.A.,Sezon 2014/2015
2015-03-15 17:00,SKK Siedlce(w),83 : 78P,78,23,43,53.5,6,22,27.3,29,65,44.6,14,20,70.0,8,23,31,16,21,17,16,9,0,3,76,BASKET ZAGŁĘBIE S.A.,Sezon 2014/2015
2015-03-22 17:00,GKS Tychy(d),69 : 78P,69,16,41,39.0,7,21,33.3,23,62,37.1,16,20,80.0,18,23,41,19,18,22,13,7,2,4,82,BASKET ZAGŁĘBIE S.A.,Sezon 2014/2015
2015-03-29 18:00,AZS Politechnika Poznań(w),59 : 83W,83,26,55,47.3,4,13,30.8,30,68,44.1,19,28,67.9,15,30,45,10,20,21,13,15,0,3,93,BASKET ZAGŁĘBIE S.A.,Sezon 2014/2015
2015-04-11 18:30,Intermarche Bricomarche BM SlamStal Ostrów(w),92 : 65P,65,16,39,41.0,8,21,38.1,24,60,40.0,9,11,81.8,9,22,31,10,15,16,16,7,0,4,59,BASKET ZAGŁĘBIE S.A.,Sezon 2014/2015
2015-04-12 18:30,Intermarche Bricomarche BM SlamStal Ostrów(w),84 : 77P,77,18,41,43.9,9,20,45.0,27,61,44.3,14,19,73.7,6,24,30,15,21,18,7,6,0,0,82,BASKET ZAGŁĘBIE S.A.,Sezon 2014/2015
2015-04-18 17:00,Intermarche Bricomarche BM SlamStal Ostrów(d),68 : 89P,68,22,44,50.0,4,15,26.7,26,59,44.1,12,17,70.6,4,21,25,9,20,15,13,2,3,1,56,BASKET ZAGŁĘBIE S.A.,Sezon 2014/2015
2014-09-27 19:00,KS Spójnia Stargard Szczeciński(d),60 : 66P,60,19,42,45.2,6,23,26.1,25,65,38.5,4,8,50.0,8,22,30,11,22,18,9,8,1,0,57,GKS Tychy,Sezon 2014/2015
2014-10-04 19:00,AZS Politechnika Poznań(d),73 : 60W,73,21,39,53.8,5,18,27.8,26,57,45.6,16,24,66.7,9,25,34,17,19,21,17,20,0,0,88,GKS Tychy,Sezon 2014/2015
2014-10-11 18:30,Intermarche Bricomarche BM SlamStal Ostrów(w),70 : 51P,51,15,38,39.5,3,19,15.8,18,57,31.6,12,18,66.7,9,20,29,6,18,20,20,7,1,2,29,GKS Tychy,Sezon 2014/2015
2014-10-18 19:00,KS Pogoń Prudnik(d),73 : 71W,73,24,42,57.1,4,16,25.0,28,58,48.3,13,17,76.5,9,24,33,18,24,20,16,12,2,0,88,GKS Tychy,Sezon 2014/2015
2014-10-24 19:16,Legia Warszawa(w),75 : 76W,76,16,31,51.6,11,24,45.8,27,55,49.1,11,20,55.0,7,22,29,9,18,20,13,7,3,0,74,GKS Tychy,Sezon 2014/2015
2014-11-02 18:00,PTG Sokół Łańcut(d),62 : 81P,62,14,45,31.1,7,26,26.9,21,71,29.6,13,21,61.9,15,22,37,12,23,20,9,9,0,6,53,GKS Tychy,Sezon 2014/2015
2014-11-08 18:00,GTK Fluor Gliwice(w),78 : 58P,58,16,30,53.3,5,22,22.7,21,52,40.4,11,24,45.8,5,23,28,12,20,21,14,4,0,1,44,GKS Tychy,Sezon 2014/2015
2014-11-15 18:00,Astoria Bydgoszcz(d),79 : 83P,79,21,43,48.8,8,21,38.1,29,64,45.3,13,19,68.4,9,20,29,14,27,21,14,7,1,2,75,GKS Tychy,Sezon 2014/2015
2014-11-22 19:00,ACK UTH Rosa Radom(w),71 : 76W,76,23,35,65.7,7,22,31.8,30,57,52.6,9,13,69.2,10,25,35,13,21,20,21,6,2,0,80,GKS Tychy,Sezon 2014/2015
2014-11-29 18:00,KKK Krosno(d),83 : 70W,83,24,41,58.5,10,22,45.5,34,63,54.0,5,9,55.6,9,25,34,13,15,14,8,7,0,0,96,GKS Tychy,Sezon 2014/2015
2014-12-06 18:00,MKS Znicz Basket Pruszków(w),63 : 48P,48,14,38,36.8,5,26,19.2,19,64,29.7,5,5,100.0,13,28,41,8,23,9,20,6,4,3,42,GKS Tychy,Sezon 2014/2015
2014-12-13 18:00,BASKET ZAGŁĘBIE S.A.(d),76 : 84P,76,19,36,52.8,7,19,36.8,26,55,47.3,17,20,85.0,7,25,32,14,22,21,20,7,2,2,79,GKS Tychy,Sezon 2014/2015
2014-12-21 17:00,SKK Siedlce(w),72 : 69P,69,21,49,42.9,6,19,31.6,27,68,39.7,9,17,52.9,7,21,28,10,20,15,13,14,2,3,61,GKS Tychy,Sezon 2014/2015
2015-01-03 17:00,KS Spójnia Stargard Szczeciński(w),79 : 74P,74,13,33,39.4,11,22,50.0,24,55,43.6,15,22,68.2,6,22,28,14,26,19,16,6,3,6,71,GKS Tychy,Sezon 2014/2015
2015-01-10 19:00,AZS Politechnika Poznań(w),75 : 73P,73,12,41,29.3,10,29,34.5,22,70,31.4,19,31,61.3,22,23,45,10,24,25,23,13,3,4,61,GKS Tychy,Sezon 2014/2015
2015-01-17 19:00,Intermarche Bricomarche BM SlamStal Ostrów(d),61 : 79P,61,8,27,29.6,9,21,42.9,17,48,35.4,18,26,69.2,8,17,25,11,27,24,15,8,3,0,54,GKS Tychy,Sezon 2014/2015
2015-01-24 17:30,KS Pogoń Prudnik(w),60 : 76W,76,19,34,55.9,7,27,25.9,26,61,42.6,17,22,77.3,14,25,39,16,20,21,10,6,0,0,87,GKS Tychy,Sezon 2014/2015
2015-01-31 19:00,Legia Warszawa(d),56 : 81P,56,17,55,30.9,6,24,25.0,23,79,29.1,4,7,57.1,17,18,35,11,27,14,11,14,3,11,49,GKS Tychy,Sezon 2014/2015
2015-02-07 17:30,PTG Sokół Łańcut(w),77 : 76P,76,15,35,42.9,11,23,47.8,26,58,44.8,13,22,59.1,4,35,39,14,29,24,21,6,3,3,76,GKS Tychy,Sezon 2014/2015
2015-02-14 18:00,GTK Fluor Gliwice(d),75 : 73W,75,27,47,57.4,5,15,33.3,32,62,51.6,6,9,66.7,7,24,31,16,16,17,11,7,1,1,86,GKS Tychy,Sezon 2014/2015
2015-02-25 19:00,Astoria Bydgoszcz(w),74 : 71P,71,18,34,52.9,7,18,38.9,25,52,48.1,14,20,70.0,6,17,23,12,28,25,22,13,6,2,70,GKS Tychy,Sezon 2014/2015
2015-02-28 18:00,ACK UTH Rosa Radom(d),78 : 56W,78,16,25,64.0,11,33,33.3,27,58,46.6,13,19,68.4,9,25,34,15,24,20,14,7,3,0,86,GKS Tychy,Sezon 2014/2015
2015-03-07 18:00,KKK Krosno(w),78 : 50P,50,15,31,48.4,5,23,21.7,20,54,37.0,5,10,50.0,5,21,26,10,19,19,20,12,3,3,42,GKS Tychy,Sezon 2014/2015
2015-03-14 18:00,MKS Znicz Basket Pruszków(d),80 : 64W,80,22,36,61.1,10,23,43.5,32,59,54.2,6,7,85.7,3,21,24,15,24,13,12,9,2,1,90,GKS Tychy,Sezon 2014/2015
2015-03-22 17:00,BASKET ZAGŁĘBIE S.A.(w),69 : 78W,78,16,34,47.1,11,23,47.8,27,57,47.4,13,16,81.3,7,20,27,15,22,18,12,8,4,2,87,GKS Tychy,Sezon 2014/2015
2015-03-28 18:00,SKK Siedlce(d),81 : 57W,81,28,46,60.9,6,18,33.3,34,64,53.1,7,9,77.8,2,21,23,16,19,20,10,7,0,0,85,GKS Tychy,Sezon 2014/2015
2014-09-27 18:00,Astoria Bydgoszcz(d),83 : 68W,83,25,46,54.3,5,17,29.4,30,63,47.6,18,33,54.5,13,29,42,16,20,29,13,6,4,1,90,GTK Fluor Gliwice,Sezon 2014/2015
2014-10-04 19:00,ACK UTH Rosa Radom(w),84 : 69P,69,17,36,47.2,7,20,35.0,24,56,42.9,14,26,53.8,12,25,37,16,25,21,12,8,3,1,77,GTK Fluor Gliwice,Sezon 2014/2015
2014-10-11 18:00,KKK Krosno(d),55 : 77P,55,20,47,42.6,1,16,6.3,21,63,33.3,12,18,66.7,11,24,35,7,18,18,14,7,1,1,43,GTK Fluor Gliwice,Sezon 2014/2015
2014-10-18 18:00,MKS Znicz Basket Pruszków(d),65 : 56W,65,19,42,45.2,5,21,23.8,24,63,38.1,12,15,80.0,8,30,38,14,21,19,7,10,0,2,78,GTK Fluor Gliwice,Sezon 2014/2015
2014-10-25 18:00,BASKET ZAGŁĘBIE S.A.(d),60 : 96P,60,20,45,44.4,3,17,17.6,23,62,37.1,11,17,64.7,10,24,34,9,20,17,21,5,1,8,43,GTK Fluor Gliwice,Sezon 2014/2015
2014-11-02 18:00,SKK Siedlce(w),78 : 74P,74,20,49,40.8,6,21,28.6,26,70,37.1,16,26,61.5,12,25,37,8,24,24,11,8,1,1,63,GTK Fluor Gliwice,Sezon 2014/2015
2014-11-08 18:00,GKS Tychy(d),78 : 58W,78,21,40,52.5,7,22,31.8,28,62,45.2,15,19,78.9,10,29,39,17,21,20,13,9,1,0,93,GTK Fluor Gliwice,Sezon 2014/2015
2014-11-16 18:00,AZS Politechnika Poznań(w),68 : 66P,66,15,37,40.5,8,23,34.8,23,60,38.3,12,22,54.5,11,22,33,18,23,22,14,8,0,6,64,GTK Fluor Gliwice,Sezon 2014/2015
2014-11-22 18:00,Intermarche Bricomarche BM SlamStal Ostrów(d),87 : 82W,87,28,52,53.8,5,14,35.7,33,66,50.0,16,26,61.5,8,22,30,18,26,25,6,4,0,3,90,GTK Fluor Gliwice,Sezon 2014/2015
2014-11-29 17:30,KS Pogoń Prudnik(w),89 : 80P,80,23,46,50.0,5,15,33.3,28,61,45.9,19,23,82.6,7,27,34,19,32,25,19,4,2,0,83,GTK Fluor Gliwice,Sezon 2014/2015
2014-12-05 20:00,Legia Warszawa(d),58 : 59P,58,13,43,30.2,6,18,33.3,19,61,31.1,14,18,77.8,10,29,39,9,19,20,13,7,3,2,57,GTK Fluor Gliwice,Sezon 2014/2015
2014-12-13 17:30,PTG Sokół Łańcut(w),82 : 72P,72,19,47,40.4,6,16,37.5,25,63,39.7,16,20,80.0,15,21,36,14,22,24,16,5,0,6,69,GTK Fluor Gliwice,Sezon 2014/2015
2014-12-20 18:00,KS Spójnia Stargard Szczeciński(d),70 : 68W,70,23,48,47.9,4,11,36.4,27,59,45.8,12,19,63.2,9,18,27,13,21,21,11,13,3,1,76,GTK Fluor Gliwice,Sezon 2014/2015
2015-01-03 19:00,Astoria Bydgoszcz(w),62 : 73W,73,23,48,47.9,5,11,45.5,28,59,47.5,12,20,60.0,10,31,41,14,17,21,10,6,3,3,88,GTK Fluor Gliwice,Sezon 2014/2015
2015-01-10 18:00,ACK UTH Rosa Radom(d),71 : 72P,71,23,44,52.3,4,12,33.3,27,56,48.2,13,20,65.0,11,21,32,21,22,26,12,7,2,0,85,GTK Fluor Gliwice,Sezon 2014/2015
2015-01-18 18:00,KKK Krosno(w),74 : 77W,77,21,46,45.7,8,15,53.3,29,61,47.5,11,15,73.3,6,19,25,14,17,21,5,8,1,4,84,GTK Fluor Gliwice,Sezon 2014/2015
2015-01-24 18:00,MKS Znicz Basket Pruszków(w),80 : 58P,58,12,37,32.4,6,22,27.3,18,59,30.5,16,18,88.9,6,20,26,8,19,20,12,9,4,3,50,GTK Fluor Gliwice,Sezon 2014/2015
2015-01-31 18:00,BASKET ZAGŁĘBIE S.A.(w),75 : 70P,70,15,45,33.3,9,21,42.9,24,66,36.4,13,15,86.7,10,26,36,18,26,18,14,7,1,4,74,GTK Fluor Gliwice,Sezon 2014/2015
2015-02-07 18:00,SKK Siedlce(d),72 : 51W,72,23,47,48.9,5,14,35.7,28,61,45.9,11,15,73.3,8,26,34,15,20,19,12,10,1,1,83,GTK Fluor Gliwice,Sezon 2014/2015
2015-02-14 18:00,GKS Tychy(w),75 : 73P,73,23,35,65.7,6,23,26.1,29,58,50.0,9,12,75.0,4,20,24,11,17,15,13,9,1,1,73,GTK Fluor Gliwice,Sezon 2014/2015
2015-02-21 18:00,AZS Politechnika Poznań(d),65 : 60W,65,19,42,45.2,6,20,30.0,25,62,40.3,9,19,47.4,19,25,44,14,11,19,21,9,3,1,67,GTK Fluor Gliwice,Sezon 2014/2015
2015-02-28 18:30,Intermarche Bricomarche BM SlamStal Ostrów(w),88 : 61P,61,18,50,36.0,5,15,33.3,23,65,35.4,10,12,83.3,9,17,26,9,19,21,10,7,0,0,49,GTK Fluor Gliwice,Sezon 2014/2015
2015-03-07 18:00,KS Pogoń Prudnik(d),67 : 62W,67,14,34,41.2,9,23,39.1,23,57,40.4,12,16,75.0,8,25,33,18,25,21,14,8,2,1,76,GTK Fluor Gliwice,Sezon 2014/2015
2015-03-14 17:00,Legia Warszawa(w),80 : 86W,86,23,43,53.5,7,14,50.0,30,57,52.6,19,22,86.4,7,29,36,11,20,26,13,4,4,1,98,GTK Fluor Gliwice,Sezon 2014/2015
2015-03-21 18:00,PTG Sokół Łańcut(d),59 : 80P,59,20,50,40.0,5,18,27.8,25,68,36.8,4,6,66.7,10,17,27,17,20,18,12,12,0,0,58,GTK Fluor Gliwice,Sezon 2014/2015
2015-03-29 18:00,KS Spójnia Stargard Szczeciński(w),79 : 64P,64,17,43,39.5,6,16,37.5,23,59,39.0,12,17,70.6,7,26,33,8,18,19,14,9,2,1,61,GTK Fluor Gliwice,Sezon 2014/2015
2014-09-27 18:30,BASKET ZAGŁĘBIE S.A.(d),83 : 50W,83,22,38,57.9,11,30,36.7,33,68,48.5,6,9,66.7,9,26,35,16,17,18,8,11,1,0,100,Intermarche Bricomarche BM SlamStal Ostrów,Sezon 2014/2015
2014-10-04 18:00,SKK Siedlce(w),69 : 90W,90,23,38,60.5,11,23,47.8,34,61,55.7,11,12,91.7,3,22,25,18,18,18,11,14,2,1,110,Intermarche Bricomarche BM SlamStal Ostrów,Sezon 2014/2015
2014-10-11 18:30,GKS Tychy(d),70 : 51W,70,24,40,60.0,5,16,31.3,29,56,51.8,7,16,43.8,6,27,33,11,21,18,14,10,2,1,76,Intermarche Bricomarche BM SlamStal Ostrów,Sezon 2014/2015
2014-10-18 18:00,AZS Politechnika Poznań(w),60 : 71W,71,22,41,53.7,5,21,23.8,27,62,43.5,12,16,75.0,14,22,36,18,19,23,13,6,2,4,81,Intermarche Bricomarche BM SlamStal Ostrów,Sezon 2014/2015
2014-10-25 18:30,KS Spójnia Stargard Szczeciński(d),79 : 67W,79,18,40,45.0,9,25,36.0,27,65,41.5,16,25,64.0,14,20,34,16,19,25,12,15,1,4,86,Intermarche Bricomarche BM SlamStal Ostrów,Sezon 2014/2015
2014-10-31 18:30,KS Pogoń Prudnik(d),96 : 67W,96,22,49,44.9,12,19,63.2,34,68,50.0,16,20,80.0,6,30,36,20,17,24,10,15,4,1,123,Intermarche Bricomarche BM SlamStal Ostrów,Sezon 2014/2015
2014-11-07 17:45,Legia Warszawa(w),69 : 80W,80,15,34,44.1,8,28,28.6,23,62,37.1,26,37,70.3,10,27,37,11,21,30,10,8,2,0,78,Intermarche Bricomarche BM SlamStal Ostrów,Sezon 2014/2015
2014-11-15 18:30,PTG Sokół Łańcut(d),72 : 67W,72,15,34,44.1,10,24,41.7,25,58,43.1,12,21,57.1,8,22,30,19,17,22,14,5,2,3,72,Intermarche Bricomarche BM SlamStal Ostrów,Sezon 2014/2015
2014-11-22 18:00,GTK Fluor Gliwice(w),87 : 82P,82,18,34,52.9,9,30,30.0,27,64,42.2,19,29,65.5,15,24,39,15,25,26,12,5,3,0,85,Intermarche Bricomarche BM SlamStal Ostrów,Sezon 2014/2015
2014-11-29 18:30,Astoria Bydgoszcz(d),78 : 57W,78,21,39,53.8,4,18,22.2,25,57,43.9,24,32,75.0,9,31,40,10,19,25,13,11,3,0,89,Intermarche Bricomarche BM SlamStal Ostrów,Sezon 2014/2015
2014-12-06 19:00,ACK UTH Rosa Radom(w),100 : 96P,96,19,36,52.8,11,21,52.4,30,57,52.6,25,32,78.1,7,30,37,15,23,25,13,4,2,1,107,Intermarche Bricomarche BM SlamStal Ostrów,Sezon 2014/2015
2014-12-13 18:30,KKK Krosno(d),80 : 65W,80,21,46,45.7,12,20,60.0,33,66,50.0,2,4,50.0,12,23,35,20,15,18,14,9,1,1,96,Intermarche Bricomarche BM SlamStal Ostrów,Sezon 2014/2015
2014-12-20 18:00,MKS Znicz Basket Pruszków(w),78 : 64P,64,12,30,40.0,7,25,28.0,19,55,34.5,19,31,61.3,13,21,34,11,27,20,18,8,1,3,52,Intermarche Bricomarche BM SlamStal Ostrów,Sezon 2014/2015
2015-01-04 17:00,BASKET ZAGŁĘBIE S.A.(w),79 : 67P,67,16,42,38.1,6,19,31.6,22,61,36.1,17,19,89.5,14,15,29,11,14,19,12,8,1,4,63,Intermarche Bricomarche BM SlamStal Ostrów,Sezon 2014/2015
2015-01-10 18:30,SKK Siedlce(d),83 : 69W,83,20,50,40.0,7,16,43.8,27,66,40.9,22,32,68.8,14,23,37,10,17,27,6,10,1,0,86,Intermarche Bricomarche BM SlamStal Ostrów,Sezon 2014/2015
2015-01-17 19:00,GKS Tychy(w),61 : 79W,79,20,26,76.9,8,23,34.8,28,49,57.1,15,23,65.2,7,24,31,10,24,27,16,6,0,0,81,Intermarche Bricomarche BM SlamStal Ostrów,Sezon 2014/2015
2015-01-24 18:30,AZS Politechnika Poznań(d),107 : 66W,107,35,53,66.0,5,19,26.3,40,72,55.6,22,23,95.7,13,28,41,19,13,24,11,10,0,3,133,Intermarche Bricomarche BM SlamStal Ostrów,Sezon 2014/2015
2015-01-31 17:00,KS Spójnia Stargard Szczeciński(w),64 : 77W,77,12,32,37.5,12,27,44.4,24,59,40.7,17,31,54.8,12,26,38,16,17,28,10,5,3,2,80,Intermarche Bricomarche BM SlamStal Ostrów,Sezon 2014/2015
2015-02-07 17:30,KS Pogoń Prudnik(w),66 : 60P,60,17,32,53.1,2,15,13.3,19,47,40.4,20,23,87.0,8,26,34,9,18,28,22,7,1,0,58,Intermarche Bricomarche BM SlamStal Ostrów,Sezon 2014/2015
2015-02-14 18:30,Legia Warszawa(d),86 : 79W,86,28,47,59.6,8,22,36.4,36,69,52.2,6,8,75.0,8,18,26,12,18,16,9,6,0,1,86,Intermarche Bricomarche BM SlamStal Ostrów,Sezon 2014/2015
2015-02-21 17:30,PTG Sokół Łańcut(w),93 : 80P,80,15,40,37.5,8,23,34.8,23,63,36.5,26,31,83.9,10,23,33,10,27,27,14,5,1,5,70,Intermarche Bricomarche BM SlamStal Ostrów,Sezon 2014/2015
2015-02-28 18:30,GTK Fluor Gliwice(d),88 : 61W,88,26,39,66.7,7,22,31.8,33,61,54.1,15,18,83.3,9,30,39,17,21,19,10,5,0,0,108,Intermarche Bricomarche BM SlamStal Ostrów,Sezon 2014/2015
2015-03-08 19:00,Astoria Bydgoszcz(w),73 : 89W,89,20,37,54.1,10,22,45.5,30,59,50.8,19,26,73.1,10,14,24,18,17,27,11,10,1,0,95,Intermarche Bricomarche BM SlamStal Ostrów,Sezon 2014/2015
2015-03-14 18:30,ACK UTH Rosa Radom(d),80 : 62W,80,21,40,52.5,9,24,37.5,30,64,46.9,11,13,84.6,9,23,32,13,12,20,16,14,1,2,88,Intermarche Bricomarche BM SlamStal Ostrów,Sezon 2014/2015
2015-03-22 18:00,KKK Krosno(w),86 : 87W,87,18,33,54.5,11,32,34.4,29,65,44.6,18,26,69.2,11,28,39,13,27,24,22,8,4,0,85,Intermarche Bricomarche BM SlamStal Ostrów,Sezon 2014/2015
2015-03-29 18:00,MKS Znicz Basket Pruszków(d),94 : 71W,94,30,42,71.4,10,25,40.0,40,67,59.7,4,6,66.7,6,22,28,20,20,19,9,11,1,1,116,Intermarche Bricomarche BM SlamStal Ostrów,Sezon 2014/2015
2015-04-11 18:30,BASKET ZAGŁĘBIE S.A.(d),92 : 65W,92,29,50,58.0,8,19,42.1,37,69,53.6,10,12,83.3,10,25,35,18,16,15,9,9,4,0,115,Intermarche Bricomarche BM SlamStal Ostrów,Sezon 2014/2015
2015-04-12 18:30,BASKET ZAGŁĘBIE S.A.(d),84 : 77W,84,20,36,55.6,10,23,43.5,30,59,50.8,14,20,70.0,10,25,35,10,18,21,9,3,0,0,88,Intermarche Bricomarche BM SlamStal Ostrów,Sezon 2014/2015
2015-04-18 17:00,BASKET ZAGŁĘBIE S.A.(w),68 : 89W,89,26,39,66.7,7,23,30.4,33,62,53.2,16,23,69.6,8,27,35,17,15,20,9,9,1,3,106,Intermarche Bricomarche BM SlamStal Ostrów,Sezon 2014/2015
2015-04-25 18:30,Legia Warszawa(d),78 : 68W,78,20,45,44.4,8,24,33.3,28,69,40.6,14,18,77.8,10,29,39,18,17,23,9,5,2,4,88,Intermarche Bricomarche BM SlamStal Ostrów,Sezon 2014/2015
2015-04-26 18:30,Legia Warszawa(d),67 : 79P,67,13,38,34.2,11,30,36.7,24,68,35.3,8,12,66.7,9,28,37,11,20,18,14,7,2,4,62,Intermarche Bricomarche BM SlamStal Ostrów,Sezon 2014/2015
2015-05-02 19:45,Legia Warszawa(w),83 : 86W,86,15,35,42.9,15,26,57.7,30,61,49.2,11,20,55.0,7,20,27,13,20,24,8,8,3,2,89,Intermarche Bricomarche BM SlamStal Ostrów,Sezon 2014/2015
2015-05-03 17:00,Legia Warszawa(w),67 : 59P,59,14,46,30.4,3,18,16.7,17,64,26.6,22,30,73.3,12,25,37,8,21,25,8,7,2,2,50,Intermarche Bricomarche BM SlamStal Ostrów,Sezon 2014/2015
2015-05-06 18:30,Legia Warszawa(d),71 : 58W,71,19,38,50.0,6,25,24.0,25,63,39.7,15,21,71.4,6,35,41,9,18,20,9,7,3,2,78,Intermarche Bricomarche BM SlamStal Ostrów,Sezon 2014/2015
2015-05-09 18:30,PTG Sokół Łańcut(d),90 : 85W,90,23,52,44.2,9,29,31.0,32,81,39.5,17,24,70.8,12,33,45,15,14,23,10,8,4,1,96,Intermarche Bricomarche BM SlamStal Ostrów,Sezon 2014/2015
2015-05-10 18:30,PTG Sokół Łańcut(d),74 : 72W,74,18,38,47.4,8,21,38.1,26,59,44.1,14,20,70.0,9,26,35,14,15,20,15,10,0,2,79,Intermarche Bricomarche BM SlamStal Ostrów,Sezon 2014/2015
2015-05-16 17:30,PTG Sokół Łańcut(w),71 : 60P,60,17,42,40.5,5,22,22.7,22,64,34.4,11,19,57.9,11,23,34,11,23,23,14,9,1,6,51,Intermarche Bricomarche BM SlamStal Ostrów,Sezon 2014/2015
2015-05-17 17:30,PTG Sokół Łańcut(w),63 : 76W,76,14,36,38.9,12,25,48.0,26,61,42.6,12,14,85.7,10,28,38,15,20,19,11,3,2,3,86,Intermarche Bricomarche BM SlamStal Ostrów,Sezon 2014/2015
2014-09-27 18:00,Legia Warszawa(d),62 : 52W,62,14,33,42.4,7,20,35.0,21,53,39.6,13,18,72.2,10,25,35,15,25,23,22,10,2,1,65,KKK Krosno,Sezon 2014/2015
2014-10-05 18:00,PTG Sokół Łańcut(d),74 : 73W,74,24,36,66.7,5,20,25.0,29,56,51.8,11,23,47.8,5,20,25,16,20,26,13,8,4,1,75,KKK Krosno,Sezon 2014/2015
2014-10-11 18:00,GTK Fluor Gliwice(w),55 : 77W,77,26,46,56.5,6,23,26.1,32,69,46.4,7,11,63.6,13,23,36,18,19,17,12,9,1,1,88,KKK Krosno,Sezon 2014/2015
2014-10-18 18:00,Astoria Bydgoszcz(d),90 : 38W,90,26,52,50.0,8,17,47.1,34,69,49.3,14,17,82.4,12,34,46,27,14,16,13,10,6,5,128,KKK Krosno,Sezon 2014/2015
2014-10-26 17:00,ACK UTH Rosa Radom(w),75 : 90W,90,17,30,56.7,14,24,58.3,31,54,57.4,14,16,87.5,6,19,25,19,16,17,15,9,2,1,105,KKK Krosno,Sezon 2014/2015
2014-11-02 17:00,KS Spójnia Stargard Szczeciński(w),53 : 57W,57,19,38,50.0,4,15,26.7,23,53,43.4,7,10,70.0,9,14,23,14,20,16,16,14,3,3,62,KKK Krosno,Sezon 2014/2015
2014-11-09 17:00,MKS Znicz Basket Pruszków(w),66 : 78W,78,16,27,59.3,11,33,33.3,27,60,45.0,13,16,81.3,7,32,39,9,24,23,15,6,4,3,85,KKK Krosno,Sezon 2014/2015
2014-11-16 19:00,BASKET ZAGŁĘBIE S.A.(w),78 : 96W,96,23,40,57.5,13,27,48.1,36,67,53.7,11,15,73.3,12,26,38,27,20,16,12,5,0,3,119,KKK Krosno,Sezon 2014/2015
2014-11-22 18:00,SKK Siedlce(d),84 : 72W,84,10,28,35.7,19,41,46.3,29,69,42.0,7,13,53.8,13,14,27,25,21,17,8,6,2,0,90,KKK Krosno,Sezon 2014/2015
2014-11-29 18:00,GKS Tychy(w),83 : 70P,70,21,33,63.6,6,26,23.1,27,59,45.8,10,12,83.3,6,19,25,10,14,15,11,3,0,0,63,KKK Krosno,Sezon 2014/2015
2014-12-06 18:00,AZS Politechnika Poznań(d),99 : 71W,99,27,36,75.0,10,25,40.0,37,61,60.7,15,21,71.4,8,25,33,28,20,17,17,11,8,3,132,KKK Krosno,Sezon 2014/2015
2014-12-13 18:30,Intermarche Bricomarche BM SlamStal Ostrów(w),80 : 65P,65,12,25,48.0,11,26,42.3,23,51,45.1,8,14,57.1,4,21,25,13,18,15,18,5,1,1,57,KKK Krosno,Sezon 2014/2015
2014-12-20 18:00,KS Pogoń Prudnik(d),79 : 65W,79,24,39,61.5,7,26,26.9,31,65,47.7,10,12,83.3,6,27,33,25,14,18,12,6,6,1,101,KKK Krosno,Sezon 2014/2015
2015-01-04 17:45,Legia Warszawa(w),72 : 64P,64,14,32,43.8,8,32,25.0,22,64,34.4,12,16,75.0,11,22,33,12,20,20,9,7,2,1,63,KKK Krosno,Sezon 2014/2015
2015-01-10 17:30,PTG Sokół Łańcut(w),67 : 64P,64,13,40,32.5,8,22,36.4,21,62,33.9,14,16,87.5,9,26,35,13,23,20,14,8,6,4,69,KKK Krosno,Sezon 2014/2015
2015-01-18 18:00,GTK Fluor Gliwice(d),74 : 77P,74,18,36,50.0,10,26,38.5,28,62,45.2,8,13,61.5,10,26,36,19,21,17,12,1,4,1,83,KKK Krosno,Sezon 2014/2015
2015-01-25 19:00,Astoria Bydgoszcz(w),71 : 73W,73,21,33,63.6,6,19,31.6,27,52,51.9,13,19,68.4,8,29,37,16,17,21,19,4,2,1,82,KKK Krosno,Sezon 2014/2015
2015-02-01 18:00,ACK UTH Rosa Radom(d),101 : 73W,101,21,30,70.0,14,32,43.8,35,62,56.5,17,24,70.8,5,32,37,29,19,19,13,4,3,0,127,KKK Krosno,Sezon 2014/2015
2015-02-07 18:00,KS Spójnia Stargard Szczeciński(d),85 : 76W,85,17,32,53.1,12,24,50.0,29,56,51.8,15,22,68.2,8,24,32,21,23,24,15,8,2,3,99,KKK Krosno,Sezon 2014/2015
2015-02-15 18:00,MKS Znicz Basket Pruszków(d),96 : 78W,96,25,41,61.0,11,28,39.3,36,69,52.2,13,16,81.3,12,28,40,23,18,23,18,9,5,1,119,KKK Krosno,Sezon 2014/2015
2015-02-21 18:00,BASKET ZAGŁĘBIE S.A.(d),83 : 75W,83,19,29,65.5,10,20,50.0,29,49,59.2,15,17,88.2,6,24,30,20,20,18,23,4,4,2,96,KKK Krosno,Sezon 2014/2015
2015-02-28 18:00,SKK Siedlce(w),59 : 89W,89,27,41,65.9,8,23,34.8,35,64,54.7,11,17,64.7,6,32,38,26,14,17,11,7,1,3,115,KKK Krosno,Sezon 2014/2015
2015-03-07 18:00,GKS Tychy(d),78 : 50W,78,20,36,55.6,9,27,33.3,29,63,46.0,11,14,78.6,10,26,36,19,19,19,16,10,3,3,93,KKK Krosno,Sezon 2014/2015
2015-03-15 18:00,AZS Politechnika Poznań(w),58 : 110W,110,24,43,55.8,17,36,47.2,41,79,51.9,11,13,84.6,16,31,47,27,17,17,6,7,4,6,149,KKK Krosno,Sezon 2014/2015
2015-03-22 18:00,Intermarche Bricomarche BM SlamStal Ostrów(d),86 : 87P,86,25,45,55.6,7,27,25.9,32,72,44.4,15,21,71.4,10,27,37,17,24,26,13,15,0,4,96,KKK Krosno,Sezon 2014/2015
2015-03-28 17:30,KS Pogoń Prudnik(w),66 : 93W,93,33,45,73.3,4,19,21.1,37,64,57.8,15,20,75.0,11,28,39,20,17,18,15,10,0,0,115,KKK Krosno,Sezon 2014/2015
2015-04-11 18:00,MKS Znicz Basket Pruszków(d),78 : 63W,78,14,29,48.3,11,36,30.6,25,65,38.5,17,21,81.0,12,30,42,16,19,20,14,8,5,2,91,KKK Krosno,Sezon 2014/2015
2015-04-12 18:00,MKS Znicz Basket Pruszków(d),81 : 72W,81,17,41,41.5,11,29,37.9,28,70,40.0,14,17,82.4,11,30,41,10,18,20,10,8,6,1,91,KKK Krosno,Sezon 2014/2015
2015-04-18 17:00,MKS Znicz Basket Pruszków(w),65 : 77W,77,16,27,59.3,13,27,48.1,29,54,53.7,6,9,66.7,5,21,26,18,14,17,17,10,2,1,88,KKK Krosno,Sezon 2014/2015
2015-04-24 18:00,PTG Sokół Łańcut(w),67 : 77W,77,17,38,44.7,9,22,40.9,26,60,43.3,16,23,69.6,16,33,49,19,20,20,14,3,1,4,94,KKK Krosno,Sezon 2014/2015
2015-04-25 17:30,PTG Sokół Łańcut(w),58 : 72W,72,16,43,37.2,10,25,40.0,26,68,38.2,10,13,76.9,14,23,37,16,19,20,13,10,4,6,81,KKK Krosno,Sezon 2014/2015
2015-05-02 18:00,PTG Sokół Łańcut(d),76 : 86P,76,15,31,48.4,8,21,38.1,23,52,44.2,22,29,75.9,8,24,32,17,19,23,19,6,3,2,79,KKK Krosno,Sezon 2014/2015
2015-05-03 18:00,PTG Sokół Łańcut(d),84 : 97P,84,26,47,55.3,6,25,24.0,32,72,44.4,14,17,82.4,9,21,30,19,24,19,9,5,3,3,89,KKK Krosno,Sezon 2014/2015
2015-05-06 18:00,PTG Sokół Łańcut(w),86 : 78P,78,18,37,48.6,9,32,28.1,27,69,39.1,15,19,78.9,9,19,28,21,20,19,10,7,2,2,80,KKK Krosno,Sezon 2014/2015
2015-05-09 19:00,Legia Warszawa(w),67 : 82W,82,18,33,54.5,11,35,31.4,29,68,42.6,13,18,72.2,15,24,39,20,20,18,11,7,1,1,94,KKK Krosno,Sezon 2014/2015
2015-05-16 18:00,Legia Warszawa(d),110 : 77W,110,25,38,65.8,19,36,52.8,44,74,59.5,3,4,75.0,7,32,39,31,23,12,11,7,3,1,148,KKK Krosno,Sezon 2014/2015
2014-09-27 18:00,MKS Znicz Basket Pruszków(w),67 : 57P,57,12,34,35.3,9,27,33.3,21,61,34.4,6,12,50.0,9,19,28,9,20,17,14,9,1,2,44,KS Pogoń Prudnik,Sezon 2014/2015
2014-10-05 17:00,BASKET ZAGŁĘBIE S.A.(w),55 : 62W,62,15,39,38.5,7,18,38.9,22,57,38.6,11,23,47.8,10,28,38,12,22,21,14,8,2,1,61,KS Pogoń Prudnik,Sezon 2014/2015
2014-10-11 17:30,SKK Siedlce(d),72 : 56W,72,18,42,42.9,5,24,20.8,23,66,34.8,21,28,75.0,10,24,34,12,23,23,11,13,1,0,71,KS Pogoń Prudnik,Sezon 2014/2015
2014-10-18 19:00,GKS Tychy(w),73 : 71P,71,19,35,54.3,3,16,18.8,22,51,43.1,24,28,85.7,7,19,26,9,20,24,18,10,0,2,65,KS Pogoń Prudnik,Sezon 2014/2015
2014-10-25 17:30,AZS Politechnika Poznań(d),82 : 65W,82,28,39,71.8,4,23,17.4,32,62,51.6,14,15,93.3,13,27,40,19,20,18,13,11,1,0,109,KS Pogoń Prudnik,Sezon 2014/2015
2014-10-31 18:30,Intermarche Bricomarche BM SlamStal Ostrów(w),96 : 67P,67,18,38,47.4,8,28,28.6,26,66,39.4,7,8,87.5,5,20,25,12,24,17,20,6,1,4,50,KS Pogoń Prudnik,Sezon 2014/2015
2014-11-08 17:30,KS Spójnia Stargard Szczeciński(d),66 : 67P,66,17,36,47.2,8,21,38.1,25,57,43.9,8,12,66.7,9,19,28,22,17,19,13,6,2,0,75,KS Pogoń Prudnik,Sezon 2014/2015
2014-11-16 17:00,Legia Warszawa(d),70 : 81P,70,13,30,43.3,9,29,31.0,22,59,37.3,17,23,73.9,10,17,27,14,23,21,11,8,0,0,65,KS Pogoń Prudnik,Sezon 2014/2015
2014-11-22 17:30,PTG Sokół Łańcut(w),83 : 68P,68,20,48,41.7,5,21,23.8,25,69,36.2,13,24,54.2,15,19,34,11,21,24,13,9,1,5,55,KS Pogoń Prudnik,Sezon 2014/2015
2014-11-29 17:30,GTK Fluor Gliwice(d),89 : 80W,89,21,36,58.3,7,28,25.0,28,64,43.8,26,31,83.9,8,26,34,18,25,32,13,9,4,0,100,KS Pogoń Prudnik,Sezon 2014/2015
2014-12-06 18:00,Astoria Bydgoszcz(w),76 : 64P,64,21,41,51.2,5,24,20.8,26,65,40.0,7,10,70.0,12,20,32,12,21,18,14,6,4,2,62,KS Pogoń Prudnik,Sezon 2014/2015
2014-12-14 18:00,ACK UTH Rosa Radom(d),61 : 55W,61,12,28,42.9,7,24,29.2,19,52,36.5,16,16,100.0,10,28,38,13,19,18,19,8,0,0,68,KS Pogoń Prudnik,Sezon 2014/2015
2014-12-20 18:00,KKK Krosno(w),79 : 65P,65,13,36,36.1,11,22,50.0,24,58,41.4,6,7,85.7,4,23,27,17,18,14,15,4,1,6,64,KS Pogoń Prudnik,Sezon 2014/2015
2015-01-03 17:30,MKS Znicz Basket Pruszków(d),89 : 71W,89,23,36,63.9,11,27,40.7,34,63,54.0,10,16,62.5,9,24,33,24,19,15,14,12,3,0,112,KS Pogoń Prudnik,Sezon 2014/2015
2015-01-10 17:30,BASKET ZAGŁĘBIE S.A.(d),72 : 84P,72,19,36,52.8,9,24,37.5,28,60,46.7,7,9,77.8,13,16,29,15,17,16,17,5,2,0,72,KS Pogoń Prudnik,Sezon 2014/2015
2015-01-17 16:00,SKK Siedlce(w),73 : 72P,72,17,36,47.2,10,24,41.7,27,60,45.0,8,18,44.4,6,19,25,13,18,21,8,10,3,3,72,KS Pogoń Prudnik,Sezon 2014/2015
2015-01-24 17:30,GKS Tychy(d),60 : 76P,60,13,28,46.4,5,21,23.8,18,49,36.7,19,23,82.6,6,24,30,9,21,20,14,5,1,0,56,KS Pogoń Prudnik,Sezon 2014/2015
2015-02-01 16:00,AZS Politechnika Poznań(w),61 : 55P,55,13,29,44.8,8,30,26.7,21,59,35.6,5,12,41.7,9,19,28,13,23,16,18,10,2,3,45,KS Pogoń Prudnik,Sezon 2014/2015
2015-02-07 17:30,Intermarche Bricomarche BM SlamStal Ostrów(d),66 : 60W,66,17,40,42.5,8,21,38.1,25,61,41.0,8,9,88.9,8,18,26,8,28,18,15,14,1,0,63,KS Pogoń Prudnik,Sezon 2014/2015
2015-02-14 17:00,KS Spójnia Stargard Szczeciński(w),93 : 71P,71,10,30,33.3,10,23,43.5,20,53,37.7,21,30,70.0,5,21,26,17,18,23,17,10,1,1,66,KS Pogoń Prudnik,Sezon 2014/2015
2015-02-21 17:45,Legia Warszawa(w),101 : 61P,61,14,33,42.4,5,25,20.0,19,58,32.8,18,21,85.7,3,11,14,16,23,17,17,7,8,2,47,KS Pogoń Prudnik,Sezon 2014/2015
2015-02-28 17:30,PTG Sokół Łańcut(d),63 : 82P,63,15,36,41.7,3,14,21.4,18,50,36.0,24,32,75.0,11,20,31,12,18,24,17,5,0,0,54,KS Pogoń Prudnik,Sezon 2014/2015
2015-03-07 18:00,GTK Fluor Gliwice(w),67 : 62P,62,14,31,45.2,4,21,19.0,18,52,34.6,22,32,68.8,10,25,35,7,22,25,13,8,1,2,56,KS Pogoń Prudnik,Sezon 2014/2015
2015-03-14 17:30,Astoria Bydgoszcz(d),90 : 62W,90,24,49,49.0,6,14,42.9,30,63,47.6,24,32,75.0,10,25,35,20,26,31,15,11,1,0,101,KS Pogoń Prudnik,Sezon 2014/2015
2015-03-22 17:00,ACK UTH Rosa Radom(w),87 : 74P,74,20,29,69.0,7,27,25.9,27,56,48.2,13,17,76.5,9,26,35,15,18,20,22,5,3,3,77,KS Pogoń Prudnik,Sezon 2014/2015
2015-03-28 17:30,KKK Krosno(d),66 : 93P,66,25,42,59.5,3,23,13.0,28,65,43.1,7,10,70.0,5,17,22,18,18,17,15,8,1,0,60,KS Pogoń Prudnik,Sezon 2014/2015
2015-04-11 17:30,AZS Politechnika Poznań(d),68 : 59W,68,20,33,60.6,3,17,17.6,23,50,46.0,19,29,65.5,8,28,36,10,12,23,16,4,1,0,66,KS Pogoń Prudnik,Sezon 2014/2015
2015-04-18 19:00,AZS Politechnika Poznań(w),77 : 82W,82,22,38,57.9,8,18,44.4,30,56,53.6,14,22,63.6,7,24,31,20,23,28,11,7,0,1,95,KS Pogoń Prudnik,Sezon 2014/2015
2014-09-27 19:00,GKS Tychy(w),60 : 66W,66,13,26,50.0,8,22,36.4,21,48,43.8,16,24,66.7,9,31,40,10,18,22,17,1,1,0,66,KS Spójnia Stargard Szczeciński,Sezon 2014/2015
2014-10-04 17:00,Astoria Bydgoszcz(d),67 : 49W,67,21,39,53.8,4,17,23.5,25,56,44.6,13,19,68.4,9,30,39,9,16,23,15,5,1,1,69,KS Spójnia Stargard Szczeciński,Sezon 2014/2015
2014-10-11 19:30,AZS Politechnika Poznań(w),43 : 76W,76,22,32,68.8,8,23,34.8,30,55,54.5,8,10,80.0,2,30,32,19,13,15,10,5,2,0,97,KS Spójnia Stargard Szczeciński,Sezon 2014/2015
2014-10-18 17:00,ACK UTH Rosa Radom(d),71 : 55W,71,17,32,53.1,11,22,50.0,28,54,51.9,4,7,57.1,6,27,33,17,13,16,15,3,2,3,82,KS Spójnia Stargard Szczeciński,Sezon 2014/2015
2014-10-25 18:30,Intermarche Bricomarche BM SlamStal Ostrów(w),79 : 67P,67,16,28,57.1,9,26,34.6,25,54,46.3,8,11,72.7,4,24,28,10,26,19,21,7,4,1,63,KS Spójnia Stargard Szczeciński,Sezon 2014/2015
2014-11-02 17:00,KKK Krosno(d),53 : 57P,53,20,40,50.0,2,17,11.8,22,57,38.6,7,12,58.3,15,20,35,13,16,20,19,10,3,3,55,KS Spójnia Stargard Szczeciński,Sezon 2014/2015
2014-11-08 17:30,KS Pogoń Prudnik(w),66 : 67W,67,22,36,61.1,6,18,33.3,28,54,51.9,5,7,71.4,8,24,32,16,19,17,15,6,1,0,79,KS Spójnia Stargard Szczeciński,Sezon 2014/2015
2014-11-15 17:00,MKS Znicz Basket Pruszków(d),72 : 68W,72,22,36,61.1,5,24,20.8,27,60,45.0,13,17,76.5,12,26,38,20,22,19,17,7,2,1,85,KS Spójnia Stargard Szczeciński,Sezon 2014/2015
2014-11-23 17:00,Legia Warszawa(w),79 : 69P,69,22,34,64.7,4,26,15.4,26,60,43.3,13,14,92.9,7,15,22,12,23,19,14,15,1,2,70,KS Spójnia Stargard Szczeciński,Sezon 2014/2015
2014-11-29 17:00,BASKET ZAGŁĘBIE S.A.(d),58 : 60P,58,15,40,37.5,7,31,22.6,22,71,31.0,7,12,58.3,19,21,40,10,16,20,12,7,2,6,51,KS Spójnia Stargard Szczeciński,Sezon 2014/2015
2014-12-06 17:30,PTG Sokół Łańcut(w),72 : 58P,58,13,35,37.1,6,24,25.0,19,59,32.2,14,22,63.6,10,24,34,6,26,25,15,10,1,5,46,KS Spójnia Stargard Szczeciński,Sezon 2014/2015
2014-12-13 18:00,SKK Siedlce(w),61 : 70W,70,18,32,56.3,6,25,24.0,24,57,42.1,16,23,69.6,8,25,33,14,22,21,13,8,2,1,74,KS Spójnia Stargard Szczeciński,Sezon 2014/2015
2014-12-20 18:00,GTK Fluor Gliwice(w),70 : 68P,68,24,39,61.5,5,23,21.7,29,62,46.8,5,9,55.6,12,23,35,16,22,21,20,5,1,3,68,KS Spójnia Stargard Szczeciński,Sezon 2014/2015
2015-01-03 17:00,GKS Tychy(d),79 : 74W,79,21,32,65.6,7,27,25.9,28,59,47.5,16,22,72.7,9,23,32,17,19,26,16,10,6,3,91,KS Spójnia Stargard Szczeciński,Sezon 2014/2015
2015-01-13 19:00,Astoria Bydgoszcz(w),53 : 71W,71,17,37,45.9,8,26,30.8,25,63,39.7,13,16,81.3,10,19,29,13,24,19,17,16,1,3,72,KS Spójnia Stargard Szczeciński,Sezon 2014/2015
2015-01-17 17:00,AZS Politechnika Poznań(d),78 : 59W,78,18,43,41.9,8,20,40.0,26,63,41.3,18,21,85.7,12,27,39,15,18,19,15,8,3,1,88,KS Spójnia Stargard Szczeciński,Sezon 2014/2015
2015-01-25 17:00,ACK UTH Rosa Radom(w),96 : 75P,75,16,35,45.7,8,26,30.8,24,61,39.3,19,22,86.4,14,15,29,17,27,25,18,11,3,0,77,KS Spójnia Stargard Szczeciński,Sezon 2014/2015
2015-01-31 17:00,Intermarche Bricomarche BM SlamStal Ostrów(d),64 : 77P,64,17,41,41.5,8,24,33.3,25,65,38.5,6,10,60.0,9,25,34,19,29,17,12,7,2,3,70,KS Spójnia Stargard Szczeciński,Sezon 2014/2015
2015-02-07 18:00,KKK Krosno(w),85 : 76P,76,14,38,36.8,10,18,55.6,24,56,42.9,18,24,75.0,4,20,24,15,24,23,14,8,3,2,74,KS Spójnia Stargard Szczeciński,Sezon 2014/2015
2015-02-14 17:00,KS Pogoń Prudnik(d),93 : 71W,93,24,38,63.2,10,26,38.5,34,64,53.1,15,17,88.2,5,30,35,19,23,18,14,11,1,1,113,KS Spójnia Stargard Szczeciński,Sezon 2014/2015
2015-02-25 19:00,MKS Znicz Basket Pruszków(w),87 : 81P,81,15,40,37.5,14,33,42.4,29,73,39.7,9,10,90.0,8,15,23,15,26,16,7,11,3,6,81,KS Spójnia Stargard Szczeciński,Sezon 2014/2015
2015-03-01 17:00,Legia Warszawa(d),73 : 66W,73,17,40,42.5,9,23,39.1,26,63,41.3,12,18,66.7,11,26,37,15,22,20,14,5,6,4,79,KS Spójnia Stargard Szczeciński,Sezon 2014/2015
2015-03-08 19:00,BASKET ZAGŁĘBIE S.A.(w),72 : 73W,73,25,38,65.8,6,22,27.3,31,60,51.7,5,8,62.5,9,22,31,20,16,16,14,8,0,0,86,KS Spójnia Stargard Szczeciński,Sezon 2014/2015
2015-03-14 17:00,PTG Sokół Łańcut(d),67 : 79P,67,18,40,45.0,7,18,38.9,25,58,43.1,10,12,83.3,5,24,29,11,15,18,13,8,0,2,67,KS Spójnia Stargard Szczeciński,Sezon 2014/2015
2015-03-21 17:00,SKK Siedlce(d),69 : 60W,69,21,45,46.7,5,24,20.8,26,69,37.7,12,20,60.0,19,21,40,10,16,22,7,10,1,0,72,KS Spójnia Stargard Szczeciński,Sezon 2014/2015
2015-03-29 18:00,GTK Fluor Gliwice(d),79 : 64W,79,18,33,54.5,11,28,39.3,29,61,47.5,10,11,90.9,3,25,28,20,19,17,12,10,1,2,93,KS Spójnia Stargard Szczeciński,Sezon 2014/2015
2015-04-11 19:16,Legia Warszawa(w),85 : 63P,63,17,34,50.0,5,24,20.8,22,58,37.9,14,16,87.5,8,17,25,15,21,19,12,5,0,3,58,KS Spójnia Stargard Szczeciński,Sezon 2014/2015
2015-04-12 17:00,Legia Warszawa(w),73 : 61P,61,18,35,51.4,5,26,19.2,23,61,37.7,10,11,90.9,12,17,29,9,21,15,15,7,1,3,53,KS Spójnia Stargard Szczeciński,Sezon 2014/2015
2015-04-18 18:00,Legia Warszawa(d),72 : 63W,72,16,41,39.0,7,18,38.9,23,59,39.0,19,24,79.2,6,28,34,13,22,24,11,11,3,2,81,KS Spójnia Stargard Szczeciński,Sezon 2014/2015
2015-04-19 17:00,Legia Warszawa(d),65 : 76P,65,11,26,42.3,11,28,39.3,22,54,40.7,10,18,55.6,4,27,31,13,29,21,14,6,4,2,65,KS Spójnia Stargard Szczeciński,Sezon 2014/2015
2014-09-27 18:00,KKK Krosno(w),62 : 52P,52,14,26,53.8,5,20,25.0,19,46,41.3,9,23,39.1,7,25,32,10,23,25,23,10,1,2,41,Legia Warszawa,Sezon 2014/2015
2014-10-02 19:00,MKS Znicz Basket Pruszków(w),72 : 69P,69,15,30,50.0,9,28,32.1,24,58,41.4,12,22,54.5,8,20,28,12,27,25,19,9,5,7,60,Legia Warszawa,Sezon 2014/2015
2014-10-10 19:16,BASKET ZAGŁĘBIE S.A.(d),88 : 57W,88,28,40,70.0,7,27,25.9,35,67,52.2,11,15,73.3,18,24,42,23,24,20,15,10,7,3,119,Legia Warszawa,Sezon 2014/2015
2014-10-18 18:00,SKK Siedlce(w),58 : 89W,89,21,40,52.5,8,24,33.3,29,64,45.3,23,29,79.3,11,32,43,21,29,28,15,5,5,1,107,Legia Warszawa,Sezon 2014/2015
2014-10-24 19:16,GKS Tychy(d),75 : 76P,75,21,42,50.0,7,25,28.0,28,67,41.8,12,15,80.0,13,20,33,17,20,18,12,9,0,3,80,Legia Warszawa,Sezon 2014/2015
2014-11-02 18:00,AZS Politechnika Poznań(w),60 : 76W,76,25,38,65.8,8,27,29.6,33,65,50.8,2,7,28.6,11,29,40,19,21,17,17,6,0,3,87,Legia Warszawa,Sezon 2014/2015
2014-11-07 17:45,Intermarche Bricomarche BM SlamStal Ostrów(d),69 : 80P,69,19,37,51.4,8,27,29.6,27,64,42.2,7,16,43.8,9,29,38,17,31,21,18,7,0,2,67,Legia Warszawa,Sezon 2014/2015
2014-11-16 17:00,KS Pogoń Prudnik(w),70 : 81W,81,25,39,64.1,6,25,24.0,31,64,48.4,13,17,76.5,12,26,38,17,21,23,12,5,1,0,93,Legia Warszawa,Sezon 2014/2015
2014-11-23 17:00,KS Spójnia Stargard Szczeciński(d),79 : 69W,79,20,32,62.5,8,22,36.4,28,54,51.9,15,23,65.2,12,21,33,13,19,23,22,8,2,1,79,Legia Warszawa,Sezon 2014/2015
2014-11-28 19:45,PTG Sokół Łańcut(d),82 : 87P,82,19,37,51.4,8,24,33.3,27,61,44.3,20,34,58.8,11,21,32,12,28,25,17,6,1,1,68,Legia Warszawa,Sezon 2014/2015
2014-12-05 20:00,GTK Fluor Gliwice(w),58 : 59W,59,17,29,58.6,7,24,29.2,24,53,45.3,4,15,26.7,3,27,30,19,20,19,16,6,2,3,60,Legia Warszawa,Sezon 2014/2015
2014-12-12 19:45,Astoria Bydgoszcz(d),82 : 74W,82,22,40,55.0,9,24,37.5,31,64,48.4,11,17,64.7,9,26,35,20,24,22,16,10,3,1,95,Legia Warszawa,Sezon 2014/2015
2014-12-20 17:00,ACK UTH Rosa Radom(w),87 : 72P,72,12,29,41.4,12,32,37.5,24,61,39.3,12,16,75.0,11,23,34,11,23,22,23,6,2,1,61,Legia Warszawa,Sezon 2014/2015
2015-01-04 17:45,KKK Krosno(d),72 : 64W,72,16,30,53.3,8,31,25.8,24,61,39.3,16,20,80.0,13,27,40,13,20,20,11,6,1,2,80,Legia Warszawa,Sezon 2014/2015
2015-01-10 17:45,MKS Znicz Basket Pruszków(d),97 : 68W,97,12,24,50.0,17,37,45.9,29,61,47.5,22,34,64.7,18,22,40,23,21,26,21,8,5,2,108,Legia Warszawa,Sezon 2014/2015
2015-01-16 17:30,BASKET ZAGŁĘBIE S.A.(w),78 : 75P,75,25,45,55.6,6,18,33.3,31,63,49.2,7,19,36.8,12,22,34,20,18,21,13,6,0,8,78,Legia Warszawa,Sezon 2014/2015
2015-01-24 19:45,SKK Siedlce(d),69 : 39W,69,14,36,38.9,7,22,31.8,21,58,36.2,20,36,55.6,15,29,44,14,16,28,16,12,6,2,76,Legia Warszawa,Sezon 2014/2015
2015-01-31 19:00,GKS Tychy(w),56 : 81W,81,23,35,65.7,6,20,30.0,29,55,52.7,17,26,65.4,13,30,43,15,15,25,18,8,11,3,105,Legia Warszawa,Sezon 2014/2015
2015-02-08 17:45,AZS Politechnika Poznań(d),99 : 41W,99,17,27,63.0,18,36,50.0,35,63,55.6,11,18,61.1,6,41,47,26,13,21,17,9,3,4,132,Legia Warszawa,Sezon 2014/2015
2015-02-14 18:30,Intermarche Bricomarche BM SlamStal Ostrów(w),86 : 79P,79,24,33,72.7,8,28,28.6,32,61,52.5,7,14,50.0,6,20,26,15,16,18,12,5,1,0,78,Legia Warszawa,Sezon 2014/2015
2015-02-21 17:45,KS Pogoń Prudnik(d),101 : 61W,101,27,44,61.4,10,22,45.5,37,66,56.1,17,19,89.5,8,34,42,26,17,23,19,10,2,8,131,Legia Warszawa,Sezon 2014/2015
2015-03-01 17:00,KS Spójnia Stargard Szczeciński(w),73 : 66P,66,15,38,39.5,8,25,32.0,23,63,36.5,12,23,52.2,13,21,34,10,20,22,14,8,4,6,57,Legia Warszawa,Sezon 2014/2015
2015-03-07 17:30,PTG Sokół Łańcut(w),76 : 78W,78,18,34,52.9,7,27,25.9,25,61,41.0,21,24,87.5,16,21,37,17,20,23,18,8,1,3,84,Legia Warszawa,Sezon 2014/2015
2015-03-14 17:00,GTK Fluor Gliwice(d),80 : 86P,80,19,36,52.8,10,33,30.3,29,69,42.0,12,20,60.0,7,16,23,15,26,20,8,7,1,4,70,Legia Warszawa,Sezon 2014/2015
2015-03-21 20:00,Astoria Bydgoszcz(w),59 : 101W,101,25,38,65.8,12,27,44.4,37,65,56.9,15,21,71.4,12,31,43,28,16,17,15,13,8,3,144,Legia Warszawa,Sezon 2014/2015
2015-03-29 18:00,ACK UTH Rosa Radom(d),63 : 73P,63,18,40,45.0,6,27,22.2,24,67,35.8,9,17,52.9,18,30,48,13,22,18,16,5,2,2,64,Legia Warszawa,Sezon 2014/2015
2015-04-11 19:16,KS Spójnia Stargard Szczeciński(d),85 : 63W,85,21,39,53.8,7,24,29.2,28,63,44.4,22,28,78.6,16,22,38,19,19,21,11,7,3,0,100,Legia Warszawa,Sezon 2014/2015
2015-04-12 17:00,KS Spójnia Stargard Szczeciński(d),73 : 61W,73,13,30,43.3,11,27,40.7,24,57,42.1,14,15,93.3,10,18,28,14,15,21,16,6,3,1,74,Legia Warszawa,Sezon 2014/2015
2015-04-18 18:00,KS Spójnia Stargard Szczeciński(w),72 : 63P,63,13,34,38.2,9,26,34.6,22,60,36.7,10,23,43.5,10,29,39,9,24,22,19,4,2,3,47,Legia Warszawa,Sezon 2014/2015
2015-04-19 17:00,KS Spójnia Stargard Szczeciński(w),65 : 76W,76,19,43,44.2,4,22,18.2,23,65,35.4,26,34,76.5,17,33,50,9,22,29,11,7,2,4,83,Legia Warszawa,Sezon 2014/2015
2015-04-25 18:30,Intermarche Bricomarche BM SlamStal Ostrów(w),78 : 68P,68,16,43,37.2,8,30,26.7,24,73,32.9,12,16,75.0,12,27,39,11,23,17,13,5,4,2,61,Legia Warszawa,Sezon 2014/2015
2015-04-26 18:30,Intermarche Bricomarche BM SlamStal Ostrów(w),67 : 79W,79,20,37,54.1,8,26,30.8,28,63,44.4,15,24,62.5,9,29,38,9,19,20,11,9,4,2,84,Legia Warszawa,Sezon 2014/2015
2015-05-02 19:45,Intermarche Bricomarche BM SlamStal Ostrów(d),83 : 86P,83,24,45,53.3,7,20,35.0,31,65,47.7,14,16,87.5,14,26,40,13,24,20,13,3,2,3,92,Legia Warszawa,Sezon 2014/2015
2015-05-03 17:00,Intermarche Bricomarche BM SlamStal Ostrów(d),67 : 59W,67,17,42,40.5,8,23,34.8,25,65,38.5,9,14,64.3,11,31,42,7,25,20,13,8,2,2,68,Legia Warszawa,Sezon 2014/2015
2015-05-06 18:30,Intermarche Bricomarche BM SlamStal Ostrów(w),71 : 58P,58,16,45,35.6,6,28,21.4,22,73,30.1,8,11,72.7,16,26,42,10,21,18,11,9,2,3,56,Legia Warszawa,Sezon 2014/2015
2015-05-09 19:00,KKK Krosno(d),67 : 82P,67,20,41,48.8,7,28,25.0,27,69,39.1,6,9,66.7,15,21,36,14,18,20,14,7,1,1,66,Legia Warszawa,Sezon 2014/2015
2015-05-16 18:00,KKK Krosno(w),110 : 77P,77,17,34,50.0,10,34,29.4,27,68,39.7,13,25,52.0,9,22,31,22,12,23,10,6,1,3,74,Legia Warszawa,Sezon 2014/2015
2014-09-27 18:00,KS Pogoń Prudnik(d),67 : 57W,67,26,45,57.8,3,16,18.8,29,61,47.5,6,9,66.7,10,30,40,13,17,20,14,8,2,1,81,MKS Znicz Basket Pruszków,Sezon 2014/2015
2014-10-02 19:00,Legia Warszawa(d),72 : 69W,72,18,39,46.2,8,20,40.0,26,59,44.1,12,21,57.1,10,26,36,10,25,27,16,11,7,5,78,MKS Znicz Basket Pruszków,Sezon 2014/2015
2014-10-11 17:30,PTG Sokół Łańcut(w),84 : 62P,62,23,45,51.1,2,14,14.3,25,59,42.4,10,19,52.6,8,21,29,8,19,25,14,6,3,7,51,MKS Znicz Basket Pruszków,Sezon 2014/2015
2014-10-18 18:00,GTK Fluor Gliwice(w),65 : 56P,56,12,27,44.4,7,24,29.2,19,51,37.3,11,17,64.7,2,27,29,7,19,21,17,4,2,0,43,MKS Znicz Basket Pruszków,Sezon 2014/2015
2014-10-26 18:00,Astoria Bydgoszcz(w),83 : 57P,57,13,32,40.6,7,22,31.8,20,54,37.0,10,12,83.3,5,23,28,15,23,16,26,8,1,3,47,MKS Znicz Basket Pruszków,Sezon 2014/2015
2014-11-02 17:00,ACK UTH Rosa Radom(d),82 : 81W,82,15,27,55.6,9,23,39.1,24,50,48.0,25,33,75.8,8,20,28,14,22,30,17,7,4,3,84,MKS Znicz Basket Pruszków,Sezon 2014/2015
2014-11-09 17:00,KKK Krosno(d),66 : 78P,66,11,34,32.4,8,32,25.0,19,66,28.8,20,26,76.9,14,22,36,12,23,24,8,9,3,4,65,MKS Znicz Basket Pruszków,Sezon 2014/2015
2014-11-15 17:00,KS Spójnia Stargard Szczeciński(w),72 : 68P,68,20,45,44.4,4,14,28.6,24,59,40.7,16,21,76.2,5,21,26,13,19,22,10,9,1,2,67,MKS Znicz Basket Pruszków,Sezon 2014/2015
2014-11-23 17:00,BASKET ZAGŁĘBIE S.A.(d),95 : 79W,95,25,37,67.6,10,22,45.5,35,59,59.3,15,19,78.9,7,31,38,19,18,19,21,6,3,2,112,MKS Znicz Basket Pruszków,Sezon 2014/2015
2014-11-29 18:00,SKK Siedlce(w),69 : 79W,79,22,46,47.8,8,28,28.6,30,74,40.5,11,17,64.7,13,22,35,15,15,23,11,10,3,4,81,MKS Znicz Basket Pruszków,Sezon 2014/2015
2014-12-06 18:00,GKS Tychy(d),63 : 48W,63,14,35,40.0,6,25,24.0,20,60,33.3,17,22,77.3,7,25,32,10,12,23,12,14,3,4,65,MKS Znicz Basket Pruszków,Sezon 2014/2015
2014-12-13 19:00,AZS Politechnika Poznań(w),74 : 100W,100,30,54,55.6,8,23,34.8,38,77,49.4,16,29,55.2,18,26,44,25,17,25,12,13,4,2,122,MKS Znicz Basket Pruszków,Sezon 2014/2015
2014-12-20 18:00,Intermarche Bricomarche BM SlamStal Ostrów(d),78 : 64W,78,21,34,61.8,6,21,28.6,27,55,49.1,18,24,75.0,7,24,31,18,21,26,17,10,3,1,89,MKS Znicz Basket Pruszków,Sezon 2014/2015
2015-01-03 17:30,KS Pogoń Prudnik(w),89 : 71P,71,15,33,45.5,9,26,34.6,24,59,40.7,14,17,82.4,10,20,30,13,17,19,17,3,0,0,62,MKS Znicz Basket Pruszków,Sezon 2014/2015
2015-01-10 17:45,Legia Warszawa(w),97 : 68P,68,20,44,45.5,5,23,21.7,25,67,37.3,13,19,68.4,15,17,32,12,27,20,19,6,2,5,53,MKS Znicz Basket Pruszków,Sezon 2014/2015
2015-01-17 18:00,PTG Sokół Łańcut(d),79 : 71W,79,19,38,50.0,7,21,33.3,26,59,44.1,20,24,83.3,10,24,34,15,24,22,17,11,2,3,87,MKS Znicz Basket Pruszków,Sezon 2014/2015
2015-01-24 18:00,GTK Fluor Gliwice(d),80 : 58W,80,25,45,55.6,7,17,41.2,32,62,51.6,9,13,69.2,8,34,42,15,20,19,18,7,3,4,95,MKS Znicz Basket Pruszków,Sezon 2014/2015
2015-02-04 19:00,Astoria Bydgoszcz(d),92 : 68W,92,28,46,60.9,6,18,33.3,34,64,53.1,18,26,69.2,9,23,32,21,21,25,19,17,5,1,110,MKS Znicz Basket Pruszków,Sezon 2014/2015
2015-02-08 17:00,ACK UTH Rosa Radom(w),65 : 85W,85,22,41,53.7,7,26,26.9,29,67,43.3,20,28,71.4,14,27,41,15,9,22,9,9,2,1,97,MKS Znicz Basket Pruszków,Sezon 2014/2015
2015-02-15 18:00,KKK Krosno(w),96 : 78P,78,16,39,41.0,11,24,45.8,27,63,42.9,13,16,81.3,9,20,29,21,23,18,19,13,1,5,84,MKS Znicz Basket Pruszków,Sezon 2014/2015
2015-02-18 20:00,AZS Politechnika Poznań(d),75 : 54W,75,19,36,52.8,10,30,33.3,29,66,43.9,7,19,36.8,8,21,29,19,16,21,14,19,5,0,84,MKS Znicz Basket Pruszków,Sezon 2014/2015
2015-02-25 19:00,KS Spójnia Stargard Szczeciński(d),87 : 81W,87,20,33,60.6,7,18,38.9,27,51,52.9,26,32,81.3,10,32,42,19,16,26,22,6,6,3,108,MKS Znicz Basket Pruszków,Sezon 2014/2015
2015-02-28 18:00,BASKET ZAGŁĘBIE S.A.(w),71 : 60P,60,21,43,48.8,5,21,23.8,26,64,40.6,3,10,30.0,10,21,31,16,16,18,17,14,1,2,60,MKS Znicz Basket Pruszków,Sezon 2014/2015
2015-03-04 19:00,SKK Siedlce(d),82 : 80W,82,12,34,35.3,16,28,57.1,28,62,45.2,10,11,90.9,13,27,40,16,15,17,18,6,6,1,97,MKS Znicz Basket Pruszków,Sezon 2014/2015
2015-03-14 18:00,GKS Tychy(w),80 : 64P,64,16,27,59.3,6,22,27.3,22,49,44.9,14,17,82.4,4,22,26,15,13,24,17,5,1,2,64,MKS Znicz Basket Pruszków,Sezon 2014/2015
2015-03-29 18:00,Intermarche Bricomarche BM SlamStal Ostrów(w),94 : 71P,71,22,38,57.9,5,19,26.3,27,57,47.4,12,19,63.2,10,17,27,8,19,20,17,7,1,1,60,MKS Znicz Basket Pruszków,Sezon 2014/2015
2015-04-11 18:00,KKK Krosno(w),78 : 63P,63,17,36,47.2,6,26,23.1,23,62,37.1,11,19,57.9,7,24,31,14,20,19,15,8,2,5,56,MKS Znicz Basket Pruszków,Sezon 2014/2015
2015-04-12 18:00,KKK Krosno(w),81 : 72P,72,18,40,45.0,9,23,39.1,27,63,42.9,9,13,69.2,7,23,30,13,20,18,13,3,1,6,66,MKS Znicz Basket Pruszków,Sezon 2014/2015
2015-04-18 17:00,KKK Krosno(d),65 : 77P,65,16,34,47.1,8,26,30.8,24,60,40.0,9,12,75.0,7,17,24,18,17,14,16,12,1,2,65,MKS Znicz Basket Pruszków,Sezon 2014/2015
2014-09-27 17:30,ACK UTH Rosa Radom(d),77 : 52W,77,21,42,50.0,7,28,25.0,28,70,40.0,14,20,70.0,14,28,42,15,23,21,16,13,5,0,88,PTG Sokół Łańcut,Sezon 2014/2015
2014-10-05 18:00,KKK Krosno(w),74 : 73P,73,13,34,38.2,13,24,54.2,26,58,44.8,8,12,66.7,9,24,33,16,26,20,17,6,1,4,76,PTG Sokół Łańcut,Sezon 2014/2015
2014-10-11 17:30,MKS Znicz Basket Pruszków(d),84 : 62W,84,21,42,50.0,9,26,34.6,30,68,44.1,15,18,83.3,17,23,40,19,25,18,12,8,7,3,105,PTG Sokół Łańcut,Sezon 2014/2015
2014-10-19 19:00,BASKET ZAGŁĘBIE S.A.(w),58 : 74W,74,19,39,48.7,8,22,36.4,27,61,44.3,12,17,70.6,10,28,38,10,21,20,15,8,5,2,81,PTG Sokół Łańcut,Sezon 2014/2015
2014-10-25 17:30,SKK Siedlce(d),92 : 69W,92,22,36,61.1,9,28,32.1,31,64,48.4,21,24,87.5,12,21,33,26,17,22,11,14,4,2,122,PTG Sokół Łańcut,Sezon 2014/2015
2014-11-02 18:00,GKS Tychy(w),62 : 81W,81,18,34,52.9,10,24,41.7,28,58,48.3,15,21,71.4,6,30,36,19,20,23,16,5,6,0,95,PTG Sokół Łańcut,Sezon 2014/2015
2014-11-08 17:30,AZS Politechnika Poznań(d),89 : 64W,89,25,38,65.8,10,31,32.3,35,69,50.7,9,12,75.0,11,24,35,27,16,16,12,12,4,0,118,PTG Sokół Łańcut,Sezon 2014/2015
2014-11-15 18:30,Intermarche Bricomarche BM SlamStal Ostrów(w),72 : 67P,67,23,46,50.0,4,23,17.4,27,69,39.1,9,13,69.2,15,24,39,24,22,17,10,8,3,2,85,PTG Sokół Łańcut,Sezon 2014/2015
2014-11-22 17:30,KS Pogoń Prudnik(d),83 : 68W,83,27,42,64.3,5,24,20.8,32,66,48.5,14,20,70.0,13,34,47,16,24,21,17,9,5,1,103,PTG Sokół Łańcut,Sezon 2014/2015
2014-11-28 19:45,Legia Warszawa(w),82 : 87W,87,16,32,50.0,10,28,35.7,26,60,43.3,25,36,69.4,11,23,34,12,25,27,12,10,1,1,87,PTG Sokół Łańcut,Sezon 2014/2015
2014-12-06 17:30,KS Spójnia Stargard Szczeciński(d),72 : 58W,72,19,44,43.2,5,23,21.7,24,67,35.8,19,21,90.5,15,30,45,9,25,26,15,7,5,0,78,PTG Sokół Łańcut,Sezon 2014/2015
2014-12-13 17:30,GTK Fluor Gliwice(d),82 : 72W,82,24,47,51.1,7,15,46.7,31,62,50.0,13,17,76.5,9,23,32,13,24,22,14,8,7,0,93,PTG Sokół Łańcut,Sezon 2014/2015
2014-12-20 19:00,Astoria Bydgoszcz(w),75 : 60P,60,17,40,42.5,5,22,22.7,22,62,35.5,11,16,68.8,14,24,38,9,14,19,21,9,6,2,56,PTG Sokół Łańcut,Sezon 2014/2015
2015-01-03 17:00,ACK UTH Rosa Radom(w),92 : 73P,73,23,38,60.5,4,16,25.0,27,54,50.0,15,22,68.2,9,24,33,15,18,25,23,7,6,1,77,PTG Sokół Łańcut,Sezon 2014/2015
2015-01-10 17:30,KKK Krosno(d),67 : 64W,67,18,53,34.0,6,18,33.3,24,71,33.8,13,19,68.4,20,26,46,10,20,23,12,9,4,5,71,PTG Sokół Łańcut,Sezon 2014/2015
2015-01-17 18:00,MKS Znicz Basket Pruszków(w),79 : 71P,71,18,40,45.0,7,24,29.2,25,64,39.1,14,22,63.6,15,23,38,13,22,23,20,11,3,2,69,PTG Sokół Łańcut,Sezon 2014/2015
2015-01-24 17:30,BASKET ZAGŁĘBIE S.A.(d),87 : 81W,87,23,45,51.1,7,24,29.2,30,69,43.5,20,28,71.4,10,29,39,21,11,23,16,14,6,3,104,PTG Sokół Łańcut,Sezon 2014/2015
2015-01-31 16:00,SKK Siedlce(w),71 : 77W,77,20,41,48.8,8,21,38.1,28,62,45.2,13,18,72.2,10,22,32,18,19,23,14,4,1,3,79,PTG Sokół Łańcut,Sezon 2014/2015
2015-02-07 17:30,GKS Tychy(d),77 : 76W,77,16,35,45.7,7,32,21.9,23,67,34.3,24,35,68.6,16,28,44,15,25,29,13,13,3,2,84,PTG Sokół Łańcut,Sezon 2014/2015
2015-02-14 20:00,AZS Politechnika Poznań(w),45 : 64W,64,18,39,46.2,7,28,25.0,25,67,37.3,7,12,58.3,18,24,42,12,15,19,19,10,3,1,65,PTG Sokół Łańcut,Sezon 2014/2015
2015-02-21 17:30,Intermarche Bricomarche BM SlamStal Ostrów(d),93 : 80W,93,22,35,62.9,7,25,28.0,29,60,48.3,28,32,87.5,8,29,37,20,27,25,11,8,5,0,117,PTG Sokół Łańcut,Sezon 2014/2015
2015-02-28 17:30,KS Pogoń Prudnik(w),63 : 82W,82,20,39,51.3,10,25,40.0,30,64,46.9,12,13,92.3,10,20,30,21,24,18,9,10,1,0,100,PTG Sokół Łańcut,Sezon 2014/2015
2015-03-07 17:30,Legia Warszawa(d),76 : 78P,76,20,35,57.1,8,31,25.8,28,66,42.4,12,16,75.0,13,19,32,15,24,20,13,8,3,1,79,PTG Sokół Łańcut,Sezon 2014/2015
2015-03-14 17:00,KS Spójnia Stargard Szczeciński(w),67 : 79W,79,20,45,44.4,12,23,52.2,32,68,47.1,3,6,50.0,12,24,36,16,18,15,14,10,2,0,90,PTG Sokół Łańcut,Sezon 2014/2015
2015-03-21 18:00,GTK Fluor Gliwice(w),59 : 80W,80,23,36,63.9,7,26,26.9,30,62,48.4,13,17,76.5,10,31,41,18,18,19,17,7,5,0,98,PTG Sokół Łańcut,Sezon 2014/2015
2015-03-28 17:30,Astoria Bydgoszcz(d),71 : 51W,71,21,43,48.8,8,23,34.8,29,66,43.9,5,5,100.0,8,32,40,12,18,16,11,13,6,3,94,PTG Sokół Łańcut,Sezon 2014/2015
2015-04-11 17:30,ACK UTH Rosa Radom(d),80 : 74W,80,15,43,34.9,13,37,35.1,28,80,35.0,11,21,52.4,20,29,49,17,23,24,12,8,5,1,85,PTG Sokół Łańcut,Sezon 2014/2015
2015-04-12 17:30,ACK UTH Rosa Radom(d),84 : 59W,84,17,36,47.2,14,31,45.2,31,67,46.3,8,8,100.0,13,28,41,25,17,17,10,6,2,2,112,PTG Sokół Łańcut,Sezon 2014/2015
2015-04-18 15:00,ACK UTH Rosa Radom(w),60 : 88W,88,30,47,63.8,6,17,35.3,36,64,56.3,10,15,66.7,7,28,35,16,18,20,11,10,3,2,108,PTG Sokół Łańcut,Sezon 2014/2015
2015-04-24 18:00,KKK Krosno(d),67 : 77P,67,14,41,34.1,9,28,32.1,23,69,33.3,12,15,80.0,11,17,28,16,20,20,9,7,4,1,64,PTG Sokół Łańcut,Sezon 2014/2015
2015-04-25 17:30,KKK Krosno(d),58 : 72P,58,18,39,46.2,5,23,21.7,23,62,37.1,7,14,50.0,13,24,37,14,20,19,18,9,6,4,60,PTG Sokół Łańcut,Sezon 2014/2015
2015-05-02 18:00,KKK Krosno(w),76 : 86W,86,24,46,52.2,8,27,29.6,32,73,43.8,14,22,63.6,15,20,35,17,23,19,9,7,2,3,89,PTG Sokół Łańcut,Sezon 2014/2015
2015-05-03 18:00,KKK Krosno(w),84 : 97W,97,17,34,50.0,15,22,68.2,32,56,57.1,18,26,69.2,6,25,31,17,19,24,11,3,3,3,108,PTG Sokół Łańcut,Sezon 2014/2015
2015-05-06 18:00,KKK Krosno(d),86 : 78W,86,18,33,54.5,13,29,44.8,31,62,50.0,11,18,61.1,11,28,39,20,19,20,17,8,2,2,100,PTG Sokół Łańcut,Sezon 2014/2015
2015-05-09 18:30,Intermarche Bricomarche BM SlamStal Ostrów(w),90 : 85P,85,17,42,40.5,15,35,42.9,32,77,41.6,6,12,50.0,10,35,45,11,24,14,14,4,1,4,81,PTG Sokół Łańcut,Sezon 2014/2015
2015-05-10 18:30,Intermarche Bricomarche BM SlamStal Ostrów(w),74 : 72P,72,22,43,51.2,6,22,27.3,28,65,43.1,10,13,76.9,8,25,33,17,20,15,13,10,2,0,81,PTG Sokół Łańcut,Sezon 2014/2015
2015-05-16 17:30,Intermarche Bricomarche BM SlamStal Ostrów(d),71 : 60W,71,19,42,45.2,5,18,27.8,24,60,40.0,18,28,64.3,13,29,42,17,23,22,15,9,6,1,84,PTG Sokół Łańcut,Sezon 2014/2015
2015-05-17 17:30,Intermarche Bricomarche BM SlamStal Ostrów(d),63 : 76P,63,14,34,41.2,7,31,22.6,21,65,32.3,14,21,66.7,14,23,37,9,19,20,10,7,3,2,58,PTG Sokół Łańcut,Sezon 2014/2015
2014-09-27 18:00,AZS Politechnika Poznań(w),65 : 61P,61,16,31,51.6,8,26,30.8,24,57,42.1,5,12,41.7,13,27,40,16,21,21,20,3,0,2,60,SKK Siedlce,Sezon 2014/2015
2014-10-04 18:00,Intermarche Bricomarche BM SlamStal Ostrów(d),69 : 90P,69,16,28,57.1,9,26,34.6,25,54,46.3,10,18,55.6,9,19,28,14,18,18,20,4,1,2,59,SKK Siedlce,Sezon 2014/2015
2014-10-11 17:30,KS Pogoń Prudnik(w),72 : 56P,56,18,36,50.0,3,16,18.8,21,52,40.4,11,18,61.1,6,30,36,7,23,23,28,3,4,0,40,SKK Siedlce,Sezon 2014/2015
2014-10-18 18:00,Legia Warszawa(d),58 : 89P,58,8,29,27.6,7,28,25.0,15,57,26.3,21,28,75.0,6,18,24,6,28,29,14,4,1,5,30,SKK Siedlce,Sezon 2014/2015
2014-10-25 17:30,PTG Sokół Łańcut(w),92 : 69P,69,18,35,51.4,8,28,28.6,26,63,41.3,9,12,75.0,10,18,28,15,22,16,18,7,2,4,63,SKK Siedlce,Sezon 2014/2015
2014-11-02 18:00,GTK Fluor Gliwice(d),78 : 74W,78,19,41,46.3,7,20,35.0,26,61,42.6,19,26,73.1,8,33,41,9,24,24,15,5,1,1,77,SKK Siedlce,Sezon 2014/2015
2014-11-08 19:00,Astoria Bydgoszcz(w),78 : 88W,88,23,51,45.1,9,21,42.9,32,72,44.4,15,23,65.2,17,31,48,17,21,21,16,9,2,5,100,SKK Siedlce,Sezon 2014/2015
2014-11-16 18:00,ACK UTH Rosa Radom(d),64 : 86P,64,20,42,47.6,4,23,17.4,24,65,36.9,12,16,75.0,13,25,38,0,16,20,14,3,2,3,63,SKK Siedlce,Sezon 2014/2015
2014-11-22 18:00,KKK Krosno(w),84 : 72P,72,22,45,48.9,6,19,31.6,28,64,43.8,10,15,66.7,20,27,47,14,17,21,17,2,0,2,77,SKK Siedlce,Sezon 2014/2015
2014-11-29 18:00,MKS Znicz Basket Pruszków(d),69 : 79P,69,19,39,48.7,9,24,37.5,28,63,44.4,4,9,44.4,12,25,37,19,23,15,20,5,4,3,74,SKK Siedlce,Sezon 2014/2015
2014-12-06 17:00,BASKET ZAGŁĘBIE S.A.(w),85 : 69P,69,26,47,55.3,4,21,19.0,30,68,44.1,5,8,62.5,15,28,43,20,19,15,17,7,0,4,81,SKK Siedlce,Sezon 2014/2015
2014-12-13 18:00,KS Spójnia Stargard Szczeciński(d),61 : 70P,61,15,40,37.5,7,20,35.0,22,60,36.7,10,13,76.9,10,25,35,15,21,22,19,5,1,2,57,SKK Siedlce,Sezon 2014/2015
2014-12-21 17:00,GKS Tychy(d),72 : 69W,72,19,39,48.7,8,22,36.4,27,61,44.3,10,15,66.7,9,30,39,17,17,20,20,9,3,2,81,SKK Siedlce,Sezon 2014/2015
2015-01-04 18:00,AZS Politechnika Poznań(d),74 : 67W,74,18,33,54.5,5,21,23.8,23,54,42.6,23,31,74.2,11,36,47,17,15,27,15,3,1,0,88,SKK Siedlce,Sezon 2014/2015
2015-01-10 18:30,Intermarche Bricomarche BM SlamStal Ostrów(w),83 : 69P,69,21,39,53.8,7,14,50.0,28,53,52.8,6,14,42.9,3,28,31,12,27,16,15,1,0,1,65,SKK Siedlce,Sezon 2014/2015
2015-01-17 16:00,KS Pogoń Prudnik(d),73 : 72W,73,17,33,51.5,9,20,45.0,26,53,49.1,12,15,80.0,4,29,33,15,21,18,21,4,3,3,77,SKK Siedlce,Sezon 2014/2015
2015-01-24 19:45,Legia Warszawa(w),69 : 39P,39,13,39,33.3,3,21,14.3,16,60,26.7,4,7,57.1,8,25,33,14,28,15,21,5,2,6,25,SKK Siedlce,Sezon 2014/2015
2015-01-31 16:00,PTG Sokół Łańcut(d),71 : 77P,71,16,38,42.1,9,24,37.5,25,62,40.3,12,12,100.0,11,21,32,13,23,19,17,6,3,1,71,SKK Siedlce,Sezon 2014/2015
2015-02-07 18:00,GTK Fluor Gliwice(w),72 : 51P,51,7,22,31.8,9,29,31.0,16,51,31.4,10,15,66.7,9,21,30,12,19,20,14,7,1,0,47,SKK Siedlce,Sezon 2014/2015
2015-02-15 17:00,Astoria Bydgoszcz(d),76 : 64W,76,20,34,58.8,8,21,38.1,28,55,50.9,12,22,54.5,6,27,33,14,20,24,18,10,2,1,80,SKK Siedlce,Sezon 2014/2015
2015-02-22 17:00,ACK UTH Rosa Radom(w),87 : 79P,79,14,32,43.8,13,29,44.8,27,61,44.3,12,17,70.6,14,22,36,17,18,20,13,5,1,1,86,SKK Siedlce,Sezon 2014/2015
2015-02-28 18:00,KKK Krosno(d),59 : 89P,59,13,42,31.0,9,27,33.3,22,69,31.9,6,8,75.0,14,24,38,10,17,14,17,4,3,1,48,SKK Siedlce,Sezon 2014/2015
2015-03-04 19:00,MKS Znicz Basket Pruszków(w),82 : 80P,80,18,44,40.9,12,27,44.4,30,71,42.3,8,10,80.0,10,20,30,17,17,15,11,8,1,6,82,SKK Siedlce,Sezon 2014/2015
2015-03-15 17:00,BASKET ZAGŁĘBIE S.A.(d),83 : 78W,83,17,38,44.7,11,28,39.3,28,66,42.4,16,23,69.6,15,31,46,11,17,21,18,9,3,0,89,SKK Siedlce,Sezon 2014/2015
2015-03-21 17:00,KS Spójnia Stargard Szczeciński(w),69 : 60P,60,10,25,40.0,12,27,44.4,22,52,42.3,4,7,57.1,6,26,32,15,22,15,18,5,0,1,61,SKK Siedlce,Sezon 2014/2015
2015-03-28 18:00,GKS Tychy(w),81 : 57P,57,19,34,55.9,4,18,22.2,23,52,44.2,7,12,58.3,7,28,35,11,20,19,26,5,0,0,48,SKK Siedlce,Sezon 2014/2015
2015-04-12 19:00,Astoria Bydgoszcz(w),77 : 65P,65,15,32,46.9,10,29,34.5,25,61,41.0,5,12,41.7,12,27,39,17,21,21,21,9,3,1,69,SKK Siedlce,Sezon 2014/2015
2015-04-18 18:00,Astoria Bydgoszcz(d),88 : 85W,88,24,40,60.0,9,25,36.0,33,65,50.8,13,20,65.0,7,27,34,12,25,23,23,10,1,0,83,SKK Siedlce,Sezon 2014/2015
2015-04-22 19:00,Astoria Bydgoszcz(w),69 : 49P,49,16,44,36.4,4,21,19.0,20,65,30.8,5,12,41.7,15,21,36,7,19,18,17,5,2,5,30,SKK Siedlce,Sezon 2014/2015
2015-04-25 19:00,AZS Politechnika Poznań(d),80 : 84P,80,15,34,44.1,13,31,41.9,28,65,43.1,11,18,61.1,12,20,32,19,22,20,17,6,6,0,82,SKK Siedlce,Sezon 2014/2015
2015-04-26 16:00,AZS Politechnika Poznań(d),72 : 45W,72,20,38,52.6,8,27,29.6,28,65,43.1,8,14,57.1,11,38,49,22,16,17,11,5,7,1,101,SKK Siedlce,Sezon 2014/2015
2015-05-02 18:00,AZS Politechnika Poznań(w),81 : 65P,65,10,29,34.5,12,34,35.3,22,63,34.9,9,17,52.9,15,22,37,10,12,16,10,4,2,2,59,SKK Siedlce,Sezon 2014/2015
2015-05-03 18:00,AZS Politechnika Poznań(w),75 : 87W,87,17,32,53.1,12,40,30.0,29,72,40.3,17,27,63.0,16,23,39,16,18,23,10,3,2,2,84,SKK Siedlce,Sezon 2014/2015
2015-05-06 18:00,AZS Politechnika Poznań(d),78 : 69W,78,15,36,41.7,12,27,44.4,27,63,42.9,12,13,92.3,11,23,34,18,19,16,12,9,1,1,91,SKK Siedlce,Sezon 2014/2015
2013-09-29 18:00,Intermarche Bricomarche BM SlamStal Ostrów(d),92 : 86W,92,22,40,55.0,9,18,50.0,31,58,53.4,21,33,63.6,8,18,26,19,15,28,13,11,2,1,98,MKS Dąbrowa Górnicza II,Sezon 2013/2014
2013-10-05 18:00,MKS Znicz Basket Pruszków(w),78 : 68P,68,13,34,38.2,7,28,25.0,20,62,32.3,21,26,80.8,13,22,35,9,26,23,10,7,3,3,65,MKS Dąbrowa Górnicza II,Sezon 2013/2014
2013-10-12 18:00,AZS Politechnika Poznań(d),86 : 69W,86,17,35,48.6,10,30,33.3,27,65,41.5,22,25,88.0,17,27,44,17,23,26,19,10,5,4,102,MKS Dąbrowa Górnicza II,Sezon 2013/2014
2013-10-19 17:30,PTG Sokół Łańcut(w),72 : 73W,73,19,39,48.7,6,22,27.3,25,61,41.0,17,23,73.9,12,22,34,14,20,21,9,6,4,5,80,MKS Dąbrowa Górnicza II,Sezon 2013/2014
2013-10-26 18:00,MOSiR PBS Bank KHS Krosno(d),80 : 93P,80,19,43,44.2,7,26,26.9,26,69,37.7,21,28,75.0,9,28,37,13,24,24,13,6,3,3,76,MKS Dąbrowa Górnicza II,Sezon 2013/2014
2013-11-02 19:00,Astoria Bydgoszcz(w),79 : 89W,89,24,50,48.0,6,23,26.1,30,73,41.1,23,30,76.7,16,30,46,13,25,25,19,10,1,1,90,MKS Dąbrowa Górnicza II,Sezon 2013/2014
2013-11-09 18:00,Polfarmex Kutno(d),90 : 83W,90,19,31,61.3,8,20,40.0,27,51,52.9,28,39,71.8,9,33,42,18,25,30,25,6,2,1,98,MKS Dąbrowa Górnicza II,Sezon 2013/2014
2013-11-16 18:00,Polski Cukier SIDEn Toruń(w),70 : 66P,66,15,28,53.6,6,28,21.4,21,56,37.5,18,23,78.3,10,24,34,14,25,19,16,3,5,2,66,MKS Dąbrowa Górnicza II,Sezon 2013/2014
2013-11-24 18:00,KS Spójnia Stargard Szczeciński(d),72 : 65W,72,17,29,58.6,7,34,20.6,24,63,38.1,17,25,68.0,13,27,40,10,19,25,8,9,5,1,81,MKS Dąbrowa Górnicza II,Sezon 2013/2014
2013-12-01 19:00,King Wilki Morskie Szczecin(w),66 : 68W,68,15,36,41.7,9,29,31.0,24,65,36.9,11,19,57.9,13,23,36,9,20,19,16,10,1,3,59,MKS Dąbrowa Górnicza II,Sezon 2013/2014
2013-12-07 18:00,MCKiS Termo-Rex SA Jaworzno(d),76 : 55W,76,17,31,54.8,10,33,30.3,27,64,42.2,12,17,70.6,8,23,31,12,21,20,14,11,3,3,77,MKS Dąbrowa Górnicza II,Sezon 2013/2014
2013-12-14 17:00,WKK ProBiotics Wrocław(w),79 : 78P,78,22,45,48.9,5,17,29.4,27,62,43.5,19,25,76.0,11,19,30,16,26,23,12,7,2,2,80,MKS Dąbrowa Górnicza II,Sezon 2013/2014
2013-12-21 18:00,MKS Wikana Start S.A. Lublin(d),82 : 75W,82,15,29,51.7,12,34,35.3,27,63,42.9,16,21,76.2,7,25,32,19,22,17,13,6,5,3,90,MKS Dąbrowa Górnicza II,Sezon 2013/2014
2014-01-04 18:30,Intermarche Bricomarche BM SlamStal Ostrów(w),74 : 78W,78,18,36,50.0,11,25,44.0,29,61,47.5,9,17,52.9,7,24,31,15,17,21,14,5,3,3,78,MKS Dąbrowa Górnicza II,Sezon 2013/2014
2014-01-12 18:00,MKS Znicz Basket Pruszków(d),90 : 75W,90,20,46,43.5,7,19,36.8,27,65,41.5,29,36,80.6,12,29,41,16,18,28,16,5,13,3,104,MKS Dąbrowa Górnicza II,Sezon 2013/2014
2014-01-18 18:00,AZS Politechnika Poznań(w),74 : 88W,88,22,39,56.4,8,20,40.0,30,59,50.8,20,28,71.4,14,21,35,15,18,27,21,3,1,2,84,MKS Dąbrowa Górnicza II,Sezon 2013/2014
2014-01-26 18:00,PTG Sokół Łańcut(d),81 : 86P,81,21,41,51.2,8,21,38.1,29,62,46.8,15,24,62.5,8,24,32,11,18,23,14,4,6,4,78,MKS Dąbrowa Górnicza II,Sezon 2013/2014
2014-02-01 18:00,MOSiR PBS Bank KHS Krosno(w),95 : 52P,52,7,31,22.6,9,34,26.5,16,65,24.6,11,18,61.1,11,23,34,9,14,21,19,4,2,6,26,MKS Dąbrowa Górnicza II,Sezon 2013/2014
2014-02-09 18:00,Astoria Bydgoszcz(d),70 : 72P,70,17,31,54.8,5,24,20.8,22,55,40.0,21,29,72.4,6,20,26,11,19,22,14,11,4,1,67,MKS Dąbrowa Górnicza II,Sezon 2013/2014
2014-02-15 17:30,Polfarmex Kutno(w),84 : 74P,74,19,36,52.8,7,18,38.9,26,54,48.1,15,20,75.0,7,20,27,14,16,22,19,7,1,2,71,MKS Dąbrowa Górnicza II,Sezon 2013/2014
2014-02-22 18:00,Polski Cukier SIDEn Toruń(d),84 : 69W,84,19,31,61.3,9,25,36.0,28,56,50.0,19,25,76.0,11,22,33,21,19,20,19,9,3,2,97,MKS Dąbrowa Górnicza II,Sezon 2013/2014
2014-03-02 17:00,KS Spójnia Stargard Szczeciński(w),63 : 91W,91,17,32,53.1,15,31,48.4,32,63,50.8,12,15,80.0,10,29,39,22,14,16,17,7,2,4,110,MKS Dąbrowa Górnicza II,Sezon 2013/2014
2014-03-08 18:00,King Wilki Morskie Szczecin(d),74 : 60W,74,17,32,53.1,9,31,29.0,26,63,41.3,13,20,65.0,10,30,40,15,16,23,9,6,5,0,87,MKS Dąbrowa Górnicza II,Sezon 2013/2014
2014-03-15 20:00,MCKiS Termo-Rex SA Jaworzno(w),72 : 88W,88,21,34,61.8,14,31,45.2,35,65,53.8,4,13,30.8,9,30,39,24,15,16,12,9,0,0,109,MKS Dąbrowa Górnicza II,Sezon 2013/2014
2014-03-22 18:00,WKK ProBiotics Wrocław(d),81 : 85P,81,21,39,53.8,3,20,15.0,24,59,40.7,30,33,90.9,5,21,26,15,23,27,9,6,8,1,89,MKS Dąbrowa Górnicza II,Sezon 2013/2014
2014-03-30 18:00,MKS Wikana Start S.A. Lublin(w),86 : 89W,89,20,41,48.8,12,33,36.4,32,74,43.2,13,22,59.1,12,23,35,20,25,25,16,10,1,4,88,MKS Dąbrowa Górnicza II,Sezon 2013/2014
2014-04-05 17:00,WKK ProBiotics Wrocław(w),79 : 77P,77,24,40,60.0,5,16,31.3,29,56,51.8,14,22,63.6,7,27,34,16,19,22,19,6,6,4,85,MKS Dąbrowa Górnicza II,Sezon 2013/2014
2014-04-06 17:00,WKK ProBiotics Wrocław(w),93 : 84P,84,24,47,51.1,4,18,22.2,28,65,43.1,24,35,68.6,10,24,34,15,27,29,16,7,7,1,83,MKS Dąbrowa Górnicza II,Sezon 2013/2014
2014-04-12 18:00,WKK ProBiotics Wrocław(d),84 : 81W,84,26,47,55.3,6,19,31.6,32,66,48.5,14,21,66.7,10,22,32,15,19,21,14,10,5,0,91,MKS Dąbrowa Górnicza II,Sezon 2013/2014
2014-04-13 18:00,WKK ProBiotics Wrocław(d),72 : 75P,72,12,31,38.7,10,25,40.0,22,56,39.3,18,18,100.0,5,23,28,11,22,21,16,2,5,2,68,MKS Dąbrowa Górnicza II,Sezon 2013/2014
2013-09-28 20:00,MCKiS Termo-Rex SA Jaworzno(w),74 : 60P,60,12,32,37.5,11,34,32.4,23,66,34.8,3,8,37.5,10,21,31,15,22,17,21,8,2,5,47,AZS Politechnika Poznań,Sezon 2013/2014
2013-10-05 18:00,WKK ProBiotics Wrocław(d),74 : 72W,74,23,49,46.9,8,14,57.1,31,63,49.2,4,7,57.1,5,34,39,18,22,18,21,10,4,1,89,AZS Politechnika Poznań,Sezon 2013/2014
2013-10-12 18:00,MKS Dąbrowa Górnicza II(w),86 : 69P,69,19,43,44.2,5,16,31.3,24,59,40.7,16,19,84.2,6,19,25,13,26,23,15,13,4,5,71,AZS Politechnika Poznań,Sezon 2013/2014
2013-10-19 19:30,Intermarche Bricomarche BM SlamStal Ostrów(d),60 : 64P,60,17,45,37.8,6,16,37.5,23,61,37.7,8,13,61.5,11,26,37,14,20,18,11,5,2,4,64,AZS Politechnika Poznań,Sezon 2013/2014
2013-10-26 18:00,MKS Znicz Basket Pruszków(w),76 : 64P,64,20,44,45.5,5,19,26.3,25,63,39.7,9,13,69.2,13,19,32,7,26,9,17,9,5,5,58,AZS Politechnika Poznań,Sezon 2013/2014
2013-11-02 18:00,MKS Wikana Start S.A. Lublin(w),72 : 64P,64,21,53,39.6,6,23,26.1,27,76,35.5,4,6,66.7,16,27,43,10,19,12,13,11,4,2,68,AZS Politechnika Poznań,Sezon 2013/2014
2013-11-09 17:30,PTG Sokół Łańcut(w),77 : 54P,54,24,58,41.4,0,12,0.0,24,70,34.3,6,11,54.5,15,23,38,14,19,14,15,9,3,3,52,AZS Politechnika Poznań,Sezon 2013/2014
2013-11-16 16:00,MOSiR PBS Bank KHS Krosno(d),49 : 66P,49,17,42,40.5,2,14,14.3,19,56,33.9,9,10,90.0,10,20,30,11,20,14,12,3,2,1,45,AZS Politechnika Poznań,Sezon 2013/2014
2013-11-23 18:00,Astoria Bydgoszcz(d),76 : 67W,76,31,61,50.8,0,9,0.0,31,70,44.3,14,22,63.6,15,24,39,14,17,20,13,6,6,1,81,AZS Politechnika Poznań,Sezon 2013/2014
2013-11-30 17:30,Polfarmex Kutno(w),86 : 56P,56,24,46,52.2,1,8,12.5,25,54,46.3,5,15,33.3,8,18,26,11,15,19,16,5,1,3,44,AZS Politechnika Poznań,Sezon 2013/2014
2013-12-07 19:00,Polski Cukier SIDEn Toruń(d),65 : 102P,65,21,48,43.8,5,19,26.3,26,67,38.8,8,11,72.7,14,17,31,9,19,16,19,8,0,2,50,AZS Politechnika Poznań,Sezon 2013/2014
2013-12-14 17:00,KS Spójnia Stargard Szczeciński(w),79 : 66P,66,20,40,50.0,4,19,21.1,24,59,40.7,14,19,73.7,10,16,26,14,18,19,17,11,3,7,63,AZS Politechnika Poznań,Sezon 2013/2014
2013-12-21 18:00,King Wilki Morskie Szczecin(d),74 : 84P,74,21,51,41.2,10,23,43.5,31,74,41.9,2,5,40.0,15,20,35,12,25,10,13,6,0,3,68,AZS Politechnika Poznań,Sezon 2013/2014
2014-01-04 18:00,MCKiS Termo-Rex SA Jaworzno(d),73 : 60W,73,19,39,48.7,7,22,31.8,26,61,42.6,14,25,56.0,13,21,34,15,17,23,20,12,2,0,70,AZS Politechnika Poznań,Sezon 2013/2014
2014-01-11 17:00,WKK ProBiotics Wrocław(w),86 : 76P,76,22,48,45.8,6,18,33.3,28,66,42.4,14,21,66.7,10,24,34,10,23,21,16,6,3,2,68,AZS Politechnika Poznań,Sezon 2013/2014
2014-01-18 18:00,MKS Dąbrowa Górnicza II(d),74 : 88P,74,23,49,46.9,7,16,43.8,30,65,46.2,7,11,63.6,9,13,22,13,28,18,15,10,2,0,67,AZS Politechnika Poznań,Sezon 2013/2014
2014-01-25 18:30,Intermarche Bricomarche BM SlamStal Ostrów(w),82 : 65P,65,22,56,39.3,4,18,22.2,26,74,35.1,9,14,64.3,10,25,35,4,29,16,12,9,1,4,49,AZS Politechnika Poznań,Sezon 2013/2014
2014-02-01 18:00,MKS Znicz Basket Pruszków(d),64 : 61W,64,22,47,46.8,3,16,18.8,25,63,39.7,11,16,68.8,10,21,31,15,21,20,18,12,4,2,65,AZS Politechnika Poznań,Sezon 2013/2014
2014-02-08 20:00,MKS Wikana Start S.A. Lublin(d),75 : 87P,75,19,48,39.6,8,20,40.0,27,68,39.7,13,19,68.4,12,20,32,20,27,15,14,4,5,3,75,AZS Politechnika Poznań,Sezon 2013/2014
2014-02-16 18:00,PTG Sokół Łańcut(d),43 : 86P,43,10,36,27.8,3,15,20.0,13,51,25.5,14,20,70.0,9,25,34,8,16,19,19,4,1,4,27,AZS Politechnika Poznań,Sezon 2013/2014
2014-02-22 18:00,MOSiR PBS Bank KHS Krosno(w),90 : 70P,70,24,54,44.4,6,14,42.9,30,68,44.1,4,6,66.7,12,19,31,18,20,15,14,9,1,3,75,AZS Politechnika Poznań,Sezon 2013/2014
2014-03-02 18:00,Astoria Bydgoszcz(w),69 : 67P,67,20,43,46.5,6,14,42.9,26,57,45.6,9,12,75.0,8,21,29,15,19,20,14,10,2,2,75,AZS Politechnika Poznań,Sezon 2013/2014
2014-03-08 18:00,Polfarmex Kutno(d),67 : 90P,67,16,40,40.0,7,18,38.9,23,58,39.7,14,22,63.6,10,28,38,11,18,25,26,9,4,2,60,AZS Politechnika Poznań,Sezon 2013/2014
2014-03-15 18:00,Polski Cukier SIDEn Toruń(w),78 : 57P,57,21,45,46.7,4,18,22.2,25,63,39.7,3,6,50.0,4,22,26,13,23,11,14,4,2,5,47,AZS Politechnika Poznań,Sezon 2013/2014
2014-03-22 16:00,KS Spójnia Stargard Szczeciński(d),69 : 77P,69,17,47,36.2,8,20,40.0,25,67,37.3,11,12,91.7,12,19,31,17,17,15,16,11,1,3,70,AZS Politechnika Poznań,Sezon 2013/2014
2014-03-30 18:00,King Wilki Morskie Szczecin(w),87 : 50P,50,14,43,32.6,5,17,29.4,19,60,31.7,7,8,87.5,6,20,26,14,14,16,21,10,0,3,37,AZS Politechnika Poznań,Sezon 2013/2014
2014-04-05 20:00,MKS Znicz Basket Pruszków(w),67 : 87W,87,26,44,59.1,9,22,40.9,35,66,53.0,8,14,57.1,11,18,29,20,25,11,9,8,2,4,100,AZS Politechnika Poznań,Sezon 2013/2014
2014-04-12 18:00,MKS Znicz Basket Pruszków(d),72 : 62W,72,11,33,33.3,11,29,37.9,22,62,35.5,17,25,68.0,13,20,33,18,28,25,14,9,2,2,72,AZS Politechnika Poznań,Sezon 2013/2014
2013-09-28 18:00,Polski Cukier SIDEn Toruń(w),84 : 66P,66,17,41,41.5,4,12,33.3,21,53,39.6,20,32,62.5,8,25,33,10,20,31,22,8,5,6,56,Astoria Bydgoszcz,Sezon 2013/2014
2013-10-05 17:00,KS Spójnia Stargard Szczeciński(d),80 : 68W,80,24,46,52.2,6,13,46.2,30,59,50.8,14,23,60.9,13,22,35,20,19,20,10,3,1,6,91,Astoria Bydgoszcz,Sezon 2013/2014
2013-10-13 16:00,King Wilki Morskie Szczecin(w),93 : 63P,63,20,48,41.7,2,20,10.0,22,68,32.4,17,27,63.0,14,18,32,11,17,23,14,10,1,7,47,Astoria Bydgoszcz,Sezon 2013/2014
2013-10-20 18:00,MCKiS Termo-Rex SA Jaworzno(d),79 : 74W,79,23,45,51.1,6,20,30.0,29,65,44.6,15,23,65.2,9,23,32,15,22,22,14,7,2,1,77,Astoria Bydgoszcz,Sezon 2013/2014
2013-10-26 17:00,WKK ProBiotics Wrocław(w),91 : 79P,79,24,42,57.1,2,8,25.0,26,50,52.0,25,35,71.4,6,29,35,11,28,30,29,11,3,5,76,Astoria Bydgoszcz,Sezon 2013/2014
2013-11-02 19:00,MKS Dąbrowa Górnicza II(d),79 : 89P,79,20,39,51.3,7,24,29.2,27,63,42.9,18,31,58.1,11,27,38,15,26,25,19,8,1,1,73,Astoria Bydgoszcz,Sezon 2013/2014
2013-11-09 18:30,Intermarche Bricomarche BM SlamStal Ostrów(w),93 : 89P,89,26,49,53.1,7,18,38.9,33,67,49.3,16,23,69.6,11,21,32,14,20,24,14,4,1,1,85,Astoria Bydgoszcz,Sezon 2013/2014
2013-11-17 17:00,MKS Znicz Basket Pruszków(w),59 : 85W,85,24,48,50.0,6,14,42.9,30,62,48.4,19,26,73.1,12,23,35,15,19,22,10,10,0,6,96,Astoria Bydgoszcz,Sezon 2013/2014
2013-11-23 18:00,AZS Politechnika Poznań(w),76 : 67P,67,17,38,44.7,8,22,36.4,25,60,41.7,9,9,100.0,3,20,23,17,22,17,13,6,1,6,66,Astoria Bydgoszcz,Sezon 2013/2014
2013-12-01 17:00,PTG Sokół Łańcut(d),84 : 90P,84,20,40,50.0,10,27,37.0,30,67,44.8,14,18,77.8,10,14,24,19,18,17,14,3,2,3,77,Astoria Bydgoszcz,Sezon 2013/2014
2013-12-07 18:00,MOSiR PBS Bank KHS Krosno(w),96 : 72P,72,20,45,44.4,7,18,38.9,27,63,42.9,11,13,84.6,5,19,24,9,23,18,19,8,1,6,57,Astoria Bydgoszcz,Sezon 2013/2014
2013-12-14 18:00,MKS Wikana Start S.A. Lublin(w),70 : 54P,54,17,44,38.6,3,14,21.4,20,58,34.5,11,19,57.9,12,16,28,6,21,20,16,5,5,3,36,Astoria Bydgoszcz,Sezon 2013/2014
2013-12-21 17:00,Polfarmex Kutno(d),63 : 93P,63,17,40,42.5,3,11,27.3,20,51,39.2,20,34,58.8,11,13,24,10,16,29,24,6,1,5,35,Astoria Bydgoszcz,Sezon 2013/2014
2014-01-04 18:00,Polski Cukier SIDEn Toruń(d),65 : 71P,65,17,43,39.5,8,24,33.3,25,67,37.3,7,13,53.8,12,18,30,10,28,20,10,4,1,6,52,Astoria Bydgoszcz,Sezon 2013/2014
2014-01-11 17:00,KS Spójnia Stargard Szczeciński(w),78 : 68P,68,12,24,50.0,8,21,38.1,20,45,44.4,20,27,74.1,9,15,24,15,23,25,18,8,1,2,66,Astoria Bydgoszcz,Sezon 2013/2014
2014-01-18 18:00,King Wilki Morskie Szczecin(d),78 : 85P,78,22,40,55.0,6,25,24.0,28,65,43.1,16,20,80.0,7,17,24,15,29,22,11,7,0,5,72,Astoria Bydgoszcz,Sezon 2013/2014
2014-01-26 18:00,MCKiS Termo-Rex SA Jaworzno(w),73 : 71P,71,18,30,60.0,7,16,43.8,25,46,54.3,14,16,87.5,3,20,23,12,20,22,18,7,0,2,72,Astoria Bydgoszcz,Sezon 2013/2014
2014-02-01 19:00,WKK ProBiotics Wrocław(d),76 : 70W,76,24,43,55.8,3,9,33.3,27,52,51.9,19,31,61.3,12,19,31,10,22,26,16,13,4,3,81,Astoria Bydgoszcz,Sezon 2013/2014
2014-02-09 18:00,MKS Dąbrowa Górnicza II(w),70 : 72W,72,19,36,52.8,8,19,42.1,27,55,49.1,10,16,62.5,10,24,34,14,22,19,18,4,1,4,73,Astoria Bydgoszcz,Sezon 2013/2014
2014-02-15 17:00,Intermarche Bricomarche BM SlamStal Ostrów(d),64 : 61W,64,20,37,54.1,6,19,31.6,26,56,46.4,6,12,50.0,6,25,31,17,17,18,10,8,3,0,77,Astoria Bydgoszcz,Sezon 2013/2014
2014-02-22 17:00,MKS Znicz Basket Pruszków(d),62 : 70P,62,17,31,54.8,6,28,21.4,23,59,39.0,10,16,62.5,9,20,29,16,24,16,13,15,3,3,70,Astoria Bydgoszcz,Sezon 2013/2014
2014-03-02 18:00,AZS Politechnika Poznań(d),69 : 67W,69,23,37,62.2,4,20,20.0,27,57,47.4,11,13,84.6,6,22,28,16,20,18,17,8,2,2,74,Astoria Bydgoszcz,Sezon 2013/2014
2014-03-08 17:30,PTG Sokół Łańcut(w),78 : 63P,63,15,35,42.9,7,23,30.4,22,58,37.9,12,18,66.7,11,21,32,11,20,18,12,6,1,4,59,Astoria Bydgoszcz,Sezon 2013/2014
2014-03-15 18:00,MOSiR PBS Bank KHS Krosno(d),63 : 82P,63,23,40,57.5,5,21,23.8,28,61,45.9,2,5,40.0,12,22,34,13,18,10,16,6,0,3,64,Astoria Bydgoszcz,Sezon 2013/2014
2014-03-22 18:00,MKS Wikana Start S.A. Lublin(d),61 : 65P,61,17,48,35.4,5,24,20.8,22,72,30.6,12,17,70.6,15,23,38,12,24,17,8,6,3,2,57,Astoria Bydgoszcz,Sezon 2013/2014
2014-03-30 18:00,Polfarmex Kutno(w),76 : 62P,62,14,32,43.8,6,20,30.0,20,52,38.5,16,24,66.7,12,16,28,12,22,24,16,4,0,3,50,Astoria Bydgoszcz,Sezon 2013/2014
2013-09-29 18:00,MKS Dąbrowa Górnicza II(w),92 : 86P,86,32,49,65.3,6,16,37.5,38,65,58.5,4,4,100.0,6,19,25,12,29,15,17,11,1,2,91,Intermarche Bricomarche BM SlamStal Ostrów,Sezon 2013/2014
2013-10-06 17:30,MKS Wikana Start S.A. Lublin(w),79 : 78P,78,21,36,58.3,8,23,34.8,29,59,49.2,12,14,85.7,5,19,24,15,22,19,9,4,0,0,80,Intermarche Bricomarche BM SlamStal Ostrów,Sezon 2013/2014
2013-10-12 18:30,MKS Znicz Basket Pruszków(d),78 : 64W,78,24,43,55.8,5,14,35.7,29,57,50.9,15,17,88.2,2,34,36,17,19,22,12,10,2,3,101,Intermarche Bricomarche BM SlamStal Ostrów,Sezon 2013/2014
2013-10-19 19:30,AZS Politechnika Poznań(w),60 : 64W,64,16,34,47.1,7,24,29.2,23,58,39.7,11,15,73.3,10,23,33,12,18,19,10,8,4,2,72,Intermarche Bricomarche BM SlamStal Ostrów,Sezon 2013/2014
2013-10-26 18:30,PTG Sokół Łańcut(d),86 : 71W,86,25,43,58.1,7,20,35.0,32,63,50.8,15,19,78.9,9,23,32,10,20,19,13,7,1,3,88,Intermarche Bricomarche BM SlamStal Ostrów,Sezon 2013/2014
2013-11-02 18:00,MOSiR PBS Bank KHS Krosno(w),73 : 64P,64,25,40,62.5,2,17,11.8,27,57,47.4,8,11,72.7,9,26,35,13,21,19,15,7,0,4,71,Intermarche Bricomarche BM SlamStal Ostrów,Sezon 2013/2014
2013-11-09 18:30,Astoria Bydgoszcz(d),93 : 89W,93,25,48,52.1,10,19,52.6,35,67,52.2,13,19,68.4,6,19,25,21,24,20,10,7,1,1,99,Intermarche Bricomarche BM SlamStal Ostrów,Sezon 2013/2014
2013-11-16 17:30,Polfarmex Kutno(w),69 : 42P,42,13,36,36.1,3,11,27.3,16,47,34.0,7,14,50.0,6,21,27,7,15,20,16,5,3,0,30,Intermarche Bricomarche BM SlamStal Ostrów,Sezon 2013/2014
2013-11-23 18:30,Polski Cukier SIDEn Toruń(d),68 : 74P,68,15,32,46.9,7,31,22.6,22,63,34.9,17,20,85.0,9,17,26,12,26,17,11,6,0,2,57,Intermarche Bricomarche BM SlamStal Ostrów,Sezon 2013/2014
2013-11-30 17:00,KS Spójnia Stargard Szczeciński(w),72 : 59P,59,12,32,37.5,6,21,28.6,18,53,34.0,17,19,89.5,6,17,23,9,19,23,14,6,3,1,49,Intermarche Bricomarche BM SlamStal Ostrów,Sezon 2013/2014
2013-12-07 18:30,King Wilki Morskie Szczecin(d),94 : 75W,94,28,50,56.0,6,17,35.3,34,67,50.7,20,29,69.0,11,23,34,9,23,20,5,4,0,2,94,Intermarche Bricomarche BM SlamStal Ostrów,Sezon 2013/2014
2013-12-14 20:00,MCKiS Termo-Rex SA Jaworzno(w),72 : 82W,82,19,30,63.3,9,29,31.0,28,59,47.5,17,20,85.0,7,23,30,14,15,28,11,11,2,1,94,Intermarche Bricomarche BM SlamStal Ostrów,Sezon 2013/2014
2013-12-21 18:30,WKK ProBiotics Wrocław(d),66 : 68P,66,20,41,48.8,5,15,33.3,25,56,44.6,11,13,84.6,8,21,29,12,19,21,12,13,2,1,77,Intermarche Bricomarche BM SlamStal Ostrów,Sezon 2013/2014
2014-01-04 18:30,MKS Dąbrowa Górnicza II(d),74 : 78P,74,25,51,49.0,5,19,26.3,30,70,42.9,9,13,69.2,16,23,39,12,21,16,13,5,3,2,76,Intermarche Bricomarche BM SlamStal Ostrów,Sezon 2013/2014
2014-01-11 18:30,MKS Wikana Start S.A. Lublin(d),92 : 97P,92,23,41,56.1,8,23,34.8,31,64,48.4,22,29,75.9,11,22,33,14,26,24,14,8,0,1,93,Intermarche Bricomarche BM SlamStal Ostrów,Sezon 2013/2014
2014-01-19 17:00,MKS Znicz Basket Pruszków(w),46 : 68W,68,19,44,43.2,5,20,25.0,24,64,37.5,15,20,75.0,8,25,33,9,21,21,10,14,2,3,71,Intermarche Bricomarche BM SlamStal Ostrów,Sezon 2013/2014
2014-01-25 18:30,AZS Politechnika Poznań(d),82 : 65W,82,19,38,50.0,6,25,24.0,25,63,39.7,26,35,74.3,11,31,42,17,16,29,9,4,4,1,93,Intermarche Bricomarche BM SlamStal Ostrów,Sezon 2013/2014
2014-02-01 17:30,PTG Sokół Łańcut(w),79 : 63P,63,16,39,41.0,4,18,22.2,20,57,35.1,19,26,73.1,7,16,23,10,15,25,13,11,2,0,52,Intermarche Bricomarche BM SlamStal Ostrów,Sezon 2013/2014
2014-02-08 18:30,MOSiR PBS Bank KHS Krosno(d),86 : 74W,86,24,49,49.0,9,24,37.5,33,73,45.2,11,17,64.7,8,28,36,20,13,23,9,11,3,3,101,Intermarche Bricomarche BM SlamStal Ostrów,Sezon 2013/2014
2014-02-15 17:00,Astoria Bydgoszcz(w),64 : 61P,61,15,40,37.5,8,20,40.0,23,60,38.3,7,8,87.5,10,26,36,10,18,17,12,8,0,3,65,Intermarche Bricomarche BM SlamStal Ostrów,Sezon 2013/2014
2014-02-23 18:30,Polfarmex Kutno(d),86 : 79W,86,27,45,60.0,2,11,18.2,29,56,51.8,26,40,65.0,13,26,39,12,18,30,18,4,1,0,83,Intermarche Bricomarche BM SlamStal Ostrów,Sezon 2013/2014
2014-03-01 17:00,Polski Cukier SIDEn Toruń(w),69 : 68P,68,18,34,52.9,6,19,31.6,24,53,45.3,14,17,82.4,3,24,27,11,18,18,14,5,1,4,66,Intermarche Bricomarche BM SlamStal Ostrów,Sezon 2013/2014
2014-03-08 18:30,KS Spójnia Stargard Szczeciński(d),68 : 53W,68,19,31,61.3,4,25,16.0,23,56,41.1,18,20,90.0,5,26,31,10,19,17,11,7,3,3,73,Intermarche Bricomarche BM SlamStal Ostrów,Sezon 2013/2014
2014-03-15 16:00,King Wilki Morskie Szczecin(w),72 : 76W,76,27,47,57.4,3,15,20.0,30,62,48.4,13,17,76.5,8,18,26,7,20,22,13,10,1,1,71,Intermarche Bricomarche BM SlamStal Ostrów,Sezon 2013/2014
2014-03-22 18:30,MCKiS Termo-Rex SA Jaworzno(d),71 : 68W,71,13,30,43.3,8,30,26.7,21,60,35.0,21,25,84.0,16,21,37,15,14,25,16,7,2,3,73,Intermarche Bricomarche BM SlamStal Ostrów,Sezon 2013/2014
2014-03-30 18:00,WKK ProBiotics Wrocław(w),77 : 60P,60,21,47,44.7,2,18,11.1,23,65,35.4,12,25,48.0,15,19,34,6,23,23,12,9,2,2,44,Intermarche Bricomarche BM SlamStal Ostrów,Sezon 2013/2014
2013-09-28 20:00,PTG Sokół Łańcut(d),84 : 77W,84,25,49,51.0,6,19,31.6,31,68,45.6,16,20,80.0,10,21,31,17,24,27,16,13,2,4,90,King Wilki Morskie Szczecin,Sezon 2013/2014
2013-10-05 18:00,MOSiR PBS Bank KHS Krosno(w),89 : 81P,81,17,30,56.7,10,26,38.5,27,56,48.2,17,25,68.0,5,31,36,15,25,24,17,2,0,1,80,King Wilki Morskie Szczecin,Sezon 2013/2014
2013-10-13 16:00,Astoria Bydgoszcz(d),93 : 63W,93,29,47,61.7,8,25,32.0,37,72,51.4,11,15,73.3,14,36,50,23,23,17,16,7,7,1,125,King Wilki Morskie Szczecin,Sezon 2013/2014
2013-10-19 17:30,Polfarmex Kutno(w),90 : 60P,60,18,35,51.4,4,21,19.0,22,56,39.3,12,20,60.0,6,19,25,13,24,23,20,7,1,2,44,King Wilki Morskie Szczecin,Sezon 2013/2014
2013-10-28 20:00,Polski Cukier SIDEn Toruń(d),76 : 79P,76,20,34,58.8,8,20,40.0,28,54,51.9,12,20,60.0,4,27,31,14,24,19,15,4,5,4,81,King Wilki Morskie Szczecin,Sezon 2013/2014
2013-11-03 17:00,KS Spójnia Stargard Szczeciński(w),53 : 67W,67,16,34,47.1,7,19,36.8,23,53,43.4,14,23,60.9,14,28,42,10,22,25,18,4,3,1,69,King Wilki Morskie Szczecin,Sezon 2013/2014
2013-11-09 18:00,MKS Wikana Start S.A. Lublin(d),86 : 78W,86,16,36,44.4,12,23,52.2,28,59,47.5,18,24,75.0,5,24,29,20,22,22,15,6,5,2,94,King Wilki Morskie Szczecin,Sezon 2013/2014
2013-11-16 18:00,MCKiS Termo-Rex SA Jaworzno(d),75 : 52W,75,22,46,47.8,10,27,37.0,32,73,43.8,1,5,20.0,13,26,39,19,12,12,14,12,6,2,92,King Wilki Morskie Szczecin,Sezon 2013/2014
2013-11-23 17:00,WKK ProBiotics Wrocław(w),75 : 83W,83,19,39,48.7,7,19,36.8,26,58,44.8,24,31,77.4,10,30,40,15,25,28,19,6,4,5,90,King Wilki Morskie Szczecin,Sezon 2013/2014
2013-12-01 19:00,MKS Dąbrowa Górnicza II(d),66 : 68P,66,21,39,53.8,6,22,27.3,27,61,44.3,6,10,60.0,8,30,38,19,19,20,20,8,3,1,76,King Wilki Morskie Szczecin,Sezon 2013/2014
2013-12-07 18:30,Intermarche Bricomarche BM SlamStal Ostrów(w),94 : 75P,75,25,46,54.3,4,20,20.0,29,66,43.9,13,18,72.2,10,20,30,12,20,23,10,2,2,0,69,King Wilki Morskie Szczecin,Sezon 2013/2014
2013-12-15 19:00,MKS Znicz Basket Pruszków(d),82 : 62W,82,26,43,60.5,9,26,34.6,35,69,50.7,3,8,37.5,12,33,45,22,22,15,18,9,5,2,106,King Wilki Morskie Szczecin,Sezon 2013/2014
2013-12-21 18:00,AZS Politechnika Poznań(w),74 : 84W,84,19,41,46.3,9,24,37.5,28,65,43.1,19,24,79.2,16,26,42,17,10,25,11,9,3,0,102,King Wilki Morskie Szczecin,Sezon 2013/2014
2014-01-04 17:30,PTG Sokół Łańcut(w),100 : 72P,72,19,35,54.3,6,28,21.4,25,63,39.7,16,24,66.7,12,20,32,10,19,21,18,6,2,6,58,King Wilki Morskie Szczecin,Sezon 2013/2014
2014-01-12 17:30,MOSiR PBS Bank KHS Krosno(d),75 : 69W,75,18,33,54.5,6,24,25.0,24,57,42.1,21,26,80.8,4,29,33,15,18,24,20,9,6,1,80,King Wilki Morskie Szczecin,Sezon 2013/2014
2014-01-18 18:00,Astoria Bydgoszcz(w),78 : 85W,85,18,26,69.2,6,21,28.6,24,47,51.1,31,35,88.6,4,22,26,12,22,28,14,5,5,0,92,King Wilki Morskie Szczecin,Sezon 2013/2014
2014-01-26 17:00,Polfarmex Kutno(d),93 : 95P,93,26,43,60.5,9,27,33.3,35,70,50.0,14,19,73.7,11,21,32,17,24,25,20,7,4,2,93,King Wilki Morskie Szczecin,Sezon 2013/2014
2014-02-01 17:00,Polski Cukier SIDEn Toruń(w),83 : 72P,72,16,42,38.1,10,19,52.6,26,61,42.6,10,13,76.9,11,15,26,12,18,19,14,8,0,1,66,King Wilki Morskie Szczecin,Sezon 2013/2014
2014-02-08 17:00,KS Spójnia Stargard Szczeciński(d),68 : 54W,68,15,37,40.5,8,22,36.4,23,59,39.0,14,19,73.7,11,25,36,14,17,21,13,8,4,1,76,King Wilki Morskie Szczecin,Sezon 2013/2014
2014-02-16 18:00,MKS Wikana Start S.A. Lublin(w),64 : 65W,65,15,33,45.5,4,25,16.0,19,58,32.8,23,27,85.2,6,26,32,11,21,23,9,6,4,1,66,King Wilki Morskie Szczecin,Sezon 2013/2014
2014-02-23 20:00,MCKiS Termo-Rex SA Jaworzno(w),84 : 93W,93,17,28,60.7,12,19,63.2,29,47,61.7,23,26,88.5,6,29,35,18,17,25,21,5,0,2,109,King Wilki Morskie Szczecin,Sezon 2013/2014
2014-03-02 17:00,WKK ProBiotics Wrocław(d),101 : 88W,101,31,55,56.4,8,17,47.1,39,72,54.2,15,18,83.3,16,21,37,21,20,20,13,5,5,1,120,King Wilki Morskie Szczecin,Sezon 2013/2014
2014-03-08 18:00,MKS Dąbrowa Górnicza II(w),74 : 60P,60,15,33,45.5,6,24,25.0,21,57,36.8,12,14,85.7,2,30,32,11,23,16,12,6,0,5,59,King Wilki Morskie Szczecin,Sezon 2013/2014
2014-03-15 16:00,Intermarche Bricomarche BM SlamStal Ostrów(d),72 : 76P,72,21,35,60.0,5,19,26.3,26,54,48.1,15,19,78.9,4,20,24,17,22,20,17,5,1,1,70,King Wilki Morskie Szczecin,Sezon 2013/2014
2014-03-22 18:00,MKS Znicz Basket Pruszków(w),77 : 68P,68,16,33,48.5,7,26,26.9,23,59,39.0,15,16,93.8,5,18,23,14,23,18,16,11,2,2,65,King Wilki Morskie Szczecin,Sezon 2013/2014
2014-03-30 18:00,AZS Politechnika Poznań(d),87 : 50W,87,29,47,61.7,7,22,31.8,36,69,52.2,8,10,80.0,11,33,44,13,16,14,17,14,3,0,109,King Wilki Morskie Szczecin,Sezon 2013/2014
2014-04-05 18:00,MOSiR PBS Bank KHS Krosno(w),84 : 76P,76,15,35,42.9,11,26,42.3,26,61,42.6,13,18,72.2,5,20,25,14,25,24,14,7,4,3,72,King Wilki Morskie Szczecin,Sezon 2013/2014
2014-04-06 18:00,MOSiR PBS Bank KHS Krosno(w),89 : 65P,65,12,24,50.0,7,23,30.4,19,47,40.4,20,25,80.0,6,21,27,12,18,24,19,4,4,2,60,King Wilki Morskie Szczecin,Sezon 2013/2014
2014-04-12 17:00,MOSiR PBS Bank KHS Krosno(d),97 : 74W,97,28,44,63.6,10,21,47.6,38,65,58.5,11,15,73.3,10,30,40,18,29,21,13,7,1,0,119,King Wilki Morskie Szczecin,Sezon 2013/2014
2014-04-13 17:00,MOSiR PBS Bank KHS Krosno(d),74 : 94P,74,18,44,40.9,6,22,27.3,24,66,36.4,20,21,95.2,17,20,37,11,23,24,18,7,1,2,69,King Wilki Morskie Szczecin,Sezon 2013/2014
2013-09-28 17:00,MOSiR PBS Bank KHS Krosno(d),53 : 68P,53,14,38,36.8,4,21,19.0,18,59,30.5,13,21,61.9,7,28,35,10,26,21,11,7,6,4,51,KS Spójnia Stargard Szczeciński,Sezon 2013/2014
2013-10-05 17:00,Astoria Bydgoszcz(w),80 : 68P,68,16,36,44.4,7,28,25.0,23,64,35.9,15,17,88.2,14,17,31,8,20,19,10,6,6,1,66,KS Spójnia Stargard Szczeciński,Sezon 2013/2014
2013-10-12 17:00,Polfarmex Kutno(d),57 : 78P,57,17,36,47.2,4,16,25.0,21,52,40.4,11,24,45.8,7,13,20,10,23,28,17,10,1,1,37,KS Spójnia Stargard Szczeciński,Sezon 2013/2014
2013-10-19 19:00,Polski Cukier SIDEn Toruń(w),79 : 62P,62,11,39,28.2,11,24,45.8,22,63,34.9,7,9,77.8,9,14,23,19,23,20,10,7,3,6,61,KS Spójnia Stargard Szczeciński,Sezon 2013/2014
2013-10-26 17:00,MKS Wikana Start S.A. Lublin(d),52 : 55P,52,11,44,25.0,7,21,33.3,18,65,27.7,9,14,64.3,12,24,36,12,23,11,10,4,1,5,43,KS Spójnia Stargard Szczeciński,Sezon 2013/2014
2013-11-03 17:00,King Wilki Morskie Szczecin(d),53 : 67P,53,15,37,40.5,4,22,18.2,19,59,32.2,11,16,68.8,12,21,33,4,25,22,12,12,1,3,46,KS Spójnia Stargard Szczeciński,Sezon 2013/2014
2013-11-09 20:00,MCKiS Termo-Rex SA Jaworzno(w),62 : 53P,53,13,27,48.1,6,32,18.8,19,59,32.2,9,16,56.3,8,25,33,11,16,22,14,6,0,1,42,KS Spójnia Stargard Szczeciński,Sezon 2013/2014
2013-11-17 17:00,WKK ProBiotics Wrocław(d),53 : 83P,53,17,40,42.5,2,13,15.4,19,53,35.8,13,17,76.5,5,20,25,11,23,23,24,8,3,1,38,KS Spójnia Stargard Szczeciński,Sezon 2013/2014
2013-11-24 18:00,MKS Dąbrowa Górnicza II(w),72 : 65P,65,17,31,54.8,7,26,26.9,24,57,42.1,10,13,76.9,8,28,36,9,25,19,12,5,1,5,68,KS Spójnia Stargard Szczeciński,Sezon 2013/2014
2013-11-30 17:00,Intermarche Bricomarche BM SlamStal Ostrów(d),72 : 59W,72,18,43,41.9,6,13,46.2,24,56,42.9,18,21,85.7,11,26,37,17,23,19,16,7,1,3,83,KS Spójnia Stargard Szczeciński,Sezon 2013/2014
2013-12-08 17:00,MKS Znicz Basket Pruszków(w),80 : 42P,42,13,44,29.5,2,18,11.1,15,62,24.2,10,15,66.7,11,23,34,6,23,18,16,9,5,7,28,KS Spójnia Stargard Szczeciński,Sezon 2013/2014
2013-12-14 17:00,AZS Politechnika Poznań(d),79 : 66W,79,15,29,51.7,10,22,45.5,25,51,49.0,19,25,76.0,8,23,31,20,20,17,16,10,7,3,99,KS Spójnia Stargard Szczeciński,Sezon 2013/2014
2013-12-21 17:30,PTG Sokół Łańcut(w),80 : 58P,58,17,43,39.5,5,15,33.3,22,58,37.9,9,11,81.8,8,19,27,9,19,21,13,5,4,2,52,KS Spójnia Stargard Szczeciński,Sezon 2013/2014
2013-12-23 18:00,MOSiR PBS Bank KHS Krosno(w),67 : 52P,52,11,34,32.4,7,18,38.9,18,52,34.6,9,14,64.3,6,19,25,11,23,21,17,6,5,7,43,KS Spójnia Stargard Szczeciński,Sezon 2013/2014
2014-01-11 17:00,Astoria Bydgoszcz(d),78 : 68W,78,24,41,58.5,7,21,33.3,31,62,50.0,9,11,81.8,14,17,31,20,25,23,16,8,2,1,90,KS Spójnia Stargard Szczeciński,Sezon 2013/2014
2014-01-18 17:30,Polfarmex Kutno(w),90 : 60P,60,16,38,42.1,7,14,50.0,23,52,44.2,7,10,70.0,5,12,17,16,21,18,19,7,3,4,52,KS Spójnia Stargard Szczeciński,Sezon 2013/2014
2014-01-25 17:00,Polski Cukier SIDEn Toruń(d),44 : 64P,44,12,34,35.3,5,23,21.7,17,57,29.8,5,14,35.7,6,20,26,7,17,20,10,8,0,2,26,KS Spójnia Stargard Szczeciński,Sezon 2013/2014
2014-02-02 18:00,MKS Wikana Start S.A. Lublin(w),64 : 53P,53,14,38,36.8,5,20,25.0,19,58,32.8,10,19,52.6,11,26,37,8,21,21,14,3,3,4,42,KS Spójnia Stargard Szczeciński,Sezon 2013/2014
2014-02-08 17:00,King Wilki Morskie Szczecin(w),68 : 54P,54,18,44,40.9,2,15,13.3,20,59,33.9,12,15,80.0,9,22,31,8,21,16,17,6,1,4,41,KS Spójnia Stargard Szczeciński,Sezon 2013/2014
2014-02-15 17:00,MCKiS Termo-Rex SA Jaworzno(d),74 : 61W,74,20,30,66.7,8,19,42.1,28,49,57.1,10,13,76.9,6,26,32,20,14,18,20,8,2,1,92,KS Spójnia Stargard Szczeciński,Sezon 2013/2014
2014-02-22 17:00,WKK ProBiotics Wrocław(w),105 : 61P,61,26,51,51.0,0,11,0.0,26,62,41.9,9,13,69.2,8,18,26,12,20,16,20,8,3,3,50,KS Spójnia Stargard Szczeciński,Sezon 2013/2014
2014-03-02 17:00,MKS Dąbrowa Górnicza II(d),63 : 91P,63,17,45,37.8,8,20,40.0,25,65,38.5,5,6,83.3,10,20,30,13,17,14,13,13,4,2,69,KS Spójnia Stargard Szczeciński,Sezon 2013/2014
2014-03-08 18:30,Intermarche Bricomarche BM SlamStal Ostrów(w),68 : 53P,53,15,37,40.5,4,23,17.4,19,60,31.7,11,14,78.6,8,25,33,7,17,19,15,4,3,3,41,KS Spójnia Stargard Szczeciński,Sezon 2013/2014
2014-03-15 18:30,MKS Znicz Basket Pruszków(d),57 : 54W,57,21,37,56.8,4,23,17.4,25,60,41.7,3,10,30.0,12,18,30,8,18,17,16,9,6,4,52,KS Spójnia Stargard Szczeciński,Sezon 2013/2014
2014-03-22 16:00,AZS Politechnika Poznań(w),69 : 77W,77,21,40,52.5,7,15,46.7,28,55,50.9,14,20,70.0,7,25,32,18,15,17,19,7,3,1,85,KS Spójnia Stargard Szczeciński,Sezon 2013/2014
2014-03-29 16:30,PTG Sokół Łańcut(d),59 : 63P,59,18,49,36.7,6,18,33.3,24,67,35.8,5,8,62.5,10,22,32,10,14,15,12,6,2,3,51,KS Spójnia Stargard Szczeciński,Sezon 2013/2014
2014-04-06 18:00,MCKiS Termo-Rex SA Jaworzno(d),64 : 55W,64,16,30,53.3,9,29,31.0,25,59,42.4,5,9,55.6,10,27,37,14,21,16,15,9,5,2,76,KS Spójnia Stargard Szczeciński,Sezon 2013/2014
2014-04-13 18:00,MCKiS Termo-Rex SA Jaworzno(w),68 : 72W,72,16,26,61.5,8,26,30.8,24,52,46.2,16,21,76.2,6,24,30,15,21,27,18,7,2,1,75,KS Spójnia Stargard Szczeciński,Sezon 2013/2014
2013-09-28 20:00,AZS Politechnika Poznań(d),74 : 60W,74,19,40,47.5,7,18,38.9,26,58,44.8,15,19,78.9,9,27,36,12,17,22,15,15,5,2,91,MCKiS Termo-Rex SA Jaworzno,Sezon 2013/2014
2013-10-05 17:30,PTG Sokół Łańcut(w),90 : 67P,67,18,37,48.6,7,21,33.3,25,58,43.1,10,15,66.7,9,22,31,9,25,18,14,5,0,4,60,MCKiS Termo-Rex SA Jaworzno,Sezon 2013/2014
2013-10-12 20:00,MOSiR PBS Bank KHS Krosno(d),61 : 86P,61,19,37,51.4,4,14,28.6,23,51,45.1,11,14,78.6,5,24,29,11,17,18,20,5,3,2,58,MCKiS Termo-Rex SA Jaworzno,Sezon 2013/2014
2013-10-20 18:00,Astoria Bydgoszcz(w),79 : 74P,74,27,47,57.4,4,15,26.7,31,62,50.0,8,17,47.1,7,25,32,15,22,22,15,11,1,2,78,MCKiS Termo-Rex SA Jaworzno,Sezon 2013/2014
2013-10-27 20:00,Polfarmex Kutno(d),65 : 70P,65,17,37,45.9,5,16,31.3,22,53,41.5,16,23,69.6,12,19,31,10,19,24,20,8,1,3,57,MCKiS Termo-Rex SA Jaworzno,Sezon 2013/2014
2013-11-02 18:00,Polski Cukier SIDEn Toruń(w),99 : 54P,54,10,33,30.3,7,18,38.9,17,51,33.3,13,18,72.2,8,17,25,10,23,19,21,3,2,5,34,MCKiS Termo-Rex SA Jaworzno,Sezon 2013/2014
2013-11-09 20:00,KS Spójnia Stargard Szczeciński(d),62 : 53W,62,15,34,44.1,9,23,39.1,24,57,42.1,5,7,71.4,7,30,37,14,22,16,12,11,1,0,78,MCKiS Termo-Rex SA Jaworzno,Sezon 2013/2014
2013-11-16 18:00,King Wilki Morskie Szczecin(w),75 : 52P,52,17,41,41.5,4,18,22.2,21,59,35.6,6,9,66.7,9,23,32,10,12,12,17,9,2,6,47,MCKiS Termo-Rex SA Jaworzno,Sezon 2013/2014
2013-11-23 18:00,MKS Wikana Start S.A. Lublin(w),76 : 55P,55,17,33,51.5,4,23,17.4,21,56,37.5,9,13,69.2,6,20,26,8,10,16,13,7,3,1,47,MCKiS Termo-Rex SA Jaworzno,Sezon 2013/2014
2013-12-01 20:00,WKK ProBiotics Wrocław(d),64 : 84P,64,21,42,50.0,2,13,15.4,23,55,41.8,16,20,80.0,8,23,31,5,14,20,23,7,2,4,50,MCKiS Termo-Rex SA Jaworzno,Sezon 2013/2014
2013-12-07 18:00,MKS Dąbrowa Górnicza II(w),76 : 55P,55,14,36,38.9,5,20,25.0,19,56,33.9,12,18,66.7,13,26,39,11,20,21,21,8,3,3,52,MCKiS Termo-Rex SA Jaworzno,Sezon 2013/2014
2013-12-14 20:00,Intermarche Bricomarche BM SlamStal Ostrów(d),72 : 82P,72,15,36,41.7,12,21,57.1,27,57,47.4,6,9,66.7,2,20,22,13,28,15,13,6,1,2,68,MCKiS Termo-Rex SA Jaworzno,Sezon 2013/2014
2013-12-21 18:00,MKS Znicz Basket Pruszków(w),66 : 76W,76,23,40,57.5,7,22,31.8,30,62,48.4,9,14,64.3,12,24,36,14,23,20,17,11,1,4,84,MCKiS Termo-Rex SA Jaworzno,Sezon 2013/2014
2014-01-04 18:00,AZS Politechnika Poznań(w),73 : 60P,60,19,41,46.3,5,24,20.8,24,65,36.9,7,11,63.6,12,22,34,9,23,17,21,13,0,2,50,MCKiS Termo-Rex SA Jaworzno,Sezon 2013/2014
2014-01-10 20:00,PTG Sokół Łańcut(d),66 : 67P,66,22,42,52.4,5,19,26.3,27,61,44.3,7,9,77.8,6,23,29,12,15,16,10,8,1,1,70,MCKiS Termo-Rex SA Jaworzno,Sezon 2013/2014
2014-01-19 17:00,MOSiR PBS Bank KHS Krosno(w),77 : 58P,58,18,41,43.9,4,18,22.2,22,59,37.3,10,12,83.3,6,16,22,10,27,18,19,13,1,2,46,MCKiS Termo-Rex SA Jaworzno,Sezon 2013/2014
2014-01-26 18:00,Astoria Bydgoszcz(d),73 : 71W,73,28,49,57.1,3,13,23.1,31,62,50.0,8,11,72.7,10,14,24,12,22,20,11,15,2,0,81,MCKiS Termo-Rex SA Jaworzno,Sezon 2013/2014
2014-02-01 17:30,Polfarmex Kutno(w),113 : 79P,79,21,47,44.7,9,18,50.0,30,65,46.2,10,12,83.3,12,12,24,14,19,14,15,4,2,5,71,MCKiS Termo-Rex SA Jaworzno,Sezon 2013/2014
2014-02-08 20:00,Polski Cukier SIDEn Toruń(d),68 : 77P,68,13,31,41.9,10,20,50.0,23,51,45.1,12,14,85.7,9,17,26,11,26,16,20,8,1,2,64,MCKiS Termo-Rex SA Jaworzno,Sezon 2013/2014
2014-02-15 17:00,KS Spójnia Stargard Szczeciński(w),74 : 61P,61,18,47,38.3,6,20,30.0,24,67,35.8,7,10,70.0,13,16,29,14,18,14,13,8,1,2,54,MCKiS Termo-Rex SA Jaworzno,Sezon 2013/2014
2014-02-23 20:00,King Wilki Morskie Szczecin(d),84 : 93P,84,28,47,59.6,6,23,26.1,34,70,48.6,10,18,55.6,8,11,19,14,25,17,8,14,2,0,81,MCKiS Termo-Rex SA Jaworzno,Sezon 2013/2014
2014-03-01 20:00,MKS Wikana Start S.A. Lublin(d),78 : 92P,78,19,43,44.2,10,28,35.7,29,71,40.8,10,15,66.7,13,19,32,16,30,20,16,12,3,3,78,MCKiS Termo-Rex SA Jaworzno,Sezon 2013/2014
2014-03-08 16:00,WKK ProBiotics Wrocław(w),92 : 60P,60,21,49,42.9,3,9,33.3,24,58,41.4,9,11,81.8,8,18,26,10,21,22,25,8,2,1,45,MCKiS Termo-Rex SA Jaworzno,Sezon 2013/2014
2014-03-15 20:00,MKS Dąbrowa Górnicza II(d),72 : 88P,72,19,42,45.2,7,23,30.4,26,65,40.0,13,14,92.9,8,22,30,13,16,15,13,7,0,0,69,MCKiS Termo-Rex SA Jaworzno,Sezon 2013/2014
2014-03-22 18:30,Intermarche Bricomarche BM SlamStal Ostrów(w),71 : 68P,68,14,28,50.0,12,27,44.4,26,55,47.3,4,8,50.0,5,14,19,11,25,14,16,9,3,2,61,MCKiS Termo-Rex SA Jaworzno,Sezon 2013/2014
2014-03-30 18:00,MKS Znicz Basket Pruszków(d),70 : 72P,70,14,27,51.9,12,38,31.6,26,65,40.0,6,11,54.5,10,18,28,18,16,15,11,7,2,1,70,MCKiS Termo-Rex SA Jaworzno,Sezon 2013/2014
2014-04-06 18:00,KS Spójnia Stargard Szczeciński(w),64 : 55P,55,13,32,40.6,8,20,40.0,21,52,40.4,5,16,31.3,5,22,27,14,16,21,15,9,2,5,50,MCKiS Termo-Rex SA Jaworzno,Sezon 2013/2014
2014-04-13 18:00,KS Spójnia Stargard Szczeciński(d),68 : 72P,68,19,43,44.2,6,19,31.6,25,62,40.3,12,22,54.5,8,22,30,9,28,21,13,10,1,2,58,MCKiS Termo-Rex SA Jaworzno,Sezon 2013/2014
2014-04-26 18:00,MKS Znicz Basket Pruszków(w),64 : 75W,75,14,29,48.3,9,27,33.3,23,56,41.1,20,26,76.9,3,31,34,12,19,24,17,8,4,1,77,MCKiS Termo-Rex SA Jaworzno,Sezon 2013/2014
2014-04-27 18:00,MKS Znicz Basket Pruszków(w),77 : 61P,61,12,25,48.0,12,33,36.4,24,58,41.4,1,8,12.5,7,13,20,15,17,19,18,10,1,3,48,MCKiS Termo-Rex SA Jaworzno,Sezon 2013/2014
2014-05-03 20:00,MKS Znicz Basket Pruszków(d),71 : 72P,71,23,41,56.1,6,27,22.2,29,68,42.6,7,14,50.0,13,27,40,12,28,17,14,6,1,2,70,MCKiS Termo-Rex SA Jaworzno,Sezon 2013/2014
2014-05-04 20:00,MKS Znicz Basket Pruszków(d),50 : 63P,50,10,26,38.5,7,28,25.0,17,54,31.5,9,16,56.3,7,19,26,12,15,18,14,12,0,3,42,MCKiS Termo-Rex SA Jaworzno,Sezon 2013/2014
2013-09-28 17:30,Polfarmex Kutno(w),75 : 68P,68,25,43,58.1,2,13,15.4,27,56,48.2,12,20,60.0,3,23,26,8,20,25,9,4,2,1,62,MKS Wikana Start S.A. Lublin,Sezon 2013/2014
2013-10-06 17:30,Intermarche Bricomarche BM SlamStal Ostrów(d),79 : 78W,79,24,45,53.3,5,18,27.8,29,63,46.0,16,24,66.7,13,22,35,13,19,22,13,6,0,0,78,MKS Wikana Start S.A. Lublin,Sezon 2013/2014
2013-10-12 18:00,Polski Cukier SIDEn Toruń(w),57 : 51P,51,14,37,37.8,4,29,13.8,18,66,27.3,11,14,78.6,11,21,32,8,21,18,11,8,2,7,39,MKS Wikana Start S.A. Lublin,Sezon 2013/2014
2013-10-19 18:00,MKS Znicz Basket Pruszków(d),76 : 55W,76,27,45,60.0,4,18,22.2,31,63,49.2,10,21,47.6,8,34,42,21,20,22,12,5,4,5,93,MKS Wikana Start S.A. Lublin,Sezon 2013/2014
2013-10-26 17:00,KS Spójnia Stargard Szczeciński(w),52 : 55W,55,15,39,38.5,4,17,23.5,19,56,33.9,13,17,76.5,7,29,36,10,11,23,9,5,5,1,61,MKS Wikana Start S.A. Lublin,Sezon 2013/2014
2013-11-02 18:00,AZS Politechnika Poznań(d),72 : 64W,72,21,43,48.8,6,17,35.3,27,60,45.0,12,20,60.0,8,24,32,19,12,19,15,6,2,4,75,MKS Wikana Start S.A. Lublin,Sezon 2013/2014
2013-11-09 18:00,King Wilki Morskie Szczecin(w),86 : 78P,78,15,45,33.3,11,23,47.8,26,68,38.2,15,22,68.2,11,23,34,17,22,22,15,8,2,5,75,MKS Wikana Start S.A. Lublin,Sezon 2013/2014
2013-11-16 18:00,PTG Sokół Łańcut(d),52 : 69P,52,14,39,35.9,4,17,23.5,18,56,32.1,12,21,57.1,11,26,37,9,18,17,19,7,0,1,39,MKS Wikana Start S.A. Lublin,Sezon 2013/2014
2013-11-23 18:00,MCKiS Termo-Rex SA Jaworzno(d),76 : 55W,76,20,39,51.3,10,26,38.5,30,65,46.2,6,10,60.0,14,22,36,22,16,10,8,7,1,3,95,MKS Wikana Start S.A. Lublin,Sezon 2013/2014
2013-11-30 18:00,MOSiR PBS Bank KHS Krosno(d),62 : 65P,62,21,48,43.8,3,19,15.8,24,67,35.8,11,18,61.1,13,29,42,16,17,19,12,6,4,3,68,MKS Wikana Start S.A. Lublin,Sezon 2013/2014
2013-12-07 17:00,WKK ProBiotics Wrocław(w),69 : 70W,70,15,33,45.5,5,21,23.8,20,54,37.0,25,36,69.4,10,26,36,9,21,27,7,3,0,2,66,MKS Wikana Start S.A. Lublin,Sezon 2013/2014
2013-12-14 18:00,Astoria Bydgoszcz(d),70 : 54W,70,21,37,56.8,7,19,36.8,28,56,50.0,7,12,58.3,7,23,30,19,20,21,13,8,3,5,84,MKS Wikana Start S.A. Lublin,Sezon 2013/2014
2013-12-21 18:00,MKS Dąbrowa Górnicza II(w),82 : 75P,75,21,42,50.0,7,21,33.3,28,63,44.4,12,15,80.0,10,27,37,12,18,22,14,4,3,5,79,MKS Wikana Start S.A. Lublin,Sezon 2013/2014
2014-01-05 18:00,Polfarmex Kutno(d),79 : 56W,79,15,40,37.5,8,13,61.5,23,53,43.4,25,36,69.4,9,34,43,15,20,30,20,6,2,1,84,MKS Wikana Start S.A. Lublin,Sezon 2013/2014
2014-01-11 18:30,Intermarche Bricomarche BM SlamStal Ostrów(w),92 : 97W,97,25,42,59.5,9,20,45.0,34,62,54.8,20,29,69.0,11,20,31,18,24,26,14,11,1,0,107,MKS Wikana Start S.A. Lublin,Sezon 2013/2014
2014-01-18 18:00,Polski Cukier SIDEn Toruń(d),87 : 94P,87,16,38,42.1,13,24,54.2,29,62,46.8,16,26,61.5,5,17,22,15,21,25,16,13,1,2,79,MKS Wikana Start S.A. Lublin,Sezon 2013/2014
2014-01-26 17:00,MKS Znicz Basket Pruszków(w),51 : 58W,58,12,34,35.3,5,21,23.8,17,55,30.9,19,32,59.4,10,35,45,8,20,25,15,5,1,0,51,MKS Wikana Start S.A. Lublin,Sezon 2013/2014
2014-02-02 18:00,KS Spójnia Stargard Szczeciński(d),64 : 53W,64,12,36,33.3,9,17,52.9,21,53,39.6,13,20,65.0,7,25,32,16,21,21,15,6,4,3,68,MKS Wikana Start S.A. Lublin,Sezon 2013/2014
2014-02-08 20:00,AZS Politechnika Poznań(w),75 : 87W,87,18,36,50.0,11,23,47.8,29,59,49.2,18,27,66.7,10,24,34,19,16,27,11,11,3,5,104,MKS Wikana Start S.A. Lublin,Sezon 2013/2014
2014-02-16 18:00,King Wilki Morskie Szczecin(d),64 : 65P,64,21,45,46.7,3,19,15.8,24,64,37.5,13,23,56.5,11,25,36,13,23,20,13,7,1,4,58,MKS Wikana Start S.A. Lublin,Sezon 2013/2014
2014-02-24 18:00,PTG Sokół Łańcut(w),71 : 77W,77,20,36,55.6,6,25,24.0,26,61,42.6,19,27,70.4,8,28,36,10,23,25,8,5,0,0,77,MKS Wikana Start S.A. Lublin,Sezon 2013/2014
2014-03-01 20:00,MCKiS Termo-Rex SA Jaworzno(w),78 : 92W,92,21,34,61.8,8,23,34.8,29,57,50.9,26,39,66.7,11,27,38,20,20,29,16,12,3,3,108,MKS Wikana Start S.A. Lublin,Sezon 2013/2014
2014-03-08 18:00,MOSiR PBS Bank KHS Krosno(w),101 : 85P,85,17,38,44.7,11,27,40.7,28,65,43.1,18,23,78.3,7,21,28,21,18,22,11,3,2,3,86,MKS Wikana Start S.A. Lublin,Sezon 2013/2014
2014-03-16 18:00,WKK ProBiotics Wrocław(d),72 : 73P,72,22,50,44.0,5,19,26.3,27,69,39.1,13,18,72.2,11,25,36,11,23,22,13,8,2,2,69,MKS Wikana Start S.A. Lublin,Sezon 2013/2014
2014-03-22 18:00,Astoria Bydgoszcz(w),61 : 65W,65,14,26,53.8,6,22,27.3,20,48,41.7,19,29,65.5,5,34,39,13,17,24,16,6,2,3,71,MKS Wikana Start S.A. Lublin,Sezon 2013/2014
2014-03-30 18:00,MKS Dąbrowa Górnicza II(d),86 : 89P,86,27,44,61.4,5,18,27.8,32,62,51.6,17,30,56.7,8,30,38,13,25,25,17,11,4,1,92,MKS Wikana Start S.A. Lublin,Sezon 2013/2014
2014-04-05 17:45,Polski Cukier SIDEn Toruń(w),78 : 80W,80,20,38,52.6,7,26,26.9,27,64,42.2,19,30,63.3,6,30,36,17,24,22,18,5,5,1,77,MKS Wikana Start S.A. Lublin,Sezon 2013/2014
2014-04-06 20:00,Polski Cukier SIDEn Toruń(w),67 : 79W,79,12,30,40.0,16,32,50.0,28,62,45.2,7,13,53.8,6,23,29,17,24,20,8,5,2,3,84,MKS Wikana Start S.A. Lublin,Sezon 2013/2014
2014-04-12 18:00,Polski Cukier SIDEn Toruń(d),67 : 63W,67,12,29,41.4,8,22,36.4,20,51,39.2,19,30,63.3,6,25,31,14,19,25,11,9,2,2,70,MKS Wikana Start S.A. Lublin,Sezon 2013/2014
2014-04-26 18:00,WKK ProBiotics Wrocław(w),66 : 60P,60,14,38,36.8,6,20,30.0,20,58,34.5,14,20,70.0,4,30,34,12,26,22,17,8,2,2,55,MKS Wikana Start S.A. Lublin,Sezon 2013/2014
2014-04-27 18:00,WKK ProBiotics Wrocław(w),63 : 69W,69,18,46,39.1,6,16,37.5,24,62,38.7,15,24,62.5,9,29,38,8,20,25,12,8,3,6,67,MKS Wikana Start S.A. Lublin,Sezon 2013/2014
2014-05-03 18:00,WKK ProBiotics Wrocław(d),51 : 70P,51,16,43,37.2,4,16,25.0,20,59,33.9,7,10,70.0,6,20,26,10,17,18,12,9,5,3,47,MKS Wikana Start S.A. Lublin,Sezon 2013/2014
2014-05-04 18:00,WKK ProBiotics Wrocław(d),88 : 60W,88,29,53,54.7,5,17,29.4,34,70,48.6,15,19,78.9,13,31,44,12,18,16,9,4,4,4,103,MKS Wikana Start S.A. Lublin,Sezon 2013/2014
2014-05-07 18:00,WKK ProBiotics Wrocław(w),78 : 61P,61,16,33,48.5,5,14,35.7,21,47,44.7,14,20,70.0,3,17,20,9,20,21,19,7,4,4,50,MKS Wikana Start S.A. Lublin,Sezon 2013/2014
2014-05-11 18:45,MOSiR PBS Bank KHS Krosno(d),65 : 79P,65,19,46,41.3,7,24,29.2,26,70,37.1,6,10,60.0,10,22,32,12,13,19,16,7,3,7,55,MKS Wikana Start S.A. Lublin,Sezon 2013/2014
2014-05-17 17:00,MOSiR PBS Bank KHS Krosno(w),100 : 70P,70,11,34,32.4,8,29,27.6,19,63,30.2,24,32,75.0,9,30,39,15,15,27,16,2,3,3,61,MKS Wikana Start S.A. Lublin,Sezon 2013/2014
2013-09-28 18:00,WKK ProBiotics Wrocław(w),79 : 68P,68,19,37,51.4,5,13,38.5,24,50,48.0,15,20,75.0,5,20,25,7,24,23,25,12,2,5,58,MKS Znicz Basket Pruszków,Sezon 2013/2014
2013-10-05 18:00,MKS Dąbrowa Górnicza II(d),78 : 68W,78,21,43,48.8,7,23,30.4,28,66,42.4,15,24,62.5,15,26,41,17,24,26,11,4,3,3,85,MKS Znicz Basket Pruszków,Sezon 2013/2014
2013-10-12 18:30,Intermarche Bricomarche BM SlamStal Ostrów(w),78 : 64P,64,19,46,41.3,7,19,36.8,26,65,40.0,5,14,35.7,7,23,30,15,22,19,11,7,3,2,60,MKS Znicz Basket Pruszków,Sezon 2013/2014
2013-10-19 18:00,MKS Wikana Start S.A. Lublin(w),76 : 55P,55,11,35,31.4,7,27,25.9,18,62,29.0,12,21,57.1,7,25,32,12,22,20,11,8,5,4,48,MKS Znicz Basket Pruszków,Sezon 2013/2014
2013-10-26 18:00,AZS Politechnika Poznań(d),76 : 64W,76,16,32,50.0,10,25,40.0,26,57,45.6,14,24,58.3,11,22,33,16,9,26,16,10,5,5,83,MKS Znicz Basket Pruszków,Sezon 2013/2014
2013-11-02 17:30,PTG Sokół Łańcut(w),76 : 72P,72,25,41,61.0,3,20,15.0,28,61,45.9,13,16,81.3,9,24,33,11,20,19,14,4,0,2,70,MKS Znicz Basket Pruszków,Sezon 2013/2014
2013-11-10 17:00,MOSiR PBS Bank KHS Krosno(d),60 : 74P,60,17,34,50.0,6,23,26.1,23,57,40.4,8,15,53.3,10,18,28,11,16,18,19,8,6,2,53,MKS Znicz Basket Pruszków,Sezon 2013/2014
2013-11-17 17:00,Astoria Bydgoszcz(d),59 : 85P,59,18,39,46.2,5,21,23.8,23,60,38.3,8,9,88.9,6,18,24,9,22,19,15,5,6,0,50,MKS Znicz Basket Pruszków,Sezon 2013/2014
2013-11-24 17:00,Polfarmex Kutno(d),88 : 80W,88,17,27,63.0,8,24,33.3,25,51,49.0,30,43,69.8,8,28,36,19,15,33,21,9,3,2,95,MKS Znicz Basket Pruszków,Sezon 2013/2014
2013-12-01 17:00,Polski Cukier SIDEn Toruń(w),90 : 51P,51,13,37,35.1,5,28,17.9,18,65,27.7,10,11,90.9,10,21,31,13,23,14,19,3,3,1,34,MKS Znicz Basket Pruszków,Sezon 2013/2014
2013-12-08 17:00,KS Spójnia Stargard Szczeciński(d),80 : 42W,80,13,28,46.4,12,30,40.0,25,58,43.1,18,24,75.0,9,37,46,16,18,23,17,9,7,5,102,MKS Znicz Basket Pruszków,Sezon 2013/2014
2013-12-15 19:00,King Wilki Morskie Szczecin(w),82 : 62P,62,15,36,41.7,7,30,23.3,22,66,33.3,11,18,61.1,5,21,26,8,15,22,16,7,2,5,38,MKS Znicz Basket Pruszków,Sezon 2013/2014
2013-12-21 18:00,MCKiS Termo-Rex SA Jaworzno(d),66 : 76P,66,12,26,46.2,9,26,34.6,21,52,40.4,15,25,60.0,8,21,29,15,20,23,18,7,4,1,62,MKS Znicz Basket Pruszków,Sezon 2013/2014
2014-01-05 17:00,WKK ProBiotics Wrocław(d),52 : 65P,52,17,36,47.2,2,13,15.4,19,49,38.8,12,21,57.1,6,22,28,10,15,21,19,9,3,0,44,MKS Znicz Basket Pruszków,Sezon 2013/2014
2014-01-12 18:00,MKS Dąbrowa Górnicza II(w),90 : 75P,75,21,58,36.2,6,18,33.3,27,76,35.5,15,17,88.2,17,23,40,11,29,17,17,9,3,13,70,MKS Znicz Basket Pruszków,Sezon 2013/2014
2014-01-19 17:00,Intermarche Bricomarche BM SlamStal Ostrów(d),46 : 68P,46,13,35,37.1,3,17,17.6,16,52,30.8,11,18,61.1,7,28,35,8,21,20,21,3,3,2,31,MKS Znicz Basket Pruszków,Sezon 2013/2014
2014-01-26 17:00,MKS Wikana Start S.A. Lublin(d),51 : 58P,51,13,32,40.6,4,31,12.9,17,63,27.0,13,22,59.1,10,32,42,8,25,20,14,8,0,1,40,MKS Znicz Basket Pruszków,Sezon 2013/2014
2014-02-01 18:00,AZS Politechnika Poznań(w),64 : 61P,61,16,37,43.2,5,22,22.7,21,59,35.6,14,22,63.6,14,27,41,12,21,21,22,8,2,4,56,MKS Znicz Basket Pruszków,Sezon 2013/2014
2014-02-09 17:00,PTG Sokół Łańcut(d),64 : 89P,64,18,38,47.4,6,21,28.6,24,59,40.7,10,19,52.6,10,19,29,15,17,21,17,10,2,6,59,MKS Znicz Basket Pruszków,Sezon 2013/2014
2014-02-16 18:00,MOSiR PBS Bank KHS Krosno(w),77 : 47P,47,13,29,44.8,3,21,14.3,16,50,32.0,12,22,54.5,5,22,27,10,17,22,15,11,1,1,37,MKS Znicz Basket Pruszków,Sezon 2013/2014
2014-02-22 17:00,Astoria Bydgoszcz(w),62 : 70W,70,18,44,40.9,6,12,50.0,24,56,42.9,16,24,66.7,12,24,36,12,16,24,20,8,3,3,69,MKS Znicz Basket Pruszków,Sezon 2013/2014
2014-02-28 18:30,Polfarmex Kutno(w),76 : 70P,70,18,37,48.6,7,18,38.9,25,55,45.5,13,21,61.9,7,28,35,15,21,20,17,3,3,2,71,MKS Znicz Basket Pruszków,Sezon 2013/2014
2014-03-08 18:00,Polski Cukier SIDEn Toruń(d),63 : 72P,63,16,39,41.0,9,18,50.0,25,57,43.9,4,7,57.1,8,20,28,13,16,14,18,5,2,1,58,MKS Znicz Basket Pruszków,Sezon 2013/2014
2014-03-15 18:30,KS Spójnia Stargard Szczeciński(w),57 : 54P,54,18,42,42.9,2,19,10.5,20,61,32.8,12,17,70.6,23,23,46,13,17,18,20,9,4,6,60,MKS Znicz Basket Pruszków,Sezon 2013/2014
2014-03-22 18:00,King Wilki Morskie Szczecin(d),77 : 68W,77,23,48,47.9,5,16,31.3,28,64,43.8,16,26,61.5,12,27,39,16,18,22,17,9,2,2,80,MKS Znicz Basket Pruszków,Sezon 2013/2014
2014-03-30 18:00,MCKiS Termo-Rex SA Jaworzno(w),70 : 72W,72,23,43,53.5,6,20,30.0,29,63,46.0,8,9,88.9,13,25,38,14,15,16,19,7,1,2,78,MKS Znicz Basket Pruszków,Sezon 2013/2014
2014-04-05 20:00,AZS Politechnika Poznań(d),67 : 87P,67,13,33,39.4,6,22,27.3,19,55,34.5,23,36,63.9,15,16,31,15,12,24,16,5,4,2,57,MKS Znicz Basket Pruszków,Sezon 2013/2014
2014-04-12 18:00,AZS Politechnika Poznań(w),72 : 62P,62,16,36,44.4,3,19,15.8,19,55,34.5,21,31,67.7,15,23,38,11,26,28,19,3,2,2,51,MKS Znicz Basket Pruszków,Sezon 2013/2014
2014-04-26 18:00,MCKiS Termo-Rex SA Jaworzno(d),64 : 75P,64,12,35,34.3,10,33,30.3,22,68,32.4,10,11,90.9,9,30,39,16,24,19,16,10,1,4,67,MKS Znicz Basket Pruszków,Sezon 2013/2014
2014-04-27 18:00,MCKiS Termo-Rex SA Jaworzno(d),77 : 61W,77,18,28,64.3,11,27,40.7,29,55,52.7,8,15,53.3,8,26,34,18,19,17,21,8,3,1,86,MKS Znicz Basket Pruszków,Sezon 2013/2014
2014-05-03 20:00,MCKiS Termo-Rex SA Jaworzno(w),71 : 72W,72,16,35,45.7,7,30,23.3,23,65,35.4,19,26,73.1,10,23,33,15,17,28,11,8,2,1,70,MKS Znicz Basket Pruszków,Sezon 2013/2014
2014-05-04 20:00,MCKiS Termo-Rex SA Jaworzno(w),50 : 63W,63,14,33,42.4,8,26,30.8,22,59,37.3,11,13,84.6,13,24,37,13,18,15,17,9,3,0,69,MKS Znicz Basket Pruszków,Sezon 2013/2014
2013-09-28 17:00,KS Spójnia Stargard Szczeciński(w),53 : 68W,68,18,34,52.9,6,24,25.0,24,58,41.4,14,23,60.9,5,24,29,10,21,26,10,5,4,6,63,MOSiR PBS Bank KHS Krosno,Sezon 2013/2014
2013-10-05 18:00,King Wilki Morskie Szczecin(d),89 : 81W,89,20,43,46.5,10,27,37.0,30,70,42.9,19,31,61.3,13,21,34,19,24,25,9,12,2,0,95,MOSiR PBS Bank KHS Krosno,Sezon 2013/2014
2013-10-12 20:00,MCKiS Termo-Rex SA Jaworzno(w),61 : 86W,86,23,52,44.2,10,28,35.7,33,80,41.3,10,13,76.9,17,17,34,16,18,17,8,14,2,3,94,MOSiR PBS Bank KHS Krosno,Sezon 2013/2014
2013-10-20 18:00,WKK ProBiotics Wrocław(d),72 : 59W,72,27,53,50.9,2,18,11.1,29,71,40.8,12,15,80.0,11,28,39,14,19,18,13,12,3,4,82,MOSiR PBS Bank KHS Krosno,Sezon 2013/2014
2013-10-26 18:00,MKS Dąbrowa Górnicza II(w),80 : 93W,93,24,44,54.5,8,24,33.3,32,68,47.1,21,26,80.8,9,26,35,13,24,22,12,6,3,3,97,MOSiR PBS Bank KHS Krosno,Sezon 2013/2014
2013-11-02 18:00,Intermarche Bricomarche BM SlamStal Ostrów(d),73 : 64W,73,22,39,56.4,5,22,22.7,27,61,44.3,14,16,87.5,7,20,27,14,19,21,9,7,4,0,80,MOSiR PBS Bank KHS Krosno,Sezon 2013/2014
2013-11-10 17:00,MKS Znicz Basket Pruszków(w),60 : 74W,74,22,40,55.0,5,24,20.8,27,64,42.2,15,18,83.3,15,23,38,14,18,16,15,12,2,6,85,MOSiR PBS Bank KHS Krosno,Sezon 2013/2014
2013-11-16 16:00,AZS Politechnika Poznań(w),49 : 66W,66,20,33,60.6,4,21,19.0,24,54,44.4,14,24,58.3,10,25,35,15,14,19,15,7,1,2,69,MOSiR PBS Bank KHS Krosno,Sezon 2013/2014
2013-11-23 17:30,PTG Sokół Łańcut(w),49 : 54W,54,13,28,46.4,7,19,36.8,20,47,42.6,7,7,100.0,6,21,27,9,19,14,16,11,3,3,61,MOSiR PBS Bank KHS Krosno,Sezon 2013/2014
2013-11-30 18:00,MKS Wikana Start S.A. Lublin(w),62 : 65W,65,15,40,37.5,8,29,27.6,23,69,33.3,11,19,57.9,15,29,44,11,19,17,12,7,3,4,64,MOSiR PBS Bank KHS Krosno,Sezon 2013/2014
2013-12-07 18:00,Astoria Bydgoszcz(d),96 : 72W,96,33,50,66.0,4,20,20.0,37,70,52.9,18,22,81.8,14,25,39,16,19,22,14,10,7,1,117,MOSiR PBS Bank KHS Krosno,Sezon 2013/2014
2013-12-14 17:30,Polfarmex Kutno(w),75 : 66P,66,21,37,56.8,5,16,31.3,26,53,49.1,9,14,64.3,2,18,20,14,21,15,13,8,2,1,65,MOSiR PBS Bank KHS Krosno,Sezon 2013/2014
2013-12-21 18:00,Polski Cukier SIDEn Toruń(d),61 : 65P,61,17,38,44.7,8,31,25.8,25,69,36.2,3,6,50.0,12,20,32,14,19,17,9,5,2,1,58,MOSiR PBS Bank KHS Krosno,Sezon 2013/2014
2013-12-23 18:00,KS Spójnia Stargard Szczeciński(d),67 : 52W,67,19,31,61.3,5,22,22.7,24,53,45.3,14,25,56.0,7,28,35,16,21,22,17,7,7,5,75,MOSiR PBS Bank KHS Krosno,Sezon 2013/2014
2014-01-12 17:30,King Wilki Morskie Szczecin(w),75 : 69P,69,23,50,46.0,3,26,11.5,26,76,34.2,14,14,100.0,13,24,37,14,24,18,15,9,1,6,65,MOSiR PBS Bank KHS Krosno,Sezon 2013/2014
2014-01-19 17:00,MCKiS Termo-Rex SA Jaworzno(d),77 : 58W,77,16,32,50.0,9,21,42.9,25,53,47.2,18,25,72.0,8,31,39,17,18,27,18,9,2,1,91,MOSiR PBS Bank KHS Krosno,Sezon 2013/2014
2014-01-25 17:00,WKK ProBiotics Wrocław(w),71 : 61P,61,15,35,42.9,5,16,31.3,20,51,39.2,16,23,69.6,5,24,29,11,18,24,16,10,1,5,58,MOSiR PBS Bank KHS Krosno,Sezon 2013/2014
2014-02-01 18:00,MKS Dąbrowa Górnicza II(d),95 : 52W,95,20,32,62.5,18,37,48.6,38,69,55.1,1,3,33.3,5,35,40,25,22,14,12,13,6,2,134,MOSiR PBS Bank KHS Krosno,Sezon 2013/2014
2014-02-08 18:30,Intermarche Bricomarche BM SlamStal Ostrów(w),86 : 74P,74,18,35,51.4,10,38,26.3,28,73,38.4,8,10,80.0,13,24,37,9,23,13,15,5,3,3,66,MOSiR PBS Bank KHS Krosno,Sezon 2013/2014
2014-02-16 18:00,MKS Znicz Basket Pruszków(d),77 : 47W,77,15,31,48.4,12,31,38.7,27,62,43.5,11,16,68.8,11,27,38,24,22,17,13,6,1,1,93,MOSiR PBS Bank KHS Krosno,Sezon 2013/2014
2014-02-22 18:00,AZS Politechnika Poznań(d),90 : 70W,90,27,35,77.1,8,25,32.0,35,60,58.3,12,16,75.0,7,21,28,23,15,20,11,10,3,1,114,MOSiR PBS Bank KHS Krosno,Sezon 2013/2014
2014-03-02 18:00,PTG Sokół Łańcut(d),67 : 56W,67,20,36,55.6,5,24,20.8,25,60,41.7,12,15,80.0,10,23,33,19,21,17,12,7,3,1,79,MOSiR PBS Bank KHS Krosno,Sezon 2013/2014
2014-03-08 18:00,MKS Wikana Start S.A. Lublin(d),101 : 85W,101,22,35,62.9,14,31,45.2,36,66,54.5,15,18,83.3,6,28,34,29,22,17,11,8,3,2,131,MOSiR PBS Bank KHS Krosno,Sezon 2013/2014
2014-03-15 18:00,Astoria Bydgoszcz(w),63 : 82W,82,28,43,65.1,6,16,37.5,34,59,57.6,8,14,57.1,7,21,28,20,11,17,8,10,3,0,104,MOSiR PBS Bank KHS Krosno,Sezon 2013/2014
2014-03-23 18:00,Polfarmex Kutno(d),74 : 60W,74,20,33,60.6,7,22,31.8,27,55,49.1,13,14,92.9,6,26,32,17,17,20,11,3,2,0,88,MOSiR PBS Bank KHS Krosno,Sezon 2013/2014
2014-03-30 18:00,Polski Cukier SIDEn Toruń(w),70 : 58P,58,15,39,38.5,8,25,32.0,23,64,35.9,4,9,44.4,7,20,27,14,16,14,12,9,4,6,54,MOSiR PBS Bank KHS Krosno,Sezon 2013/2014
2014-04-05 18:00,King Wilki Morskie Szczecin(d),84 : 76W,84,22,41,53.7,6,23,26.1,28,64,43.8,22,28,78.6,7,27,34,18,24,25,12,9,3,4,94,MOSiR PBS Bank KHS Krosno,Sezon 2013/2014
2014-04-06 18:00,King Wilki Morskie Szczecin(d),89 : 65W,89,23,40,57.5,11,28,39.3,34,68,50.0,10,10,100.0,11,16,27,22,24,18,10,9,2,4,105,MOSiR PBS Bank KHS Krosno,Sezon 2013/2014
2014-04-12 17:00,King Wilki Morskie Szczecin(w),97 : 74P,74,17,41,41.5,6,21,28.6,23,62,37.1,22,32,68.8,11,15,26,11,21,27,12,9,0,1,59,MOSiR PBS Bank KHS Krosno,Sezon 2013/2014
2014-04-13 17:00,King Wilki Morskie Szczecin(w),74 : 94W,94,24,35,68.6,7,22,31.8,31,57,54.4,25,25,100.0,4,25,29,22,24,23,15,10,2,1,116,MOSiR PBS Bank KHS Krosno,Sezon 2013/2014
2014-04-26 18:00,Polfarmex Kutno(d),79 : 65W,79,24,41,58.5,4,15,26.7,28,56,50.0,19,22,86.4,7,22,29,17,21,23,11,13,2,1,98,MOSiR PBS Bank KHS Krosno,Sezon 2013/2014
2014-04-27 18:00,Polfarmex Kutno(d),65 : 77P,65,14,27,51.9,8,28,28.6,22,55,40.0,13,17,76.5,4,27,31,12,18,17,16,4,2,3,61,MOSiR PBS Bank KHS Krosno,Sezon 2013/2014
2014-05-03 16:00,Polfarmex Kutno(w),73 : 57P,57,8,30,26.7,7,25,28.0,15,55,27.3,20,24,83.3,10,20,30,13,16,20,13,5,2,3,50,MOSiR PBS Bank KHS Krosno,Sezon 2013/2014
2014-05-04 17:30,Polfarmex Kutno(w),77 : 72P,72,21,44,47.7,3,23,13.0,24,67,35.8,21,22,95.5,8,32,40,15,24,22,14,10,1,3,80,MOSiR PBS Bank KHS Krosno,Sezon 2013/2014
2014-05-11 18:45,MKS Wikana Start S.A. Lublin(w),65 : 79W,79,25,46,54.3,7,20,35.0,32,66,48.5,8,12,66.7,8,30,38,20,19,13,12,8,7,3,102,MOSiR PBS Bank KHS Krosno,Sezon 2013/2014
2014-05-17 17:00,MKS Wikana Start S.A. Lublin(d),100 : 70W,100,25,40,62.5,14,40,35.0,39,80,48.8,8,10,80.0,9,33,42,27,27,15,8,7,3,3,128,MOSiR PBS Bank KHS Krosno,Sezon 2013/2014
2013-09-28 17:30,MKS Wikana Start S.A. Lublin(d),75 : 68W,75,17,35,48.6,8,27,29.6,25,62,40.3,17,22,77.3,11,27,38,19,25,20,10,8,1,2,89,Polfarmex Kutno,Sezon 2013/2014
2013-10-05 17:30,Polski Cukier SIDEn Toruń(d),58 : 64P,58,11,37,29.7,8,29,27.6,19,66,28.8,12,17,70.6,9,15,24,8,24,20,9,10,0,3,39,Polfarmex Kutno,Sezon 2013/2014
2013-10-12 17:00,KS Spójnia Stargard Szczeciński(w),57 : 78W,78,22,36,61.1,6,18,33.3,28,54,51.9,16,19,84.2,9,23,32,20,28,23,20,10,1,1,92,Polfarmex Kutno,Sezon 2013/2014
2013-10-19 17:30,King Wilki Morskie Szczecin(d),90 : 60W,90,26,41,63.4,6,19,31.6,32,60,53.3,20,28,71.4,12,25,37,20,24,23,16,13,2,1,110,Polfarmex Kutno,Sezon 2013/2014
2013-10-27 20:00,MCKiS Termo-Rex SA Jaworzno(w),65 : 70W,70,20,30,66.7,8,30,26.7,28,60,46.7,6,12,50.0,11,20,31,20,24,19,21,14,3,1,79,Polfarmex Kutno,Sezon 2013/2014
2013-11-02 17:30,WKK ProBiotics Wrocław(d),75 : 61W,75,17,38,44.7,6,18,33.3,23,56,41.1,23,31,74.2,15,26,41,14,19,29,18,14,3,1,88,Polfarmex Kutno,Sezon 2013/2014
2013-11-09 18:00,MKS Dąbrowa Górnicza II(w),90 : 83P,83,26,52,50.0,5,19,26.3,31,71,43.7,16,26,61.5,11,18,29,13,30,24,13,14,1,2,77,Polfarmex Kutno,Sezon 2013/2014
2013-11-16 17:30,Intermarche Bricomarche BM SlamStal Ostrów(d),69 : 42W,69,20,38,52.6,7,27,25.9,27,65,41.5,8,9,88.9,11,25,36,13,20,15,7,12,0,3,84,Polfarmex Kutno,Sezon 2013/2014
2013-11-24 17:00,MKS Znicz Basket Pruszków(w),88 : 80P,80,19,38,50.0,13,37,35.1,32,75,42.7,3,6,50.0,9,20,29,15,33,14,18,11,2,3,73,Polfarmex Kutno,Sezon 2013/2014
2013-11-30 17:30,AZS Politechnika Poznań(d),86 : 56W,86,30,45,66.7,6,20,30.0,36,65,55.4,8,11,72.7,12,23,35,27,19,15,16,19,3,1,122,Polfarmex Kutno,Sezon 2013/2014
2013-12-07 17:30,PTG Sokół Łańcut(w),73 : 77W,77,15,27,55.6,12,19,63.2,27,46,58.7,11,16,68.8,7,20,27,19,23,17,17,8,2,1,92,Polfarmex Kutno,Sezon 2013/2014
2013-12-14 17:30,MOSiR PBS Bank KHS Krosno(d),75 : 66W,75,13,25,52.0,12,27,44.4,25,52,48.1,13,22,59.1,7,20,27,17,15,21,14,8,1,2,78,Polfarmex Kutno,Sezon 2013/2014
2013-12-21 17:00,Astoria Bydgoszcz(w),63 : 93W,93,29,38,76.3,7,21,33.3,36,59,61.0,14,17,82.4,6,20,26,19,30,16,13,16,5,1,120,Polfarmex Kutno,Sezon 2013/2014
2014-01-05 18:00,MKS Wikana Start S.A. Lublin(w),79 : 56P,56,11,36,30.6,7,31,22.6,18,67,26.9,13,18,72.2,14,25,39,11,30,20,15,12,1,2,50,Polfarmex Kutno,Sezon 2013/2014
2014-01-11 17:00,Polski Cukier SIDEn Toruń(w),70 : 59P,59,18,41,43.9,4,24,16.7,22,65,33.8,11,18,61.1,12,21,33,11,21,15,15,9,1,5,48,Polfarmex Kutno,Sezon 2013/2014
2014-01-18 17:30,KS Spójnia Stargard Szczeciński(d),90 : 60W,90,22,35,62.9,9,13,69.2,31,48,64.6,19,25,76.0,8,23,31,22,18,20,16,15,4,3,123,Polfarmex Kutno,Sezon 2013/2014
2014-01-26 17:00,King Wilki Morskie Szczecin(w),93 : 95W,95,20,42,47.6,11,26,42.3,31,68,45.6,22,31,71.0,15,19,34,16,26,23,20,9,2,4,90,Polfarmex Kutno,Sezon 2013/2014
2014-02-01 17:30,MCKiS Termo-Rex SA Jaworzno(d),113 : 79W,113,27,36,75.0,15,29,51.7,42,65,64.6,14,19,73.7,6,20,26,29,14,19,8,13,5,2,150,Polfarmex Kutno,Sezon 2013/2014
2014-02-08 17:00,WKK ProBiotics Wrocław(w),71 : 86W,86,18,44,40.9,13,26,50.0,31,70,44.3,11,17,64.7,12,25,37,17,24,23,8,8,6,3,101,Polfarmex Kutno,Sezon 2013/2014
2014-02-15 17:30,MKS Dąbrowa Górnicza II(d),84 : 74W,84,20,36,55.6,12,29,41.4,32,65,49.2,8,10,80.0,9,23,32,23,22,16,13,15,2,1,108,Polfarmex Kutno,Sezon 2013/2014
2014-02-23 18:30,Intermarche Bricomarche BM SlamStal Ostrów(w),86 : 79P,79,25,47,53.2,7,29,24.1,32,76,42.1,8,13,61.5,11,18,29,17,30,18,10,12,0,0,78,Polfarmex Kutno,Sezon 2013/2014
2014-02-28 18:30,MKS Znicz Basket Pruszków(d),76 : 70W,76,17,42,40.5,8,27,29.6,25,69,36.2,18,26,69.2,14,20,34,16,20,21,8,15,2,3,83,Polfarmex Kutno,Sezon 2013/2014
2014-03-08 18:00,AZS Politechnika Poznań(w),67 : 90W,90,30,56,53.6,8,23,34.8,38,79,48.1,6,20,30.0,13,25,38,19,25,15,15,16,2,4,95,Polfarmex Kutno,Sezon 2013/2014
2014-03-15 17:30,PTG Sokół Łańcut(d),78 : 50W,78,20,40,50.0,10,22,45.5,30,62,48.4,8,12,66.7,7,28,35,21,20,13,15,21,5,2,109,Polfarmex Kutno,Sezon 2013/2014
2014-03-23 18:00,MOSiR PBS Bank KHS Krosno(w),74 : 60P,60,18,36,50.0,5,28,17.9,23,64,35.9,9,14,64.3,12,19,31,12,20,17,9,6,0,2,54,Polfarmex Kutno,Sezon 2013/2014
2014-03-30 18:00,Astoria Bydgoszcz(d),76 : 62W,76,22,29,75.9,6,21,28.6,28,50,56.0,14,23,60.9,6,21,27,19,24,22,12,14,3,0,96,Polfarmex Kutno,Sezon 2013/2014
2014-04-05 17:30,PTG Sokół Łańcut(d),67 : 78P,67,21,50,42.0,4,22,18.2,25,72,34.7,13,18,72.2,11,22,33,9,28,19,5,11,2,3,65,Polfarmex Kutno,Sezon 2013/2014
2014-04-06 17:30,PTG Sokół Łańcut(d),84 : 53W,84,20,38,52.6,12,28,42.9,32,66,48.5,8,10,80.0,16,24,40,25,24,15,9,15,4,1,123,Polfarmex Kutno,Sezon 2013/2014
2014-04-12 17:30,PTG Sokół Łańcut(w),68 : 94W,94,18,32,56.3,12,25,48.0,30,57,52.6,22,31,71.0,7,17,24,16,22,27,5,8,2,0,103,Polfarmex Kutno,Sezon 2013/2014
2014-04-13 17:30,PTG Sokół Łańcut(w),60 : 64W,64,11,34,32.4,10,29,34.5,21,63,33.3,12,20,60.0,10,22,32,13,22,21,10,7,2,0,58,Polfarmex Kutno,Sezon 2013/2014
2014-04-26 18:00,MOSiR PBS Bank KHS Krosno(w),79 : 65P,65,17,37,45.9,7,26,26.9,24,63,38.1,10,10,100.0,10,15,25,10,23,20,20,5,1,2,47,Polfarmex Kutno,Sezon 2013/2014
2014-04-27 18:00,MOSiR PBS Bank KHS Krosno(w),65 : 77W,77,17,42,40.5,12,28,42.9,29,70,41.4,7,12,58.3,12,30,42,14,17,18,10,9,3,2,89,Polfarmex Kutno,Sezon 2013/2014
2014-05-03 16:00,MOSiR PBS Bank KHS Krosno(d),73 : 57W,73,23,46,50.0,8,17,47.1,31,63,49.2,3,6,50.0,10,27,37,16,20,16,12,9,3,2,91,Polfarmex Kutno,Sezon 2013/2014
2014-05-04 17:30,MOSiR PBS Bank KHS Krosno(d),77 : 72W,77,22,40,55.0,7,27,25.9,29,67,43.3,12,23,52.2,9,30,39,20,22,24,7,10,3,1,93,Polfarmex Kutno,Sezon 2013/2014
2014-05-10 17:30,WKK ProBiotics Wrocław(d),89 : 56W,89,28,42,66.7,9,23,39.1,37,65,56.9,6,11,54.5,10,22,32,21,23,18,9,19,3,2,122,Polfarmex Kutno,Sezon 2013/2014
2014-05-11 17:30,WKK ProBiotics Wrocław(d),81 : 79W,81,19,29,65.5,10,25,40.0,29,54,53.7,13,16,81.3,7,21,28,19,20,20,10,6,4,2,100,Polfarmex Kutno,Sezon 2013/2014
2014-05-17 20:00,WKK ProBiotics Wrocław(w),69 : 70W,70,17,44,38.6,5,21,23.8,22,65,33.8,21,28,75.0,9,22,31,12,20,24,12,14,0,3,65,Polfarmex Kutno,Sezon 2013/2014
2013-09-28 18:00,Astoria Bydgoszcz(d),84 : 66W,84,24,52,46.2,9,21,42.9,33,73,45.2,9,10,90.0,8,25,33,21,31,20,18,14,6,5,99,Polski Cukier SIDEn Toruń,Sezon 2013/2014
2013-10-05 17:30,Polfarmex Kutno(w),58 : 64W,64,24,35,68.6,1,14,7.1,25,49,51.0,13,26,50.0,9,34,43,10,20,24,15,5,3,0,73,Polski Cukier SIDEn Toruń,Sezon 2013/2014
2013-10-12 18:00,MKS Wikana Start S.A. Lublin(d),57 : 51W,57,22,46,47.8,2,15,13.3,24,61,39.3,7,14,50.0,10,31,41,14,18,21,17,6,7,2,64,Polski Cukier SIDEn Toruń,Sezon 2013/2014
2013-10-19 19:00,KS Spójnia Stargard Szczeciński(d),79 : 62W,79,22,35,62.9,6,22,27.3,28,57,49.1,17,27,63.0,14,29,43,21,20,22,16,5,6,3,99,Polski Cukier SIDEn Toruń,Sezon 2013/2014
2013-10-28 20:00,King Wilki Morskie Szczecin(w),76 : 79W,79,17,53,32.1,9,21,42.9,26,74,35.1,18,26,69.2,18,23,41,21,19,24,11,6,4,5,84,Polski Cukier SIDEn Toruń,Sezon 2013/2014
2013-11-02 18:00,MCKiS Termo-Rex SA Jaworzno(d),99 : 54W,99,20,35,57.1,13,26,50.0,33,61,54.1,20,28,71.4,10,24,34,25,19,23,13,14,5,2,128,Polski Cukier SIDEn Toruń,Sezon 2013/2014
2013-11-09 17:00,WKK ProBiotics Wrocław(w),82 : 63P,63,21,39,53.8,2,12,16.7,23,51,45.1,15,28,53.6,7,23,30,13,24,27,19,4,3,3,53,Polski Cukier SIDEn Toruń,Sezon 2013/2014
2013-11-16 18:00,MKS Dąbrowa Górnicza II(d),70 : 66W,70,19,49,38.8,5,16,31.3,24,65,36.9,17,28,60.7,16,24,40,17,20,24,12,7,2,5,72,Polski Cukier SIDEn Toruń,Sezon 2013/2014
2013-11-23 18:30,Intermarche Bricomarche BM SlamStal Ostrów(w),68 : 74W,74,21,32,65.6,4,12,33.3,25,44,56.8,20,33,60.6,6,25,31,14,17,26,16,8,2,0,81,Polski Cukier SIDEn Toruń,Sezon 2013/2014
2013-12-01 17:00,MKS Znicz Basket Pruszków(d),90 : 51W,90,21,44,47.7,10,19,52.6,31,63,49.2,18,22,81.8,6,31,37,26,14,23,12,10,1,3,116,Polski Cukier SIDEn Toruń,Sezon 2013/2014
2013-12-07 19:00,AZS Politechnika Poznań(w),65 : 102W,102,30,37,81.1,11,19,57.9,41,56,73.2,9,17,52.9,3,24,27,31,16,19,14,13,2,0,138,Polski Cukier SIDEn Toruń,Sezon 2013/2014
2013-12-14 17:00,PTG Sokół Łańcut(d),71 : 68W,71,24,45,53.3,4,15,26.7,28,60,46.7,11,16,68.8,7,25,32,17,18,21,14,6,2,5,77,Polski Cukier SIDEn Toruń,Sezon 2013/2014
2013-12-21 18:00,MOSiR PBS Bank KHS Krosno(w),61 : 65W,65,16,35,45.7,8,19,42.1,24,54,44.4,9,11,81.8,9,26,35,11,17,19,17,4,1,1,67,Polski Cukier SIDEn Toruń,Sezon 2013/2014
2014-01-04 18:00,Astoria Bydgoszcz(w),65 : 71W,71,20,35,57.1,4,13,30.8,24,48,50.0,19,31,61.3,7,28,35,16,20,28,13,6,6,1,85,Polski Cukier SIDEn Toruń,Sezon 2013/2014
2014-01-11 17:00,Polfarmex Kutno(d),70 : 59W,70,18,41,43.9,7,18,38.9,25,59,42.4,13,23,56.5,12,29,41,18,15,21,16,7,5,1,81,Polski Cukier SIDEn Toruń,Sezon 2013/2014
2014-01-18 18:00,MKS Wikana Start S.A. Lublin(w),87 : 94W,94,21,38,55.3,13,26,50.0,34,64,53.1,13,19,68.4,7,29,36,26,25,21,22,10,2,1,110,Polski Cukier SIDEn Toruń,Sezon 2013/2014
2014-01-25 17:00,KS Spójnia Stargard Szczeciński(w),44 : 64W,64,23,44,52.3,3,13,23.1,26,57,45.6,9,12,75.0,9,32,41,22,20,17,16,6,2,0,85,Polski Cukier SIDEn Toruń,Sezon 2013/2014
2014-02-01 17:00,King Wilki Morskie Szczecin(d),83 : 72W,83,28,36,77.8,7,26,26.9,35,62,56.5,6,9,66.7,9,22,31,26,19,18,12,3,1,0,102,Polski Cukier SIDEn Toruń,Sezon 2013/2014
2014-02-08 20:00,MCKiS Termo-Rex SA Jaworzno(w),68 : 77W,77,19,38,50.0,7,17,41.2,26,55,47.3,18,22,81.8,9,16,25,16,16,26,18,8,2,1,77,Polski Cukier SIDEn Toruń,Sezon 2013/2014
2014-02-15 17:00,WKK ProBiotics Wrocław(d),62 : 65P,62,16,41,39.0,6,18,33.3,22,59,37.3,12,19,63.2,10,22,32,18,20,19,14,6,2,1,62,Polski Cukier SIDEn Toruń,Sezon 2013/2014
2014-02-22 18:00,MKS Dąbrowa Górnicza II(w),84 : 69P,69,23,45,51.1,3,20,15.0,26,65,40.0,14,22,63.6,14,14,28,12,20,19,14,7,2,3,57,Polski Cukier SIDEn Toruń,Sezon 2013/2014
2014-03-01 17:00,Intermarche Bricomarche BM SlamStal Ostrów(d),69 : 68W,69,19,42,45.2,8,23,34.8,27,65,41.5,7,10,70.0,10,19,29,17,18,18,15,7,4,1,70,Polski Cukier SIDEn Toruń,Sezon 2013/2014
2014-03-08 18:00,MKS Znicz Basket Pruszków(w),63 : 72W,72,20,40,50.0,8,22,36.4,28,62,45.2,8,13,61.5,10,20,30,21,14,16,10,12,1,2,87,Polski Cukier SIDEn Toruń,Sezon 2013/2014
2014-03-15 18:00,AZS Politechnika Poznań(d),78 : 57W,78,26,46,56.5,3,20,15.0,29,66,43.9,17,24,70.8,16,26,42,26,11,23,15,6,5,2,98,Polski Cukier SIDEn Toruń,Sezon 2013/2014
2014-03-22 17:30,PTG Sokół Łańcut(w),73 : 69P,69,14,34,41.2,10,23,43.5,24,57,42.1,11,20,55.0,8,21,29,15,21,21,19,8,3,0,63,Polski Cukier SIDEn Toruń,Sezon 2013/2014
2014-03-30 18:00,MOSiR PBS Bank KHS Krosno(d),70 : 58W,70,17,36,47.2,9,22,40.9,26,58,44.8,9,12,75.0,11,29,40,19,15,16,17,5,6,4,88,Polski Cukier SIDEn Toruń,Sezon 2013/2014
2014-04-05 17:45,MKS Wikana Start S.A. Lublin(d),78 : 80P,78,18,38,47.4,9,29,31.0,27,67,40.3,15,25,60.0,7,30,37,15,23,23,15,8,1,5,74,Polski Cukier SIDEn Toruń,Sezon 2013/2014
2014-04-06 20:00,MKS Wikana Start S.A. Lublin(d),67 : 79P,67,8,30,26.7,12,29,41.4,20,59,33.9,15,22,68.2,12,23,35,18,20,24,11,4,3,2,70,Polski Cukier SIDEn Toruń,Sezon 2013/2014
2014-04-12 18:00,MKS Wikana Start S.A. Lublin(w),67 : 63P,63,11,32,34.4,12,27,44.4,23,59,39.0,5,10,50.0,6,26,32,15,25,18,18,4,2,2,57,Polski Cukier SIDEn Toruń,Sezon 2013/2014
2013-09-28 20:00,King Wilki Morskie Szczecin(w),84 : 77P,77,18,34,52.9,5,22,22.7,23,56,41.1,26,29,89.7,5,24,29,11,27,24,23,10,4,2,72,PTG Sokół Łańcut,Sezon 2013/2014
2013-10-05 17:30,MCKiS Termo-Rex SA Jaworzno(d),90 : 67W,90,16,26,61.5,14,32,43.8,30,58,51.7,16,21,76.2,10,24,34,18,18,25,13,8,4,0,108,PTG Sokół Łańcut,Sezon 2013/2014
2013-10-12 17:00,WKK ProBiotics Wrocław(w),71 : 64P,64,18,37,48.6,3,18,16.7,21,55,38.2,19,24,79.2,6,26,32,14,20,26,15,6,8,2,70,PTG Sokół Łańcut,Sezon 2013/2014
2013-10-19 17:30,MKS Dąbrowa Górnicza II(d),72 : 73P,72,18,38,47.4,8,26,30.8,26,64,40.6,12,15,80.0,11,25,36,11,21,20,11,5,5,4,77,PTG Sokół Łańcut,Sezon 2013/2014
2013-10-26 18:30,Intermarche Bricomarche BM SlamStal Ostrów(w),86 : 71P,71,15,33,45.5,8,22,36.4,23,55,41.8,17,22,77.3,7,18,25,16,20,20,13,7,3,1,72,PTG Sokół Łańcut,Sezon 2013/2014
2013-11-02 17:30,MKS Znicz Basket Pruszków(d),76 : 72W,76,18,36,50.0,9,25,36.0,27,61,44.3,13,18,72.2,6,18,24,17,19,20,9,4,2,0,75,PTG Sokół Łańcut,Sezon 2013/2014
2013-11-09 17:30,AZS Politechnika Poznań(d),77 : 54W,77,23,42,54.8,6,22,27.3,29,64,45.3,13,20,65.0,13,25,38,21,14,19,15,12,3,3,94,PTG Sokół Łańcut,Sezon 2013/2014
2013-11-16 18:00,MKS Wikana Start S.A. Lublin(w),52 : 69W,69,17,39,43.6,8,26,30.8,25,65,38.5,11,15,73.3,15,26,41,14,18,18,12,11,1,0,80,PTG Sokół Łańcut,Sezon 2013/2014
2013-11-23 17:30,MOSiR PBS Bank KHS Krosno(d),49 : 54P,49,16,35,45.7,2,18,11.1,18,53,34.0,11,15,73.3,13,19,32,7,14,19,14,11,3,3,49,PTG Sokół Łańcut,Sezon 2013/2014
2013-12-01 17:00,Astoria Bydgoszcz(w),84 : 90W,90,24,44,54.5,9,22,40.9,33,66,50.0,15,17,88.2,10,24,34,22,17,18,16,10,3,2,108,PTG Sokół Łańcut,Sezon 2013/2014
2013-12-07 17:30,Polfarmex Kutno(d),73 : 77P,73,19,35,54.3,8,20,40.0,27,55,49.1,11,15,73.3,11,15,26,11,18,23,14,12,1,2,77,PTG Sokół Łańcut,Sezon 2013/2014
2013-12-14 17:00,Polski Cukier SIDEn Toruń(w),71 : 68P,68,17,33,51.5,7,25,28.0,24,58,41.4,13,15,86.7,7,22,29,17,21,18,13,1,5,2,71,PTG Sokół Łańcut,Sezon 2013/2014
2013-12-21 17:30,KS Spójnia Stargard Szczeciński(d),80 : 58W,80,18,36,50.0,9,24,37.5,27,60,45.0,17,21,81.0,14,27,41,17,21,19,9,10,2,4,104,PTG Sokół Łańcut,Sezon 2013/2014
2014-01-04 17:30,King Wilki Morskie Szczecin(d),100 : 72W,100,25,41,61.0,13,29,44.8,38,70,54.3,11,16,68.8,12,25,37,26,21,19,15,10,6,2,127,PTG Sokół Łańcut,Sezon 2013/2014
2014-01-10 20:00,MCKiS Termo-Rex SA Jaworzno(w),66 : 67W,67,21,41,51.2,5,19,26.3,26,60,43.3,10,13,76.9,11,22,33,12,16,15,14,6,1,1,68,PTG Sokół Łańcut,Sezon 2013/2014
2014-01-18 17:30,WKK ProBiotics Wrocław(d),82 : 74W,82,21,42,50.0,7,23,30.4,28,65,43.1,19,25,76.0,8,28,36,12,20,25,16,9,8,2,88,PTG Sokół Łańcut,Sezon 2013/2014
2014-01-26 18:00,MKS Dąbrowa Górnicza II(w),81 : 86W,86,18,41,43.9,12,26,46.2,30,67,44.8,14,19,73.7,11,23,34,13,23,18,12,12,4,6,95,PTG Sokół Łańcut,Sezon 2013/2014
2014-02-01 17:30,Intermarche Bricomarche BM SlamStal Ostrów(d),79 : 63W,79,22,33,66.7,9,27,33.3,31,60,51.7,8,9,88.9,7,30,37,22,25,14,16,6,1,0,99,PTG Sokół Łańcut,Sezon 2013/2014
2014-02-09 17:00,MKS Znicz Basket Pruszków(w),64 : 89W,89,24,38,63.2,10,28,35.7,34,66,51.5,11,15,73.3,12,22,34,15,21,17,15,11,6,2,104,PTG Sokół Łańcut,Sezon 2013/2014
2014-02-16 18:00,AZS Politechnika Poznań(w),43 : 86W,86,22,41,53.7,10,24,41.7,32,65,49.2,12,14,85.7,5,26,31,26,19,15,8,8,4,1,112,PTG Sokół Łańcut,Sezon 2013/2014
2014-02-24 18:00,MKS Wikana Start S.A. Lublin(d),71 : 77P,71,17,31,54.8,6,32,18.8,23,63,36.5,19,23,82.6,11,25,36,14,25,23,6,7,6,0,84,PTG Sokół Łańcut,Sezon 2013/2014
2014-03-02 18:00,MOSiR PBS Bank KHS Krosno(w),67 : 56P,56,12,33,36.4,7,21,33.3,19,54,35.2,11,12,91.7,4,22,26,13,18,21,17,6,1,3,49,PTG Sokół Łańcut,Sezon 2013/2014
2014-03-08 17:30,Astoria Bydgoszcz(d),78 : 63W,78,17,33,51.5,10,21,47.6,27,54,50.0,14,18,77.8,7,20,27,19,18,20,12,6,4,1,91,PTG Sokół Łańcut,Sezon 2013/2014
2014-03-15 17:30,Polfarmex Kutno(w),78 : 50P,50,18,42,42.9,2,17,11.8,20,59,33.9,8,11,72.7,10,25,35,10,13,20,14,4,2,5,45,PTG Sokół Łańcut,Sezon 2013/2014
2014-03-22 17:30,Polski Cukier SIDEn Toruń(d),73 : 69W,73,19,38,50.0,8,20,40.0,27,58,46.6,11,14,78.6,2,22,24,15,22,20,14,10,5,0,79,PTG Sokół Łańcut,Sezon 2013/2014
2014-03-29 16:30,KS Spójnia Stargard Szczeciński(w),59 : 63W,63,24,37,64.9,4,24,16.7,28,61,45.9,3,6,50.0,7,30,37,18,15,14,17,7,3,2,75,PTG Sokół Łańcut,Sezon 2013/2014
2014-04-05 17:30,Polfarmex Kutno(w),67 : 78W,78,23,42,54.8,2,13,15.4,25,55,45.5,26,32,81.3,8,34,42,13,19,28,16,3,3,2,87,PTG Sokół Łańcut,Sezon 2013/2014
2014-04-06 17:30,Polfarmex Kutno(w),84 : 53P,53,12,35,34.3,5,14,35.7,17,49,34.7,14,23,60.9,7,18,25,12,15,24,16,7,1,4,41,PTG Sokół Łańcut,Sezon 2013/2014
2014-04-12 17:30,Polfarmex Kutno(d),68 : 94P,68,17,33,51.5,6,19,31.6,23,52,44.2,16,20,80.0,7,19,26,15,27,22,12,2,2,0,68,PTG Sokół Łańcut,Sezon 2013/2014
2014-04-13 17:30,Polfarmex Kutno(d),60 : 64P,60,18,34,52.9,4,23,17.4,22,57,38.6,12,16,75.0,7,31,38,8,21,22,12,5,3,0,63,PTG Sokół Łańcut,Sezon 2013/2014
2013-09-28 18:00,MKS Znicz Basket Pruszków(d),79 : 68W,79,21,47,44.7,8,16,50.0,29,63,46.0,13,19,68.4,12,17,29,15,23,24,17,11,5,2,82,WKK ProBiotics Wrocław,Sezon 2013/2014
2013-10-05 18:00,AZS Politechnika Poznań(w),74 : 72P,72,12,35,34.3,11,29,37.9,23,64,35.9,15,22,68.2,10,20,30,12,18,22,18,13,1,4,62,WKK ProBiotics Wrocław,Sezon 2013/2014
2013-10-12 17:00,PTG Sokół Łańcut(d),71 : 64W,71,20,49,40.8,5,17,29.4,25,66,37.9,16,21,76.2,12,26,38,12,26,20,11,7,2,8,73,WKK ProBiotics Wrocław,Sezon 2013/2014
2013-10-20 18:00,MOSiR PBS Bank KHS Krosno(w),72 : 59P,59,13,42,31.0,8,23,34.8,21,65,32.3,9,14,64.3,12,27,39,13,18,19,18,6,4,3,54,WKK ProBiotics Wrocław,Sezon 2013/2014
2013-10-26 17:00,Astoria Bydgoszcz(d),91 : 79W,91,25,57,43.9,5,20,25.0,30,77,39.0,26,31,83.9,20,19,39,12,30,27,19,18,5,3,94,WKK ProBiotics Wrocław,Sezon 2013/2014
2013-11-02 17:30,Polfarmex Kutno(w),75 : 61P,61,18,50,36.0,5,21,23.8,23,71,32.4,10,16,62.5,10,18,28,12,30,19,18,9,1,3,39,WKK ProBiotics Wrocław,Sezon 2013/2014
2013-11-09 17:00,Polski Cukier SIDEn Toruń(d),82 : 63W,82,23,51,45.1,8,16,50.0,31,67,46.3,12,19,63.2,11,17,28,9,27,24,10,13,3,3,82,WKK ProBiotics Wrocław,Sezon 2013/2014
2013-11-17 17:00,KS Spójnia Stargard Szczeciński(w),53 : 83W,83,19,42,45.2,10,19,52.6,29,61,47.5,15,18,83.3,10,24,34,18,24,22,17,13,1,3,97,WKK ProBiotics Wrocław,Sezon 2013/2014
2013-11-23 17:00,King Wilki Morskie Szczecin(d),75 : 83P,75,16,39,41.0,8,30,26.7,24,69,34.8,19,24,79.2,14,19,33,14,29,23,13,8,5,4,72,WKK ProBiotics Wrocław,Sezon 2013/2014
2013-12-01 20:00,MCKiS Termo-Rex SA Jaworzno(w),64 : 84W,84,29,48,60.4,8,24,33.3,37,72,51.4,2,3,66.7,8,17,25,14,20,14,11,11,4,2,91,WKK ProBiotics Wrocław,Sezon 2013/2014
2013-12-07 17:00,MKS Wikana Start S.A. Lublin(d),69 : 70P,69,12,36,33.3,9,31,29.0,21,67,31.3,18,24,75.0,14,27,41,13,28,19,9,2,2,0,66,WKK ProBiotics Wrocław,Sezon 2013/2014
2013-12-14 17:00,MKS Dąbrowa Górnicza II(d),79 : 78W,79,19,44,43.2,8,22,36.4,27,66,40.9,17,28,60.7,18,22,40,11,23,25,14,5,2,2,73,WKK ProBiotics Wrocław,Sezon 2013/2014
2013-12-21 18:30,Intermarche Bricomarche BM SlamStal Ostrów(w),66 : 68W,68,21,45,46.7,6,21,28.6,27,66,40.9,8,10,80.0,15,18,33,12,21,19,16,9,1,2,66,WKK ProBiotics Wrocław,Sezon 2013/2014
2014-01-05 17:00,MKS Znicz Basket Pruszków(w),52 : 65W,65,20,44,45.5,6,21,28.6,26,65,40.0,7,14,50.0,14,23,37,10,21,15,17,15,0,3,64,WKK ProBiotics Wrocław,Sezon 2013/2014
2014-01-11 17:00,AZS Politechnika Poznań(d),86 : 76W,86,30,51,58.8,5,20,25.0,35,71,49.3,11,18,61.1,15,26,41,22,21,23,15,11,2,3,104,WKK ProBiotics Wrocław,Sezon 2013/2014
2014-01-18 17:30,PTG Sokół Łańcut(w),82 : 74P,74,24,57,42.1,5,17,29.4,29,74,39.2,11,13,84.6,12,24,36,8,26,20,14,10,2,8,69,WKK ProBiotics Wrocław,Sezon 2013/2014
2014-01-25 17:00,MOSiR PBS Bank KHS Krosno(d),71 : 61W,71,21,46,45.7,7,20,35.0,28,66,42.4,8,11,72.7,10,22,32,11,24,18,13,9,5,1,74,WKK ProBiotics Wrocław,Sezon 2013/2014
2014-02-01 19:00,Astoria Bydgoszcz(w),76 : 70P,70,14,35,40.0,10,23,43.5,24,58,41.4,12,18,66.7,13,15,28,15,27,22,19,5,3,4,62,WKK ProBiotics Wrocław,Sezon 2013/2014
2014-02-08 17:00,Polfarmex Kutno(d),71 : 86P,71,21,48,43.8,5,21,23.8,26,69,37.7,14,24,58.3,19,25,44,15,23,24,14,6,3,6,72,WKK ProBiotics Wrocław,Sezon 2013/2014
2014-02-15 17:00,Polski Cukier SIDEn Toruń(w),62 : 65W,65,10,32,31.3,11,21,52.4,21,53,39.6,12,20,60.0,8,25,33,18,19,20,18,5,1,2,64,WKK ProBiotics Wrocław,Sezon 2013/2014
2014-02-22 17:00,KS Spójnia Stargard Szczeciński(d),105 : 61W,105,28,50,56.0,12,20,60.0,40,70,57.1,13,18,72.2,13,26,39,25,17,20,14,10,3,3,133,WKK ProBiotics Wrocław,Sezon 2013/2014
2014-03-02 17:00,King Wilki Morskie Szczecin(w),101 : 88P,88,25,45,55.6,7,22,31.8,32,67,47.8,17,22,77.3,9,16,25,17,21,20,10,7,1,5,88,WKK ProBiotics Wrocław,Sezon 2013/2014
2014-03-08 16:00,MCKiS Termo-Rex SA Jaworzno(d),92 : 60W,92,25,36,69.4,10,28,35.7,35,64,54.7,12,19,63.2,9,22,31,23,22,21,13,18,1,2,116,WKK ProBiotics Wrocław,Sezon 2013/2014
2014-03-16 18:00,MKS Wikana Start S.A. Lublin(w),72 : 73W,73,20,45,44.4,5,24,20.8,25,69,36.2,18,19,94.7,11,26,37,10,22,23,16,9,2,2,70,WKK ProBiotics Wrocław,Sezon 2013/2014
2014-03-22 18:00,MKS Dąbrowa Górnicza II(w),81 : 85W,85,21,47,44.7,10,23,43.5,31,70,44.3,13,17,76.5,12,24,36,18,27,23,14,4,1,8,87,WKK ProBiotics Wrocław,Sezon 2013/2014
2014-03-30 18:00,Intermarche Bricomarche BM SlamStal Ostrów(d),77 : 60W,77,18,43,41.9,7,17,41.2,25,60,41.7,20,26,76.9,15,25,40,19,23,23,15,9,2,2,91,WKK ProBiotics Wrocław,Sezon 2013/2014
2014-04-05 17:00,MKS Dąbrowa Górnicza II(d),79 : 77W,79,23,49,46.9,6,27,22.2,29,76,38.2,15,21,71.4,17,22,39,12,23,19,10,11,4,6,82,WKK ProBiotics Wrocław,Sezon 2013/2014
2014-04-06 17:00,MKS Dąbrowa Górnicza II(d),93 : 84W,93,16,51,31.4,13,26,50.0,29,77,37.7,22,29,75.9,21,28,49,10,30,26,20,11,1,7,89,WKK ProBiotics Wrocław,Sezon 2013/2014
2014-04-12 18:00,MKS Dąbrowa Górnicza II(w),84 : 81P,81,29,51,56.9,5,16,31.3,34,67,50.7,8,11,72.7,11,21,32,12,21,19,16,3,0,5,76,WKK ProBiotics Wrocław,Sezon 2013/2014
2014-04-13 18:00,MKS Dąbrowa Górnicza II(w),72 : 75W,75,21,51,41.2,5,14,35.7,26,65,40.0,18,23,78.3,13,23,36,16,21,22,12,9,2,5,82,WKK ProBiotics Wrocław,Sezon 2013/2014
2014-04-26 18:00,MKS Wikana Start S.A. Lublin(d),66 : 60W,66,14,42,33.3,8,21,38.1,22,63,34.9,14,27,51.9,11,31,42,15,22,25,17,5,2,2,59,WKK ProBiotics Wrocław,Sezon 2013/2014
2014-04-27 18:00,MKS Wikana Start S.A. Lublin(d),63 : 69P,63,11,39,28.2,8,25,32.0,19,64,29.7,17,21,81.0,9,23,32,12,25,20,15,7,6,3,56,WKK ProBiotics Wrocław,Sezon 2013/2014
2014-05-03 18:00,MKS Wikana Start S.A. Lublin(w),51 : 70W,70,18,45,40.0,9,21,42.9,27,66,40.9,7,10,70.0,14,27,41,13,18,17,13,5,3,5,77,WKK ProBiotics Wrocław,Sezon 2013/2014
2014-05-04 18:00,MKS Wikana Start S.A. Lublin(w),88 : 60P,60,13,40,32.5,9,33,27.3,22,73,30.1,7,10,70.0,14,18,32,9,16,18,11,4,4,4,44,WKK ProBiotics Wrocław,Sezon 2013/2014
2014-05-07 18:00,MKS Wikana Start S.A. Lublin(d),78 : 61W,78,20,47,42.6,10,22,45.5,30,69,43.5,8,15,53.3,15,18,33,14,21,20,14,11,4,4,80,WKK ProBiotics Wrocław,Sezon 2013/2014
2014-05-10 17:30,Polfarmex Kutno(w),89 : 56P,56,16,42,38.1,2,17,11.8,18,59,30.5,18,27,66.7,14,17,31,8,18,23,18,7,2,3,36,WKK ProBiotics Wrocław,Sezon 2013/2014
2014-05-11 17:30,Polfarmex Kutno(w),81 : 79P,79,21,43,48.8,7,20,35.0,28,63,44.4,16,18,88.9,8,13,21,18,20,20,12,5,2,4,76,WKK ProBiotics Wrocław,Sezon 2013/2014
2014-05-17 20:00,Polfarmex Kutno(d),69 : 70P,69,19,41,46.3,8,20,40.0,27,61,44.3,7,11,63.6,9,30,39,11,24,20,22,5,3,0,67,WKK ProBiotics Wrocław,Sezon 2013/2014
2012-09-29 18:00,AZS WSGK POLFARMEX Kutno(d),80 : 77W,80,20,40,50.0,6,18,33.3,26,58,44.8,22,34,64.7,7,23,30,13,24,31,13,5,1,0,72,MKS Dąbrowa Górnicza II,Sezon 2012/2013
2012-10-03 17:00,AZS Politechnika Poznań(w),64 : 71W,71,22,39,56.4,3,24,12.5,25,63,39.7,18,28,64.3,8,26,34,12,18,29,17,12,1,0,65,MKS Dąbrowa Górnicza II,Sezon 2012/2013
2012-10-07 18:00,Polski Cukier SIDEn Toruń(d),76 : 66W,76,22,41,53.7,6,27,22.2,28,68,41.2,14,20,70.0,9,31,40,15,24,25,11,8,4,0,86,MKS Dąbrowa Górnicza II,Sezon 2012/2013
2012-10-13 20:00,AZS Radex Szczecin(w),70 : 65P,65,20,37,54.1,5,20,25.0,25,57,43.9,10,18,55.6,8,21,29,12,24,19,20,3,2,0,51,MKS Dąbrowa Górnicza II,Sezon 2012/2013
2012-10-21 18:00,PBS BANK EFIR ENERGY MOSiR Krosno(d),86 : 77W,86,23,49,46.9,8,20,40.0,31,69,44.9,16,25,64.0,18,19,37,22,18,23,11,9,3,0,99,MKS Dąbrowa Górnicza II,Sezon 2012/2013
2012-10-27 17:00,KS Spójnia Stargard Szczeciński(w),57 : 65W,65,17,37,45.9,7,21,33.3,24,58,41.4,10,20,50.0,6,28,34,14,16,20,14,7,2,3,64,MKS Dąbrowa Górnicza II,Sezon 2012/2013
2012-11-04 18:00,Franz Astoria Bydgoszcz(d),87 : 71W,87,24,41,58.5,9,23,39.1,33,64,51.6,12,17,70.6,6,35,41,20,19,19,19,10,6,0,109,MKS Dąbrowa Górnicza II,Sezon 2012/2013
2012-11-11 18:15,WKS Śląsk Wrocław(w),94 : 62P,62,20,44,45.5,3,17,17.6,23,61,37.7,13,18,72.2,13,19,32,5,27,25,15,10,1,0,52,MKS Dąbrowa Górnicza II,Sezon 2012/2013
2012-11-17 18:00,BM SLAM STAL Ostrów Wielkopolski(d),72 : 83P,72,22,49,44.9,7,19,36.8,29,68,42.6,7,18,38.9,8,24,32,14,25,18,12,6,1,0,63,MKS Dąbrowa Górnicza II,Sezon 2012/2013
2012-11-24 18:00,WIKANA START SA Lublin(w),85 : 74P,74,17,34,50.0,9,24,37.5,26,58,44.8,13,19,68.4,8,21,29,7,18,20,11,5,1,1,67,MKS Dąbrowa Górnicza II,Sezon 2012/2013
2012-12-02 18:00,Siedlecki Klub Koszykówki Siedlce(d),96 : 66W,96,27,43,62.8,13,24,54.2,40,67,59.7,3,10,30.0,9,23,32,26,16,15,10,5,3,0,118,MKS Dąbrowa Górnicza II,Sezon 2012/2013
2012-12-05 18:00,NETO PTG Sokół Łańcut(w),82 : 89W,89,22,36,61.1,7,20,35.0,29,56,51.8,24,28,85.7,12,22,34,9,21,25,18,5,2,2,90,MKS Dąbrowa Górnicza II,Sezon 2012/2013
2012-12-08 18:00,BUDIMPEX-POLONIA Przemyśl(w),69 : 82W,82,23,42,54.8,6,27,22.2,29,69,42.0,18,22,81.8,12,27,39,15,19,20,8,7,3,1,94,MKS Dąbrowa Górnicza II,Sezon 2012/2013
2012-12-14 19:00,MKS Znicz Basket Pruszków(w),59 : 66W,66,18,46,39.1,1,14,7.1,19,60,31.7,27,40,67.5,13,26,39,5,17,28,17,10,4,4,53,MKS Dąbrowa Górnicza II,Sezon 2012/2013
2012-12-19 19:00,UMKS Kielce(w),81 : 86W,86,28,45,62.2,4,17,23.5,32,62,51.6,18,28,64.3,8,29,37,18,17,24,17,7,0,6,91,MKS Dąbrowa Górnicza II,Sezon 2012/2013
2013-01-05 17:30,AZS WSGK POLFARMEX Kutno(w),75 : 73P,73,25,46,54.3,5,20,25.0,30,66,45.5,8,17,47.1,7,18,25,13,20,25,11,4,1,1,60,MKS Dąbrowa Górnicza II,Sezon 2012/2013
2013-01-09 18:00,AZS Politechnika Poznań(d),94 : 66W,94,34,56,60.7,5,20,25.0,39,76,51.3,11,17,64.7,13,25,38,19,12,16,17,13,3,0,107,MKS Dąbrowa Górnicza II,Sezon 2012/2013
2013-01-13 18:30,Polski Cukier SIDEn Toruń(w),75 : 68P,68,20,47,42.6,6,24,25.0,26,71,36.6,10,13,76.9,10,27,37,10,20,16,8,3,5,3,67,MKS Dąbrowa Górnicza II,Sezon 2012/2013
2013-01-19 17:00,AZS Radex Szczecin(d),84 : 77W,84,26,50,52.0,5,20,25.0,31,70,44.3,17,27,63.0,10,34,44,17,17,26,12,7,5,0,96,MKS Dąbrowa Górnicza II,Sezon 2012/2013
2013-01-27 18:00,PBS BANK EFIR ENERGY MOSiR Krosno(w),97 : 75P,75,21,39,53.8,5,17,29.4,26,56,46.4,18,33,54.5,9,15,24,16,19,26,11,4,4,3,67,MKS Dąbrowa Górnicza II,Sezon 2012/2013
2013-01-30 18:00,KS Spójnia Stargard Szczeciński(d),70 : 72P,70,12,26,46.2,8,26,30.8,20,52,38.5,22,23,95.7,5,26,31,11,23,22,15,3,2,0,69,MKS Dąbrowa Górnicza II,Sezon 2012/2013
2013-02-03 17:00,Franz Astoria Bydgoszcz(w),104 : 110W,110,31,53,58.5,7,21,33.3,38,74,51.4,27,41,65.9,12,23,35,17,28,31,10,11,2,3,115,MKS Dąbrowa Górnicza II,Sezon 2012/2013
2013-02-13 19:00,WKS Śląsk Wrocław(d),78 : 87P,78,22,41,53.7,4,19,21.1,26,60,43.3,22,30,73.3,14,24,38,15,21,21,18,4,4,0,79,MKS Dąbrowa Górnicza II,Sezon 2012/2013
2013-02-16 18:30,BM SLAM STAL Ostrów Wielkopolski(w),95 : 91P,91,31,43,72.1,4,20,20.0,35,63,55.6,17,23,73.9,6,26,32,12,24,25,17,5,0,2,89,MKS Dąbrowa Górnicza II,Sezon 2012/2013
2013-02-23 18:00,WIKANA START SA Lublin(d),84 : 83W,84,20,37,54.1,11,33,33.3,31,70,44.3,11,17,64.7,15,17,32,18,20,19,10,4,7,0,90,MKS Dąbrowa Górnicza II,Sezon 2012/2013
2013-03-02 19:00,Siedlecki Klub Koszykówki Siedlce(w),65 : 69W,69,21,49,42.9,6,16,37.5,27,65,41.5,9,16,56.3,6,24,30,15,15,20,8,9,3,3,73,MKS Dąbrowa Górnicza II,Sezon 2012/2013
2013-03-06 18:00,NETO PTG Sokół Łańcut(d),72 : 64W,72,24,43,55.8,6,17,35.3,30,60,50.0,6,13,46.2,6,25,31,17,23,20,16,6,4,0,77,MKS Dąbrowa Górnicza II,Sezon 2012/2013
2013-03-09 18:00,BUDIMPEX-POLONIA Przemyśl(d),72 : 64W,72,19,45,42.2,9,21,42.9,28,66,42.4,7,8,87.5,15,23,38,16,21,15,14,6,4,3,83,MKS Dąbrowa Górnicza II,Sezon 2012/2013
2013-03-20 18:00,MKS Znicz Basket Pruszków(d),93 : 77W,93,19,41,46.3,13,26,50.0,32,67,47.8,16,24,66.7,11,25,36,19,22,21,12,10,2,1,105,MKS Dąbrowa Górnicza II,Sezon 2012/2013
2013-03-23 18:00,UMKS Kielce(d),90 : 74W,90,20,32,62.5,10,26,38.5,30,58,51.7,20,29,69.0,13,33,46,18,25,25,19,11,1,0,110,MKS Dąbrowa Górnicza II,Sezon 2012/2013
2013-04-07 18:00,PBS BANK EFIR ENERGY MOSiR Krosno(d),83 : 81W,83,21,41,51.2,9,23,39.1,30,64,46.9,14,25,56.0,13,22,35,20,18,25,10,8,1,3,92,MKS Dąbrowa Górnicza II,Sezon 2012/2013
2013-04-08 18:00,PBS BANK EFIR ENERGY MOSiR Krosno(d),84 : 89P,84,26,40,65.0,6,21,28.6,32,61,52.5,14,22,63.6,10,24,34,19,23,26,17,5,6,2,94,MKS Dąbrowa Górnicza II,Sezon 2012/2013
2013-04-13 18:00,PBS BANK EFIR ENERGY MOSiR Krosno(w),75 : 62P,62,15,35,42.9,5,24,20.8,20,59,33.9,17,28,60.7,12,24,36,11,24,26,17,7,3,1,52,MKS Dąbrowa Górnicza II,Sezon 2012/2013
2013-04-14 18:00,PBS BANK EFIR ENERGY MOSiR Krosno(w),57 : 83W,83,19,36,52.8,12,28,42.9,31,64,48.4,9,12,75.0,5,24,29,14,21,19,8,5,2,4,89,MKS Dąbrowa Górnicza II,Sezon 2012/2013
2013-04-17 18:00,PBS BANK EFIR ENERGY MOSiR Krosno(d),72 : 89P,72,20,48,41.7,9,24,37.5,29,72,40.3,5,11,45.5,12,26,38,17,29,19,13,3,4,4,72,MKS Dąbrowa Górnicza II,Sezon 2012/2013
2012-09-30 18:00,NETO PTG Sokół Łańcut(w),83 : 76P,76,16,41,39.0,10,23,43.5,26,64,40.6,14,21,66.7,10,24,34,11,27,19,17,4,1,0,64,AZS Politechnika Poznań,Sezon 2012/2013
2012-10-03 17:00,MKS Dąbrowa Górnicza II(d),64 : 71P,64,23,57,40.4,3,18,16.7,26,75,34.7,9,17,52.9,14,30,44,12,29,18,22,8,4,0,53,AZS Politechnika Poznań,Sezon 2012/2013
2012-10-07 19:00,MKS Znicz Basket Pruszków(w),67 : 57P,57,20,57,35.1,4,15,26.7,24,72,33.3,5,14,35.7,18,18,36,12,21,18,16,11,3,0,46,AZS Politechnika Poznań,Sezon 2012/2013
2012-10-14 17:00,UMKS Kielce(d),65 : 73P,65,15,41,36.6,9,31,29.0,24,72,33.3,8,18,44.4,20,22,42,12,27,19,16,8,2,0,55,AZS Politechnika Poznań,Sezon 2012/2013
2012-10-20 17:30,AZS WSGK POLFARMEX Kutno(w),81 : 67P,67,21,50,42.0,3,13,23.1,24,63,38.1,16,25,64.0,8,20,28,14,19,19,18,8,1,6,52,AZS Politechnika Poznań,Sezon 2012/2013
2012-10-27 18:00,BUDIMPEX-POLONIA Przemyśl(w),92 : 76P,76,28,53,52.8,5,18,27.8,33,71,46.5,5,9,55.6,8,14,22,11,27,16,15,12,2,7,66,AZS Politechnika Poznań,Sezon 2012/2013
2012-11-03 19:30,Polski Cukier SIDEn Toruń(d),73 : 60W,73,21,41,51.2,6,25,24.0,27,66,40.9,13,15,86.7,14,26,40,15,26,15,15,6,2,2,80,AZS Politechnika Poznań,Sezon 2012/2013
2012-11-10 20:00,AZS Radex Szczecin(w),70 : 63P,63,26,53,49.1,2,14,14.3,28,67,41.8,5,10,50.0,7,19,26,18,17,13,9,8,2,4,64,AZS Politechnika Poznań,Sezon 2012/2013
2012-11-17 19:30,PBS BANK EFIR ENERGY MOSiR Krosno(d),67 : 85P,67,19,47,40.4,5,19,26.3,24,66,36.4,14,18,77.8,11,20,31,18,20,24,20,10,3,0,63,AZS Politechnika Poznań,Sezon 2012/2013
2012-11-24 17:00,KS Spójnia Stargard Szczeciński(w),97 : 79P,79,26,50,52.0,7,21,33.3,33,71,46.5,6,10,60.0,10,16,26,21,19,12,14,14,1,1,85,AZS Politechnika Poznań,Sezon 2012/2013
2012-12-01 19:30,Franz Astoria Bydgoszcz(d),81 : 98P,81,29,67,43.3,3,18,16.7,32,85,37.6,14,21,66.7,17,23,40,18,37,19,25,15,5,9,74,AZS Politechnika Poznań,Sezon 2012/2013
2012-12-05 19:15,WKS Śląsk Wrocław(w),107 : 61P,61,20,54,37.0,3,11,27.3,23,65,35.4,12,19,63.2,7,19,26,6,34,20,15,9,3,2,41,AZS Politechnika Poznań,Sezon 2012/2013
2012-12-08 18:00,BM SLAM STAL Ostrów Wielkopolski(d),72 : 104P,72,18,47,38.3,7,23,30.4,25,70,35.7,15,25,60.0,11,15,26,17,25,17,18,16,7,3,65,AZS Politechnika Poznań,Sezon 2012/2013
2012-12-15 18:00,WIKANA START SA Lublin(w),95 : 62P,62,17,44,38.6,7,30,23.3,24,74,32.4,7,11,63.6,13,20,33,14,18,17,17,7,4,1,49,AZS Politechnika Poznań,Sezon 2012/2013
2012-12-19 17:00,Siedlecki Klub Koszykówki Siedlce(d),77 : 74W,77,24,55,43.6,7,24,29.2,31,79,39.2,8,12,66.7,17,25,42,20,23,18,11,9,5,3,90,AZS Politechnika Poznań,Sezon 2012/2013
2013-01-06 18:00,NETO PTG Sokół Łańcut(d),51 : 66P,51,17,43,39.5,3,16,18.8,20,59,33.9,8,10,80.0,14,29,43,20,28,17,21,14,2,3,68,AZS Politechnika Poznań,Sezon 2012/2013
2013-01-09 18:00,MKS Dąbrowa Górnicza II(w),94 : 66P,66,22,52,42.3,3,13,23.1,25,65,38.5,13,13,100.0,11,20,31,14,16,12,25,5,4,0,55,AZS Politechnika Poznań,Sezon 2012/2013
2013-01-13 17:00,MKS Znicz Basket Pruszków(d),61 : 55W,61,20,45,44.4,4,21,19.0,24,66,36.4,9,13,69.2,17,25,42,15,21,17,12,10,5,1,75,AZS Politechnika Poznań,Sezon 2012/2013
2013-01-19 17:15,UMKS Kielce(w),82 : 76P,76,25,48,52.1,6,22,27.3,31,70,44.3,8,10,80.0,7,19,26,19,24,17,10,9,4,3,83,AZS Politechnika Poznań,Sezon 2012/2013
2013-01-30 17:30,BUDIMPEX-POLONIA Przemyśl(d),56 : 58P,56,23,56,41.1,2,13,15.4,25,69,36.2,4,8,50.0,13,22,35,12,19,17,8,6,4,2,57,AZS Politechnika Poznań,Sezon 2012/2013
2013-02-03 18:30,Polski Cukier SIDEn Toruń(w),77 : 68P,68,16,48,33.3,9,17,52.9,25,65,38.5,9,11,81.8,9,22,31,13,20,13,20,6,4,8,60,AZS Politechnika Poznań,Sezon 2012/2013
2013-02-10 17:30,AZS Radex Szczecin(d),58 : 62P,58,18,44,40.9,3,10,30.0,21,54,38.9,13,17,76.5,9,26,35,13,22,18,15,5,3,2,62,AZS Politechnika Poznań,Sezon 2012/2013
2013-02-16 18:00,PBS BANK EFIR ENERGY MOSiR Krosno(w),75 : 78W,78,19,43,44.2,11,24,45.8,30,67,44.8,7,18,38.9,14,25,39,16,25,21,16,8,2,1,79,AZS Politechnika Poznań,Sezon 2012/2013
2013-02-23 19:30,KS Spójnia Stargard Szczeciński(d),68 : 59W,68,21,48,43.8,4,17,23.5,25,65,38.5,14,21,66.7,15,28,43,11,29,23,14,8,3,1,72,AZS Politechnika Poznań,Sezon 2012/2013
2013-03-02 18:00,Franz Astoria Bydgoszcz(w),88 : 69P,69,26,59,44.1,2,16,12.5,28,75,37.3,11,19,57.9,23,14,37,12,22,23,17,12,0,4,58,AZS Politechnika Poznań,Sezon 2012/2013
2013-03-06 17:30,WKS Śląsk Wrocław(d),72 : 51W,72,27,53,50.9,3,14,21.4,30,67,44.8,9,12,75.0,13,29,42,22,19,14,16,15,2,4,97,AZS Politechnika Poznań,Sezon 2012/2013
2013-03-10 18:30,BM SLAM STAL Ostrów Wielkopolski(w),69 : 77W,77,19,42,45.2,8,21,38.1,27,63,42.9,15,25,60.0,10,22,32,16,23,23,17,10,2,4,74,AZS Politechnika Poznań,Sezon 2012/2013
2013-03-13 17:30,AZS WSGK POLFARMEX Kutno(d),68 : 61W,68,26,38,68.4,3,14,21.4,29,52,55.8,7,16,43.8,9,34,43,23,19,17,18,5,1,0,90,AZS Politechnika Poznań,Sezon 2012/2013
2013-03-17 18:30,WIKANA START SA Lublin(d),71 : 86P,71,23,43,53.5,6,22,27.3,29,65,44.6,7,15,46.7,15,20,35,16,20,19,15,7,4,2,74,AZS Politechnika Poznań,Sezon 2012/2013
2013-03-24 18:00,Siedlecki Klub Koszykówki Siedlce(w),68 : 94W,94,32,53,60.4,7,17,41.2,39,70,55.7,9,14,64.3,11,24,35,20,18,14,11,15,0,3,117,AZS Politechnika Poznań,Sezon 2012/2013
2013-04-06 20:00,Franz Astoria Bydgoszcz(w),72 : 68P,68,27,66,40.9,2,15,13.3,29,81,35.8,8,13,61.5,19,23,42,13,24,18,13,9,5,3,67,AZS Politechnika Poznań,Sezon 2012/2013
2013-04-07 18:00,Franz Astoria Bydgoszcz(w),59 : 60W,60,22,44,50.0,3,16,18.8,25,60,41.7,7,12,58.3,12,21,33,10,27,23,19,10,6,2,60,AZS Politechnika Poznań,Sezon 2012/2013
2013-04-13 20:30,Franz Astoria Bydgoszcz(d),77 : 66W,77,28,45,62.2,1,11,9.1,29,56,51.8,18,22,81.8,12,34,46,19,25,22,21,16,7,0,113,AZS Politechnika Poznań,Sezon 2012/2013
2013-04-14 20:00,Franz Astoria Bydgoszcz(d),74 : 73W,74,26,70,37.1,5,13,38.5,31,83,37.3,7,11,63.6,13,33,46,21,24,14,13,12,4,3,88,AZS Politechnika Poznań,Sezon 2012/2013
2012-09-29 18:00,WIKANA START SA Lublin(d),74 : 85P,68,23,37,62.2,4,19,21.1,27,56,48.2,10,11,90.9,12,18,30,17,21,16,15,3,2,0,75,AZS Radex Szczecin,Sezon 2012/2013
2012-10-03 18:00,Siedlecki Klub Koszykówki Siedlce(d),58 : 67P,58,18,35,51.4,3,16,18.8,21,51,41.2,13,18,72.2,8,22,30,15,24,24,14,5,3,0,62,AZS Radex Szczecin,Sezon 2012/2013
2012-10-06 15:00,NETO PTG Sokół Łańcut(w),70 : 67P,67,20,42,47.6,4,21,19.0,24,63,38.1,15,24,62.5,9,20,29,16,27,22,15,7,3,0,59,AZS Radex Szczecin,Sezon 2012/2013
2012-10-13 20:00,MKS Dąbrowa Górnicza II(d),70 : 65W,70,21,44,47.7,3,12,25.0,24,56,42.9,19,22,86.4,7,23,30,14,19,24,11,13,1,0,82,AZS Radex Szczecin,Sezon 2012/2013
2012-10-21 17:00,MKS Znicz Basket Pruszków(w),74 : 63P,63,16,37,43.2,7,19,36.8,23,56,41.1,10,16,62.5,11,25,36,8,26,19,21,8,1,0,56,AZS Radex Szczecin,Sezon 2012/2013
2012-10-27 18:00,UMKS Kielce(d),82 : 74W,82,20,41,48.8,9,25,36.0,29,66,43.9,15,16,93.8,10,17,27,23,22,23,12,8,1,0,91,AZS Radex Szczecin,Sezon 2012/2013
2012-11-03 17:30,AZS WSGK POLFARMEX Kutno(w),67 : 36P,36,12,30,40.0,0,11,0.0,12,41,29.3,12,22,54.5,6,15,21,3,21,25,22,9,3,3,11,AZS Radex Szczecin,Sezon 2012/2013
2012-11-10 20:00,AZS Politechnika Poznań(d),70 : 63W,70,23,41,56.1,6,23,26.1,29,64,45.3,6,8,75.0,10,24,34,16,13,17,11,4,5,2,81,AZS Radex Szczecin,Sezon 2012/2013
2012-11-17 18:30,Polski Cukier SIDEn Toruń(w),72 : 79W,79,20,45,44.4,7,16,43.8,27,61,44.3,18,25,72.0,15,20,35,10,23,28,16,8,1,3,76,AZS Radex Szczecin,Sezon 2012/2013
2012-11-25 14:30,BUDIMPEX-POLONIA Przemyśl(w),75 : 93W,93,28,50,56.0,8,16,50.0,36,66,54.5,13,14,92.9,11,21,32,13,19,14,9,7,1,5,106,AZS Radex Szczecin,Sezon 2012/2013
2012-12-02 20:00,PBS BANK EFIR ENERGY MOSiR Krosno(d),76 : 78P,76,26,49,53.1,5,16,31.3,31,65,47.7,9,11,81.8,9,22,31,14,20,18,10,6,2,1,83,AZS Radex Szczecin,Sezon 2012/2013
2012-12-05 18:00,KS Spójnia Stargard Szczeciński(w),74 : 61P,61,15,41,36.6,5,12,41.7,20,53,37.7,16,17,94.1,4,26,30,10,22,21,16,7,4,2,62,AZS Radex Szczecin,Sezon 2012/2013
2012-12-08 16:00,Franz Astoria Bydgoszcz(d),93 : 88W,93,22,45,48.9,7,19,36.8,29,64,45.3,28,42,66.7,12,21,33,18,21,28,15,12,7,1,99,AZS Radex Szczecin,Sezon 2012/2013
2012-12-16 14:00,WKS Śląsk Wrocław(w),77 : 57P,57,18,47,38.3,4,9,44.4,22,56,39.3,9,13,69.2,7,14,21,8,24,17,7,7,1,1,49,AZS Radex Szczecin,Sezon 2012/2013
2012-12-19 18:00,BM SLAM STAL Ostrów Wielkopolski(d),75 : 95P,75,23,40,57.5,7,22,31.8,30,62,48.4,8,9,88.9,8,20,28,21,24,15,19,4,4,4,80,AZS Radex Szczecin,Sezon 2012/2013
2013-01-06 18:00,WIKANA START SA Lublin(w),84 : 82P,82,26,43,60.5,8,23,34.8,34,66,51.5,6,13,46.2,12,16,28,15,22,14,7,5,4,1,88,AZS Radex Szczecin,Sezon 2012/2013
2013-01-09 18:00,Siedlecki Klub Koszykówki Siedlce(w),68 : 77W,77,25,42,59.5,4,19,21.1,29,61,47.5,15,21,71.4,7,23,30,10,18,20,4,6,2,2,83,AZS Radex Szczecin,Sezon 2012/2013
2013-01-13 18:30,NETO PTG Sokół Łańcut(d),82 : 61W,82,30,49,61.2,4,11,36.4,34,60,56.7,10,16,62.5,9,28,37,20,25,19,14,7,4,3,104,AZS Radex Szczecin,Sezon 2012/2013
2013-01-19 17:00,MKS Dąbrowa Górnicza II(w),84 : 77P,77,25,58,43.1,5,18,27.8,30,76,39.5,12,16,75.0,10,28,38,8,26,16,10,4,2,0,69,AZS Radex Szczecin,Sezon 2012/2013
2013-01-26 19:30,MKS Znicz Basket Pruszków(d),81 : 92P,81,18,41,43.9,7,26,26.9,25,67,37.3,24,27,88.9,9,24,33,19,29,24,15,11,1,1,85,AZS Radex Szczecin,Sezon 2012/2013
2013-01-30 19:45,UMKS Kielce(w),66 : 84W,84,28,44,63.6,5,13,38.5,33,57,57.9,13,16,81.3,9,25,34,18,15,18,8,8,1,2,110,AZS Radex Szczecin,Sezon 2012/2013
2013-02-03 18:00,AZS WSGK POLFARMEX Kutno(d),68 : 65W,68,20,40,50.0,7,19,36.8,27,59,45.8,7,9,77.8,7,28,35,18,19,12,17,8,2,2,80,AZS Radex Szczecin,Sezon 2012/2013
2013-02-10 17:30,AZS Politechnika Poznań(w),58 : 62W,62,17,42,40.5,6,19,31.6,23,61,37.7,10,17,58.8,15,22,37,12,18,22,11,7,2,3,64,AZS Radex Szczecin,Sezon 2012/2013
2013-02-16 18:00,Polski Cukier SIDEn Toruń(d),81 : 76W,81,23,46,50.0,7,19,36.8,30,65,46.2,14,15,93.3,7,25,32,17,24,17,10,10,4,2,98,AZS Radex Szczecin,Sezon 2012/2013
2013-02-24 18:00,BUDIMPEX-POLONIA Przemyśl(d),80 : 69W,80,21,41,51.2,7,15,46.7,28,56,50.0,17,19,89.5,11,27,38,19,19,20,14,7,2,1,102,AZS Radex Szczecin,Sezon 2012/2013
2013-03-02 18:00,PBS BANK EFIR ENERGY MOSiR Krosno(w),67 : 61P,61,16,39,41.0,4,20,20.0,20,59,33.9,17,22,77.3,16,23,39,13,22,22,14,5,1,2,61,AZS Radex Szczecin,Sezon 2012/2013
2013-03-06 18:00,KS Spójnia Stargard Szczeciński(d),98 : 73W,98,21,33,63.6,12,21,57.1,33,54,61.1,20,21,95.2,5,33,38,29,21,22,12,6,2,0,139,AZS Radex Szczecin,Sezon 2012/2013
2013-03-10 17:00,Franz Astoria Bydgoszcz(w),83 : 80P,80,26,47,55.3,6,16,37.5,32,63,50.8,10,14,71.4,9,24,33,13,24,15,14,7,0,1,84,AZS Radex Szczecin,Sezon 2012/2013
2013-03-16 18:00,WKS Śląsk Wrocław(d),86 : 81W,86,23,46,50.0,7,16,43.8,30,62,48.4,19,23,82.6,9,26,35,23,25,20,9,7,2,0,108,AZS Radex Szczecin,Sezon 2012/2013
2013-03-24 18:00,BM SLAM STAL Ostrów Wielkopolski(w),78 : 75P,75,15,32,46.9,11,27,40.7,26,59,44.1,12,19,63.2,7,30,37,16,27,20,15,5,2,3,80,AZS Radex Szczecin,Sezon 2012/2013
2012-09-29 18:00,MKS Dąbrowa Górnicza II(w),80 : 77P,77,17,34,50.0,7,20,35.0,24,54,44.4,22,27,81.5,3,27,30,14,31,24,13,6,1,0,80,AZS WSGK POLFARMEX Kutno,Sezon 2012/2013
2012-10-03 18:00,MKS Znicz Basket Pruszków(d),80 : 74W,80,22,36,61.1,6,29,20.7,28,65,43.1,18,30,60.0,13,26,39,13,31,27,10,10,4,0,87,AZS WSGK POLFARMEX Kutno,Sezon 2012/2013
2012-10-06 17:00,UMKS Kielce(w),65 : 89W,89,25,45,55.6,9,29,31.0,34,74,45.9,12,17,70.6,13,27,40,22,25,22,10,11,2,0,109,AZS WSGK POLFARMEX Kutno,Sezon 2012/2013
2012-10-13 18:00,BUDIMPEX-POLONIA Przemyśl(w),58 : 85W,85,24,46,52.2,8,24,33.3,32,70,45.7,13,14,92.9,16,18,34,14,21,18,10,10,1,6,95,AZS WSGK POLFARMEX Kutno,Sezon 2012/2013
2012-10-20 17:30,AZS Politechnika Poznań(d),81 : 67W,81,23,37,62.2,6,23,26.1,29,60,48.3,17,21,81.0,9,29,38,19,21,18,17,11,6,1,103,AZS WSGK POLFARMEX Kutno,Sezon 2012/2013
2012-10-28 18:30,Polski Cukier SIDEn Toruń(w),68 : 67P,67,20,40,50.0,5,22,22.7,25,62,40.3,12,21,57.1,8,18,26,11,25,21,11,7,3,4,57,AZS WSGK POLFARMEX Kutno,Sezon 2012/2013
2012-11-03 17:30,AZS Radex Szczecin(d),67 : 36W,67,21,39,53.8,5,14,35.7,26,53,49.1,10,21,47.6,10,21,31,14,25,21,17,12,3,3,72,AZS WSGK POLFARMEX Kutno,Sezon 2012/2013
2012-11-10 18:00,PBS BANK EFIR ENERGY MOSiR Krosno(w),78 : 87W,87,23,41,56.1,7,19,36.8,30,60,50.0,20,28,71.4,11,25,36,10,23,24,16,7,2,2,88,AZS WSGK POLFARMEX Kutno,Sezon 2012/2013
2012-11-17 17:30,KS Spójnia Stargard Szczeciński(d),58 : 54W,58,15,29,51.7,5,23,21.7,20,52,38.5,13,18,72.2,10,24,34,11,20,20,14,7,4,0,63,AZS WSGK POLFARMEX Kutno,Sezon 2012/2013
2012-11-24 19:00,Franz Astoria Bydgoszcz(w),81 : 85W,85,19,39,48.7,8,19,42.1,27,58,46.6,23,30,76.7,10,24,34,15,34,24,26,12,3,2,85,AZS WSGK POLFARMEX Kutno,Sezon 2012/2013
2012-12-01 17:30,WKS Śląsk Wrocław(d),55 : 96P,55,12,32,37.5,4,19,21.1,16,51,31.4,19,29,65.5,12,14,26,10,25,26,11,8,1,0,44,AZS WSGK POLFARMEX Kutno,Sezon 2012/2013
2012-12-05 18:30,BM SLAM STAL Ostrów Wielkopolski(w),70 : 77W,77,21,37,56.8,8,25,32.0,29,62,46.8,11,17,64.7,11,26,37,12,24,20,21,7,3,2,76,AZS WSGK POLFARMEX Kutno,Sezon 2012/2013
2012-12-08 17:30,WIKANA START SA Lublin(d),89 : 59W,89,29,39,74.4,7,19,36.8,36,58,62.1,10,17,58.8,10,23,33,18,17,15,12,11,2,0,112,AZS WSGK POLFARMEX Kutno,Sezon 2012/2013
2012-12-16 17:00,Siedlecki Klub Koszykówki Siedlce(w),58 : 70W,70,15,41,36.6,11,23,47.8,26,64,40.6,7,9,77.8,8,21,29,16,20,15,9,10,1,2,77,AZS WSGK POLFARMEX Kutno,Sezon 2012/2013
2012-12-19 18:00,NETO PTG Sokół Łańcut(d),80 : 85P,80,26,47,55.3,3,29,10.3,29,76,38.2,19,26,73.1,17,25,42,15,37,22,17,10,1,2,77,AZS WSGK POLFARMEX Kutno,Sezon 2012/2013
2013-01-05 17:30,MKS Dąbrowa Górnicza II(d),75 : 73W,75,20,33,60.6,6,14,42.9,26,47,55.3,17,25,68.0,3,29,32,10,25,20,17,6,1,1,78,AZS WSGK POLFARMEX Kutno,Sezon 2012/2013
2013-01-09 19:00,MKS Znicz Basket Pruszków(w),73 : 75W,75,16,41,39.0,8,23,34.8,24,64,37.5,19,30,63.3,17,20,37,14,22,23,15,9,2,3,71,AZS WSGK POLFARMEX Kutno,Sezon 2012/2013
2013-01-12 17:30,UMKS Kielce(d),77 : 51W,77,19,31,61.3,7,25,28.0,26,56,46.4,18,21,85.7,5,28,33,16,15,16,12,6,3,2,90,AZS WSGK POLFARMEX Kutno,Sezon 2012/2013
2013-01-19 17:30,BUDIMPEX-POLONIA Przemyśl(d),79 : 58W,79,22,37,59.5,9,20,45.0,31,57,54.4,8,13,61.5,11,23,34,15,14,19,6,7,0,0,98,AZS WSGK POLFARMEX Kutno,Sezon 2012/2013
2013-01-30 18:00,Polski Cukier SIDEn Toruń(d),74 : 67W,74,14,35,40.0,12,26,46.2,26,61,42.6,10,12,83.3,13,28,41,10,19,16,8,4,2,1,86,AZS WSGK POLFARMEX Kutno,Sezon 2012/2013
2013-02-03 18:00,AZS Radex Szczecin(w),68 : 65P,65,21,43,48.8,5,19,26.3,26,62,41.9,8,18,44.4,10,20,30,14,12,19,12,7,2,2,60,AZS WSGK POLFARMEX Kutno,Sezon 2012/2013
2013-02-09 17:30,PBS BANK EFIR ENERGY MOSiR Krosno(d),72 : 76P,72,9,25,36.0,15,36,41.7,24,61,39.3,9,14,64.3,8,26,34,16,20,18,11,9,5,0,83,AZS WSGK POLFARMEX Kutno,Sezon 2012/2013
2013-02-16 17:00,KS Spójnia Stargard Szczeciński(w),79 : 76P,76,18,29,62.1,8,22,36.4,26,51,51.0,16,24,66.7,6,28,34,17,23,19,15,5,2,1,86,AZS WSGK POLFARMEX Kutno,Sezon 2012/2013
2013-02-23 17:30,Franz Astoria Bydgoszcz(d),93 : 84W,93,19,42,45.2,12,32,37.5,31,74,41.9,19,21,90.5,16,25,41,18,17,18,9,10,2,3,110,AZS WSGK POLFARMEX Kutno,Sezon 2012/2013
2013-03-03 18:15,WKS Śląsk Wrocław(w),91 : 67P,67,19,37,51.4,7,23,30.4,26,60,43.3,8,12,66.7,6,24,30,11,19,16,12,7,1,2,66,AZS WSGK POLFARMEX Kutno,Sezon 2012/2013
2013-03-06 18:00,BM SLAM STAL Ostrów Wielkopolski(d),74 : 66W,74,23,40,57.5,5,24,20.8,28,64,43.8,13,16,81.3,9,23,32,15,23,17,4,8,4,2,90,AZS WSGK POLFARMEX Kutno,Sezon 2012/2013
2013-03-10 19:00,WIKANA START SA Lublin(w),63 : 73W,73,16,41,39.0,13,30,43.3,29,71,40.8,2,4,50.0,10,29,39,13,17,13,8,8,2,2,83,AZS WSGK POLFARMEX Kutno,Sezon 2012/2013
2013-03-13 17:30,AZS Politechnika Poznań(w),68 : 61P,61,13,31,41.9,10,35,28.6,23,66,34.8,5,13,38.5,12,18,30,19,17,19,12,13,2,0,62,AZS WSGK POLFARMEX Kutno,Sezon 2012/2013
2013-03-16 17:30,Siedlecki Klub Koszykówki Siedlce(d),64 : 52W,64,21,40,52.5,7,22,31.8,28,62,45.2,1,1,100.0,10,29,39,16,24,13,14,9,10,3,90,AZS WSGK POLFARMEX Kutno,Sezon 2012/2013
2013-03-24 18:00,NETO PTG Sokół Łańcut(w),90 : 87P,87,20,53,37.7,11,32,34.4,31,85,36.5,14,26,53.8,21,22,43,16,20,25,15,11,1,6,77,AZS WSGK POLFARMEX Kutno,Sezon 2012/2013
2013-04-06 17:30,KS Spójnia Stargard Szczeciński(d),69 : 55W,69,19,36,52.8,8,22,36.4,27,58,46.6,7,10,70.0,5,33,38,13,20,17,13,3,5,0,81,AZS WSGK POLFARMEX Kutno,Sezon 2012/2013
2013-04-07 17:30,KS Spójnia Stargard Szczeciński(d),77 : 63W,77,14,32,43.8,13,22,59.1,27,54,50.0,10,15,66.7,5,29,34,18,18,18,12,4,5,4,94,AZS WSGK POLFARMEX Kutno,Sezon 2012/2013
2013-04-13 17:00,KS Spójnia Stargard Szczeciński(w),79 : 80W,80,21,40,52.5,11,22,50.0,32,62,51.6,5,14,35.7,8,22,30,17,14,17,11,5,2,0,84,AZS WSGK POLFARMEX Kutno,Sezon 2012/2013
2013-04-20 17:30,PBS BANK EFIR ENERGY MOSiR Krosno(d),79 : 84P,79,21,43,48.8,9,28,32.1,30,71,42.3,10,14,71.4,9,22,31,15,15,18,10,9,1,0,80,AZS WSGK POLFARMEX Kutno,Sezon 2012/2013
2013-04-21 17:30,PBS BANK EFIR ENERGY MOSiR Krosno(d),61 : 66P,61,18,38,47.4,5,19,26.3,23,57,40.4,10,18,55.6,12,20,32,15,17,19,9,5,3,0,65,AZS WSGK POLFARMEX Kutno,Sezon 2012/2013
2013-04-27 18:00,PBS BANK EFIR ENERGY MOSiR Krosno(w),61 : 76W,76,24,43,55.8,7,26,26.9,31,69,44.9,7,12,58.3,7,29,36,19,23,16,8,10,3,2,93,AZS WSGK POLFARMEX Kutno,Sezon 2012/2013
2013-04-28 18:00,PBS BANK EFIR ENERGY MOSiR Krosno(w),93 : 89P,89,14,35,40.0,17,33,51.5,31,68,45.6,10,14,71.4,5,17,22,18,25,21,8,6,0,1,86,AZS WSGK POLFARMEX Kutno,Sezon 2012/2013
2013-05-04 18:00,Polski Cukier SIDEn Toruń(w),73 : 73P,73,19,46,41.3,9,25,36.0,28,71,39.4,8,14,57.1,6,17,23,17,21,15,7,17,1,4,75,AZS WSGK POLFARMEX Kutno,Sezon 2012/2013
2013-05-11 17:30,Polski Cukier SIDEn Toruń(d),84 : 81W,84,16,35,45.7,12,24,50.0,28,59,47.5,16,21,76.2,3,21,24,22,19,18,9,9,1,4,95,AZS WSGK POLFARMEX Kutno,Sezon 2012/2013
2012-09-29 18:30,PBS BANK EFIR ENERGY MOSiR Krosno(d),80 : 66W,80,21,44,47.7,8,27,29.6,29,71,40.8,14,25,56.0,19,30,49,14,23,29,11,4,1,0,84,BM SLAM STAL Ostrów Wielkopolski,Sezon 2012/2013
2012-10-03 18:00,KS Spójnia Stargard Szczeciński(w),51 : 75W,75,19,40,47.5,8,19,42.1,27,59,45.8,13,14,92.9,8,24,32,15,17,16,13,5,2,0,83,BM SLAM STAL Ostrów Wielkopolski,Sezon 2012/2013
2012-10-07 18:30,Franz Astoria Bydgoszcz(d),76 : 71W,76,20,43,46.5,5,19,26.3,25,62,40.3,21,32,65.6,16,25,41,17,18,28,14,11,1,0,84,BM SLAM STAL Ostrów Wielkopolski,Sezon 2012/2013
2012-10-14 15:00,WKS Śląsk Wrocław(w),88 : 72P,72,20,36,55.6,6,18,33.3,26,54,48.1,14,19,73.7,7,21,28,13,24,23,19,10,1,0,72,BM SLAM STAL Ostrów Wielkopolski,Sezon 2012/2013
2012-10-20 18:30,BUDIMPEX-POLONIA Przemyśl(d),80 : 92P,80,24,57,42.1,5,21,23.8,29,78,37.2,17,26,65.4,14,23,37,13,22,20,11,8,1,3,70,BM SLAM STAL Ostrów Wielkopolski,Sezon 2012/2013
2012-10-27 18:30,WIKANA START SA Lublin(d),88 : 65W,88,20,34,58.8,10,23,43.5,30,57,52.6,18,26,69.2,12,21,33,21,26,24,18,10,1,3,100,BM SLAM STAL Ostrów Wielkopolski,Sezon 2012/2013
2012-11-03 18:00,Siedlecki Klub Koszykówki Siedlce(w),64 : 97W,97,27,41,65.9,9,17,52.9,36,58,62.1,16,20,80.0,4,24,28,19,21,29,11,7,3,0,117,BM SLAM STAL Ostrów Wielkopolski,Sezon 2012/2013
2012-11-10 18:30,NETO PTG Sokół Łańcut(d),72 : 63W,72,17,38,44.7,6,19,31.6,23,57,40.4,20,32,62.5,12,22,34,15,19,29,14,10,3,2,74,BM SLAM STAL Ostrów Wielkopolski,Sezon 2012/2013
2012-11-17 18:00,MKS Dąbrowa Górnicza II(w),72 : 83W,83,17,34,50.0,10,25,40.0,27,59,45.8,19,36,52.8,9,33,42,14,18,25,10,7,2,0,89,BM SLAM STAL Ostrów Wielkopolski,Sezon 2012/2013
2012-11-24 18:30,MKS Znicz Basket Pruszków(d),70 : 81P,70,21,46,45.7,6,23,26.1,27,69,39.1,10,12,83.3,15,21,36,17,19,15,21,8,2,4,68,BM SLAM STAL Ostrów Wielkopolski,Sezon 2012/2013
2012-12-01 18:30,UMKS Kielce(w),68 : 77W,77,18,37,48.6,8,18,44.4,26,55,47.3,17,25,68.0,3,27,30,15,21,24,16,11,1,3,81,BM SLAM STAL Ostrów Wielkopolski,Sezon 2012/2013
2012-12-05 18:30,AZS WSGK POLFARMEX Kutno(d),70 : 77P,70,22,40,55.0,5,25,20.0,27,65,41.5,11,16,68.8,11,24,35,13,20,24,13,12,2,3,76,BM SLAM STAL Ostrów Wielkopolski,Sezon 2012/2013
2012-12-08 18:00,AZS Politechnika Poznań(w),72 : 104W,104,32,50,64.0,7,19,36.8,39,69,56.5,19,27,70.4,17,33,50,26,18,24,24,13,3,7,134,BM SLAM STAL Ostrów Wielkopolski,Sezon 2012/2013
2012-12-15 18:30,Polski Cukier SIDEn Toruń(d),76 : 69W,76,24,48,50.0,7,24,29.2,31,72,43.1,7,13,53.8,11,25,36,19,22,20,12,7,1,2,80,BM SLAM STAL Ostrów Wielkopolski,Sezon 2012/2013
2012-12-19 18:00,AZS Radex Szczecin(w),75 : 95W,95,28,48,58.3,4,14,28.6,32,62,51.6,27,33,81.8,9,18,27,13,16,24,8,10,4,4,105,BM SLAM STAL Ostrów Wielkopolski,Sezon 2012/2013
2013-01-06 18:00,PBS BANK EFIR ENERGY MOSiR Krosno(w),78 : 69P,69,17,44,38.6,7,17,41.2,24,61,39.3,14,21,66.7,11,19,30,11,20,21,13,6,0,2,59,BM SLAM STAL Ostrów Wielkopolski,Sezon 2012/2013
2013-01-09 18:30,KS Spójnia Stargard Szczeciński(d),72 : 74P,72,17,46,37.0,8,24,33.3,25,70,35.7,14,20,70.0,13,26,39,11,26,23,16,7,2,3,64,BM SLAM STAL Ostrów Wielkopolski,Sezon 2012/2013
2013-01-13 16:00,Franz Astoria Bydgoszcz(w),82 : 75P,75,23,47,48.9,3,14,21.4,26,61,42.6,20,24,83.3,9,20,29,7,25,21,12,9,2,2,71,BM SLAM STAL Ostrów Wielkopolski,Sezon 2012/2013
2013-01-19 18:30,WKS Śląsk Wrocław(d),64 : 87P,64,15,37,40.5,5,16,31.3,20,53,37.7,19,24,79.2,10,19,29,12,16,22,18,6,2,2,57,BM SLAM STAL Ostrów Wielkopolski,Sezon 2012/2013
2013-01-27 18:00,BUDIMPEX-POLONIA Przemyśl(w),79 : 70P,70,19,47,40.4,5,21,23.8,24,68,35.3,17,20,85.0,13,21,34,12,24,21,16,4,2,7,59,BM SLAM STAL Ostrów Wielkopolski,Sezon 2012/2013
2013-01-30 18:00,WIKANA START SA Lublin(w),79 : 56P,56,18,36,50.0,6,24,25.0,24,60,40.0,2,6,33.3,8,19,27,8,27,14,15,6,4,1,46,BM SLAM STAL Ostrów Wielkopolski,Sezon 2012/2013
2013-02-03 18:30,Siedlecki Klub Koszykówki Siedlce(d),80 : 74W,80,24,48,50.0,7,19,36.8,31,67,46.3,11,16,68.8,12,23,35,16,18,18,11,8,3,0,90,BM SLAM STAL Ostrów Wielkopolski,Sezon 2012/2013
2013-02-09 18:00,NETO PTG Sokół Łańcut(w),88 : 85P,85,21,44,47.7,12,23,52.2,33,67,49.3,7,10,70.0,11,22,33,15,26,13,15,6,2,0,89,BM SLAM STAL Ostrów Wielkopolski,Sezon 2012/2013
2013-02-16 18:30,MKS Dąbrowa Górnicza II(d),95 : 91W,95,31,54,57.4,4,19,21.1,35,73,47.9,21,28,75.0,10,22,32,18,25,24,9,13,2,0,106,BM SLAM STAL Ostrów Wielkopolski,Sezon 2012/2013
2013-02-23 18:00,MKS Znicz Basket Pruszków(w),82 : 74P,74,26,44,59.1,5,23,21.7,31,67,46.3,7,12,58.3,15,17,32,13,20,15,15,6,2,4,71,BM SLAM STAL Ostrów Wielkopolski,Sezon 2012/2013
2013-03-02 18:30,UMKS Kielce(d),88 : 54W,88,28,47,59.6,5,18,27.8,33,65,50.8,17,22,77.3,14,27,41,17,20,16,16,10,2,0,105,BM SLAM STAL Ostrów Wielkopolski,Sezon 2012/2013
2013-03-06 18:00,AZS WSGK POLFARMEX Kutno(w),74 : 66P,66,16,40,40.0,6,17,35.3,22,57,38.6,16,26,61.5,11,26,37,9,17,23,15,2,2,4,56,BM SLAM STAL Ostrów Wielkopolski,Sezon 2012/2013
2013-03-10 18:30,AZS Politechnika Poznań(d),69 : 77P,69,20,38,52.6,5,23,21.7,25,61,41.0,14,16,87.5,10,24,34,14,23,23,18,11,4,2,76,BM SLAM STAL Ostrów Wielkopolski,Sezon 2012/2013
2013-03-17 19:30,Polski Cukier SIDEn Toruń(w),86 : 70P,70,25,52,48.1,4,14,28.6,29,66,43.9,8,9,88.9,10,18,28,12,24,15,15,9,2,3,68,BM SLAM STAL Ostrów Wielkopolski,Sezon 2012/2013
2013-03-24 18:00,AZS Radex Szczecin(d),78 : 75W,78,24,51,47.1,3,17,17.6,27,68,39.7,21,27,77.8,9,23,32,10,20,27,6,4,3,2,74,BM SLAM STAL Ostrów Wielkopolski,Sezon 2012/2013
2012-09-29 19:00,Franz Astoria Bydgoszcz(w),60 : 68W,68,16,39,41.0,6,22,27.3,22,61,36.1,18,28,64.3,15,31,46,13,15,24,18,6,4,0,70,BUDIMPEX-POLONIA Przemyśl,Sezon 2012/2013
2012-10-03 18:00,UMKS Kielce(d),64 : 65P,64,20,36,55.6,4,21,19.0,24,57,42.1,12,18,66.7,11,24,35,14,16,17,16,10,7,0,75,BUDIMPEX-POLONIA Przemyśl,Sezon 2012/2013
2012-10-06 19:15,WKS Śląsk Wrocław(w),75 : 66P,66,19,39,48.7,7,20,35.0,26,59,44.1,7,10,70.0,5,24,29,13,24,18,12,21,1,0,82,BUDIMPEX-POLONIA Przemyśl,Sezon 2012/2013
2012-10-13 18:00,AZS WSGK POLFARMEX Kutno(d),58 : 85P,58,14,29,48.3,6,19,31.6,20,48,41.7,12,13,92.3,9,17,26,15,18,21,22,6,6,1,60,BUDIMPEX-POLONIA Przemyśl,Sezon 2012/2013
2012-10-20 18:30,BM SLAM STAL Ostrów Wielkopolski(w),80 : 92W,92,19,34,55.9,10,24,41.7,29,58,50.0,24,30,80.0,5,31,36,15,20,22,15,9,3,1,105,BUDIMPEX-POLONIA Przemyśl,Sezon 2012/2013
2012-10-27 18:00,AZS Politechnika Poznań(d),92 : 76W,92,22,31,71.0,9,15,60.0,31,46,67.4,21,25,84.0,1,31,32,25,16,27,24,9,7,2,122,BUDIMPEX-POLONIA Przemyśl,Sezon 2012/2013
2012-11-04 18:00,WIKANA START SA Lublin(w),92 : 61P,61,16,39,41.0,9,21,42.9,25,60,41.7,2,5,40.0,8,21,29,12,25,15,17,5,1,1,53,BUDIMPEX-POLONIA Przemyśl,Sezon 2012/2013
2012-11-11 17:00,Polski Cukier SIDEn Toruń(d),80 : 74W,80,23,46,50.0,8,19,42.1,31,65,47.7,10,12,83.3,5,32,37,17,19,15,9,4,5,4,98,BUDIMPEX-POLONIA Przemyśl,Sezon 2012/2013
2012-11-17 18:00,Siedlecki Klub Koszykówki Siedlce(w),50 : 59W,59,17,42,40.5,4,12,33.3,21,54,38.9,13,17,76.5,5,35,40,4,16,16,9,3,4,1,64,BUDIMPEX-POLONIA Przemyśl,Sezon 2012/2013
2012-11-25 14:30,AZS Radex Szczecin(d),75 : 93P,75,23,45,51.1,3,10,30.0,26,55,47.3,20,25,80.0,8,19,27,13,15,19,11,5,5,1,80,BUDIMPEX-POLONIA Przemyśl,Sezon 2012/2013
2012-12-01 18:00,NETO PTG Sokół Łańcut(w),65 : 60P,60,15,37,40.5,6,18,33.3,21,55,38.2,12,19,63.2,7,27,34,5,20,20,16,8,1,4,51,BUDIMPEX-POLONIA Przemyśl,Sezon 2012/2013
2012-12-05 18:00,PBS BANK EFIR ENERGY MOSiR Krosno(d),95 : 79W,95,25,41,61.0,9,21,42.9,34,62,54.8,18,22,81.8,9,21,30,19,21,21,12,7,3,1,110,BUDIMPEX-POLONIA Przemyśl,Sezon 2012/2013
2012-12-08 18:00,MKS Dąbrowa Górnicza II(d),69 : 82P,69,23,42,54.8,3,21,14.3,26,63,41.3,14,19,73.7,11,25,36,9,21,19,11,4,1,3,66,BUDIMPEX-POLONIA Przemyśl,Sezon 2012/2013
2012-12-11 18:00,KS Spójnia Stargard Szczeciński(d),74 : 56W,74,25,46,54.3,5,15,33.3,30,61,49.2,9,13,69.2,9,29,38,15,17,17,13,10,5,4,94,BUDIMPEX-POLONIA Przemyśl,Sezon 2012/2013
2012-12-19 19:00,MKS Znicz Basket Pruszków(w),75 : 61P,61,12,47,25.5,7,18,38.9,19,65,29.2,16,19,84.2,10,27,37,11,22,21,12,6,6,6,60,BUDIMPEX-POLONIA Przemyśl,Sezon 2012/2013
2013-01-06 17:00,Franz Astoria Bydgoszcz(d),94 : 75W,94,25,45,55.6,8,18,44.4,33,63,52.4,20,25,80.0,8,21,29,21,22,20,11,12,5,0,115,BUDIMPEX-POLONIA Przemyśl,Sezon 2012/2013
2013-01-09 19:30,UMKS Kielce(w),73 : 77W,77,19,38,50.0,5,18,27.8,24,56,42.9,24,25,96.0,7,23,30,13,16,18,15,7,1,0,80,BUDIMPEX-POLONIA Przemyśl,Sezon 2012/2013
2013-01-12 18:00,WKS Śląsk Wrocław(d),72 : 86P,72,23,42,54.8,5,17,29.4,28,59,47.5,11,15,73.3,3,19,22,16,17,21,11,8,4,1,76,BUDIMPEX-POLONIA Przemyśl,Sezon 2012/2013
2013-01-19 17:30,AZS WSGK POLFARMEX Kutno(w),79 : 58P,58,16,31,51.6,7,20,35.0,23,51,45.1,5,10,50.0,5,15,20,11,19,13,9,2,0,0,49,BUDIMPEX-POLONIA Przemyśl,Sezon 2012/2013
2013-01-27 18:00,BM SLAM STAL Ostrów Wielkopolski(d),79 : 70W,79,21,38,55.3,4,15,26.7,25,53,47.2,25,27,92.6,3,23,26,16,22,22,15,5,7,2,88,BUDIMPEX-POLONIA Przemyśl,Sezon 2012/2013
2013-01-30 17:30,AZS Politechnika Poznań(w),56 : 58W,58,11,33,33.3,9,22,40.9,20,55,36.4,9,10,90.0,5,29,34,15,17,19,18,6,2,4,61,BUDIMPEX-POLONIA Przemyśl,Sezon 2012/2013
2013-02-03 17:00,WIKANA START SA Lublin(d),85 : 98P,85,27,38,71.1,6,14,42.9,33,52,63.5,13,16,81.3,4,18,22,14,16,19,13,3,4,1,93,BUDIMPEX-POLONIA Przemyśl,Sezon 2012/2013
2013-02-09 18:30,Polski Cukier SIDEn Toruń(w),77 : 79W,79,20,46,43.5,10,17,58.8,30,63,47.6,9,12,75.0,2,25,27,15,22,19,14,5,1,7,77,BUDIMPEX-POLONIA Przemyśl,Sezon 2012/2013
2013-02-16 18:00,Siedlecki Klub Koszykówki Siedlce(d),60 : 72P,60,18,39,46.2,4,19,21.1,22,58,37.9,12,15,80.0,4,20,24,13,17,19,11,4,3,2,54,BUDIMPEX-POLONIA Przemyśl,Sezon 2012/2013
2013-02-24 18:00,AZS Radex Szczecin(w),80 : 69P,69,16,36,44.4,6,20,30.0,22,56,39.3,19,24,79.2,6,17,23,13,20,19,10,7,1,2,64,BUDIMPEX-POLONIA Przemyśl,Sezon 2012/2013
2013-02-26 18:00,KS Spójnia Stargard Szczeciński(w),64 : 56P,56,14,38,36.8,6,17,35.3,20,55,36.4,10,13,76.9,10,23,33,11,21,20,18,2,3,0,49,BUDIMPEX-POLONIA Przemyśl,Sezon 2012/2013
2013-03-02 18:00,NETO PTG Sokół Łańcut(d),77 : 68W,77,22,40,55.0,7,18,38.9,29,58,50.0,12,14,85.7,3,28,31,18,21,21,12,5,1,2,89,BUDIMPEX-POLONIA Przemyśl,Sezon 2012/2013
2013-03-06 18:00,PBS BANK EFIR ENERGY MOSiR Krosno(w),85 : 73P,73,18,34,52.9,8,22,36.4,26,56,46.4,13,17,76.5,7,21,28,13,17,21,17,7,2,2,72,BUDIMPEX-POLONIA Przemyśl,Sezon 2012/2013
2013-03-09 18:00,MKS Dąbrowa Górnicza II(w),72 : 64P,64,21,42,50.0,3,12,25.0,24,54,44.4,13,18,72.2,6,18,24,8,15,21,16,7,3,4,55,BUDIMPEX-POLONIA Przemyśl,Sezon 2012/2013
2013-03-24 18:00,MKS Znicz Basket Pruszków(d),52 : 51W,52,12,36,33.3,2,27,7.4,14,63,22.2,22,28,78.6,12,26,38,6,18,25,11,12,4,2,46,BUDIMPEX-POLONIA Przemyśl,Sezon 2012/2013
2013-04-06 18:00,Siedlecki Klub Koszykówki Siedlce(d),68 : 54W,68,20,40,50.0,5,17,29.4,25,57,43.9,13,17,76.5,4,26,30,17,15,18,12,7,4,2,78,BUDIMPEX-POLONIA Przemyśl,Sezon 2012/2013
2013-04-07 17:00,Siedlecki Klub Koszykówki Siedlce(d),65 : 62W,65,13,39,33.3,5,20,25.0,18,59,30.5,24,28,85.7,10,25,35,11,14,25,10,6,4,2,66,BUDIMPEX-POLONIA Przemyśl,Sezon 2012/2013
2013-04-13 18:00,Siedlecki Klub Koszykówki Siedlce(w),62 : 70W,70,19,33,57.6,6,20,30.0,25,53,47.2,14,26,53.8,8,28,36,15,16,27,11,8,4,1,82,BUDIMPEX-POLONIA Przemyśl,Sezon 2012/2013
2012-09-29 19:00,BUDIMPEX-POLONIA Przemyśl(d),60 : 68P,60,20,49,40.8,5,15,33.3,25,64,39.1,5,11,45.5,7,23,30,17,25,15,14,8,0,0,56,Franz Astoria Bydgoszcz,Sezon 2012/2013
2012-10-03 19:00,WKS Śląsk Wrocław(d),61 : 92P,61,18,41,43.9,4,11,36.4,22,52,42.3,13,22,59.1,10,21,31,16,25,22,24,6,3,0,54,Franz Astoria Bydgoszcz,Sezon 2012/2013
2012-10-07 18:30,BM SLAM STAL Ostrów Wielkopolski(w),76 : 71P,71,26,45,57.8,3,15,20.0,29,60,48.3,10,15,66.7,7,16,23,10,28,18,15,10,2,0,65,Franz Astoria Bydgoszcz,Sezon 2012/2013
2012-10-13 19:00,WIKANA START SA Lublin(d),83 : 81W,83,24,56,42.9,4,12,33.3,28,68,41.2,23,34,67.6,12,20,32,17,23,28,7,8,3,1,85,Franz Astoria Bydgoszcz,Sezon 2012/2013
2012-10-20 18:00,Siedlecki Klub Koszykówki Siedlce(w),88 : 78P,78,17,35,48.6,11,17,64.7,28,52,53.8,11,24,45.8,3,18,21,19,29,21,16,6,0,4,71,Franz Astoria Bydgoszcz,Sezon 2012/2013
2012-10-28 17:00,NETO PTG Sokół Łańcut(d),79 : 95P,79,27,37,73.0,1,8,12.5,28,45,62.2,22,37,59.5,4,12,16,15,25,27,18,11,2,2,73,Franz Astoria Bydgoszcz,Sezon 2012/2013
2012-11-04 18:00,MKS Dąbrowa Górnicza II(w),87 : 71P,71,24,54,44.4,4,18,22.2,28,72,38.9,11,19,57.9,10,24,34,16,19,19,13,12,2,0,70,Franz Astoria Bydgoszcz,Sezon 2012/2013
2012-11-10 17:00,MKS Znicz Basket Pruszków(d),82 : 80W,82,25,43,58.1,4,17,23.5,29,60,48.3,20,34,58.8,8,20,28,18,25,28,16,9,2,4,78,Franz Astoria Bydgoszcz,Sezon 2012/2013
2012-11-17 18:00,UMKS Kielce(w),66 : 92W,92,32,50,64.0,4,10,40.0,36,60,60.0,16,20,80.0,8,29,37,23,21,23,16,9,1,3,118,Franz Astoria Bydgoszcz,Sezon 2012/2013
2012-11-24 19:00,AZS WSGK POLFARMEX Kutno(d),81 : 85P,81,25,48,52.1,3,10,30.0,28,58,48.3,22,51,43.1,13,17,30,17,27,34,17,7,2,3,61,Franz Astoria Bydgoszcz,Sezon 2012/2013
2012-12-01 19:30,AZS Politechnika Poznań(w),81 : 98W,98,22,44,50.0,7,15,46.7,29,59,49.2,33,51,64.7,11,34,45,21,20,35,24,13,9,5,114,Franz Astoria Bydgoszcz,Sezon 2012/2013
2012-12-05 19:00,Polski Cukier SIDEn Toruń(d),101 : 90W,101,37,65,56.9,4,16,25.0,41,81,50.6,15,23,65.2,17,18,35,22,19,25,9,9,2,4,112,Franz Astoria Bydgoszcz,Sezon 2012/2013
2012-12-08 16:00,AZS Radex Szczecin(w),93 : 88P,88,24,48,50.0,5,17,29.4,29,65,44.6,25,33,75.8,11,25,36,19,29,21,19,9,1,7,90,Franz Astoria Bydgoszcz,Sezon 2012/2013
2012-12-15 17:00,PBS BANK EFIR ENERGY MOSiR Krosno(d),62 : 80P,62,17,35,48.6,6,25,24.0,23,60,38.3,10,19,52.6,12,20,32,15,17,22,19,7,2,1,53,Franz Astoria Bydgoszcz,Sezon 2012/2013
2012-12-19 18:00,KS Spójnia Stargard Szczeciński(w),63 : 72W,72,23,41,56.1,1,15,6.7,24,56,42.9,23,30,76.7,10,29,39,16,19,24,13,9,3,3,87,Franz Astoria Bydgoszcz,Sezon 2012/2013
2013-01-06 17:00,BUDIMPEX-POLONIA Przemyśl(w),94 : 75P,75,26,46,56.5,5,15,33.3,31,61,50.8,8,19,42.1,8,22,30,16,22,20,18,5,0,5,67,Franz Astoria Bydgoszcz,Sezon 2012/2013
2013-01-09 19:15,WKS Śląsk Wrocław(w),104 : 53P,53,16,46,34.8,4,13,30.8,20,59,33.9,9,25,36.0,5,18,23,9,23,24,16,10,0,3,24,Franz Astoria Bydgoszcz,Sezon 2012/2013
2013-01-13 16:00,BM SLAM STAL Ostrów Wielkopolski(d),82 : 75W,82,28,44,63.6,3,15,20.0,31,59,52.5,17,27,63.0,11,21,32,18,21,25,13,7,2,2,90,Franz Astoria Bydgoszcz,Sezon 2012/2013
2013-01-19 18:00,WIKANA START SA Lublin(w),71 : 70P,70,23,50,46.0,5,18,27.8,28,68,41.2,9,20,45.0,13,25,38,15,19,20,14,9,3,0,70,Franz Astoria Bydgoszcz,Sezon 2012/2013
2013-01-26 17:00,Siedlecki Klub Koszykówki Siedlce(d),78 : 71W,78,23,42,54.8,6,18,33.3,29,60,48.3,14,22,63.6,8,26,34,18,25,19,14,4,3,3,84,Franz Astoria Bydgoszcz,Sezon 2012/2013
2013-01-30 18:00,NETO PTG Sokół Łańcut(w),97 : 71P,71,20,46,43.5,4,13,30.8,24,59,40.7,19,31,61.3,10,18,28,11,16,22,14,11,4,3,64,Franz Astoria Bydgoszcz,Sezon 2012/2013
2013-02-03 17:00,MKS Dąbrowa Górnicza II(d),104 : 110P,104,27,50,54.0,10,25,40.0,37,75,49.3,20,30,66.7,13,27,40,15,31,28,16,4,3,2,102,Franz Astoria Bydgoszcz,Sezon 2012/2013
2013-02-13 19:00,MKS Znicz Basket Pruszków(w),58 : 74W,74,20,42,47.6,6,18,33.3,26,60,43.3,16,29,55.2,15,34,49,12,25,24,17,8,3,2,82,Franz Astoria Bydgoszcz,Sezon 2012/2013
2013-02-17 17:00,UMKS Kielce(d),86 : 75W,86,31,54,57.4,5,19,26.3,36,73,49.3,9,16,56.3,12,26,38,23,20,19,14,13,5,3,107,Franz Astoria Bydgoszcz,Sezon 2012/2013
2013-02-23 17:30,AZS WSGK POLFARMEX Kutno(w),93 : 84P,84,30,50,60.0,4,9,44.4,34,59,57.6,12,18,66.7,4,20,24,9,18,17,13,5,3,2,81,Franz Astoria Bydgoszcz,Sezon 2012/2013
2013-03-02 18:00,AZS Politechnika Poznań(d),88 : 69W,88,28,43,65.1,5,11,45.5,33,54,61.1,17,22,77.3,5,18,23,24,23,22,18,10,4,0,105,Franz Astoria Bydgoszcz,Sezon 2012/2013
2013-03-06 18:30,Polski Cukier SIDEn Toruń(w),92 : 77P,77,21,56,37.5,5,16,31.3,26,72,36.1,20,29,69.0,12,23,35,11,23,23,11,5,1,4,63,Franz Astoria Bydgoszcz,Sezon 2012/2013
2013-03-10 17:00,AZS Radex Szczecin(d),83 : 80W,83,25,52,48.1,5,11,45.5,30,63,47.6,18,22,81.8,9,19,28,13,15,24,9,3,1,0,82,Franz Astoria Bydgoszcz,Sezon 2012/2013
2013-03-17 18:00,PBS BANK EFIR ENERGY MOSiR Krosno(w),86 : 90W,90,29,53,54.7,7,16,43.8,36,69,52.2,11,17,64.7,11,19,30,20,19,19,11,8,2,3,100,Franz Astoria Bydgoszcz,Sezon 2012/2013
2013-03-24 18:00,KS Spójnia Stargard Szczeciński(d),70 : 71P,70,21,42,50.0,5,16,31.3,26,58,44.8,13,18,72.2,4,24,28,17,21,18,13,9,1,1,75,Franz Astoria Bydgoszcz,Sezon 2012/2013
2013-04-06 20:00,AZS Politechnika Poznań(d),72 : 68W,72,21,42,50.0,5,17,29.4,26,59,44.1,15,22,68.2,7,23,30,14,18,24,13,11,3,5,77,Franz Astoria Bydgoszcz,Sezon 2012/2013
2013-04-07 18:00,AZS Politechnika Poznań(d),59 : 60P,59,17,35,48.6,3,13,23.1,20,48,41.7,16,20,80.0,6,18,24,9,23,25,23,9,2,6,48,Franz Astoria Bydgoszcz,Sezon 2012/2013
2013-04-13 20:30,AZS Politechnika Poznań(w),77 : 66P,66,21,44,47.7,2,18,11.1,23,62,37.1,18,28,64.3,9,15,24,8,22,25,19,11,0,4,41,Franz Astoria Bydgoszcz,Sezon 2012/2013
2013-04-14 20:00,AZS Politechnika Poznań(w),74 : 73P,73,25,50,50.0,1,17,5.9,26,67,38.8,20,26,76.9,7,35,42,12,15,24,18,10,5,2,77,Franz Astoria Bydgoszcz,Sezon 2012/2013
2012-09-29 19:15,WKS Śląsk Wrocław(w),75 : 80W,80,22,41,53.7,6,14,42.9,28,55,50.9,18,22,81.8,5,21,26,12,26,25,12,9,2,0,86,KS Spójnia Stargard Szczeciński,Sezon 2012/2013
2012-10-03 18:00,BM SLAM STAL Ostrów Wielkopolski(d),51 : 75P,51,9,34,26.5,7,16,43.8,16,50,32.0,12,15,80.0,5,20,25,12,16,17,16,7,6,0,48,KS Spójnia Stargard Szczeciński,Sezon 2012/2013
2012-10-07 18:00,WIKANA START SA Lublin(w),56 : 79W,79,16,36,44.4,10,28,35.7,26,64,40.6,17,18,94.4,5,25,30,17,15,20,7,13,0,0,93,KS Spójnia Stargard Szczeciński,Sezon 2012/2013
2012-10-13 17:00,Siedlecki Klub Koszykówki Siedlce(d),57 : 69P,57,15,38,39.5,5,24,20.8,20,62,32.3,12,19,63.2,11,18,29,11,26,24,12,3,0,1,39,KS Spójnia Stargard Szczeciński,Sezon 2012/2013
2012-10-20 18:00,NETO PTG Sokół Łańcut(w),62 : 59P,59,16,30,53.3,3,18,16.7,19,48,39.6,18,25,72.0,4,20,24,11,22,23,17,8,1,1,50,KS Spójnia Stargard Szczeciński,Sezon 2012/2013
2012-10-27 17:00,MKS Dąbrowa Górnicza II(d),57 : 65P,57,20,44,45.5,4,17,23.5,24,61,39.3,5,11,45.5,11,30,41,11,20,16,18,7,3,2,58,KS Spójnia Stargard Szczeciński,Sezon 2012/2013
2012-11-03 19:00,MKS Znicz Basket Pruszków(d),55 : 44W,55,15,38,39.5,6,21,28.6,21,59,35.6,7,11,63.6,9,20,29,13,16,17,14,11,2,2,54,KS Spójnia Stargard Szczeciński,Sezon 2012/2013
2012-11-10 18:30,UMKS Kielce(w),71 : 68P,68,17,34,50.0,8,25,32.0,25,59,42.4,10,11,90.9,6,22,28,18,20,17,13,6,2,3,74,KS Spójnia Stargard Szczeciński,Sezon 2012/2013
2012-11-17 17:30,AZS WSGK POLFARMEX Kutno(w),58 : 54P,54,13,25,52.0,6,26,23.1,19,51,37.3,10,17,58.8,5,17,22,10,20,20,12,5,0,4,40,KS Spójnia Stargard Szczeciński,Sezon 2012/2013
2012-11-24 17:00,AZS Politechnika Poznań(d),97 : 79W,97,24,35,68.6,13,28,46.4,37,63,58.7,10,12,83.3,9,26,35,25,12,19,20,11,1,1,121,KS Spójnia Stargard Szczeciński,Sezon 2012/2013
2012-12-01 18:30,Polski Cukier SIDEn Toruń(w),75 : 84W,84,19,37,51.4,8,23,34.8,27,60,45.0,22,29,75.9,6,23,29,9,23,25,8,7,1,4,82,KS Spójnia Stargard Szczeciński,Sezon 2012/2013
2012-12-05 18:00,AZS Radex Szczecin(d),74 : 61W,74,20,34,58.8,7,23,30.4,27,57,47.4,13,19,68.4,4,28,32,17,21,22,14,9,2,4,84,KS Spójnia Stargard Szczeciński,Sezon 2012/2013
2012-12-09 18:00,PBS BANK EFIR ENERGY MOSiR Krosno(w),85 : 64P,64,18,37,48.6,6,20,30.0,24,57,42.1,10,14,71.4,7,20,27,15,18,19,14,3,2,3,60,KS Spójnia Stargard Szczeciński,Sezon 2012/2013
2012-12-11 18:00,BUDIMPEX-POLONIA Przemyśl(w),74 : 56P,56,19,42,45.2,4,15,26.7,23,57,40.4,6,12,50.0,6,25,31,9,17,17,15,6,4,5,51,KS Spójnia Stargard Szczeciński,Sezon 2012/2013
2012-12-19 18:00,Franz Astoria Bydgoszcz(d),63 : 72P,63,19,43,44.2,6,29,20.7,25,72,34.7,7,14,50.0,14,22,36,15,25,19,14,7,3,3,56,KS Spójnia Stargard Szczeciński,Sezon 2012/2013
2013-01-05 17:00,WKS Śląsk Wrocław(d),71 : 75P,71,24,49,49.0,4,10,40.0,28,59,47.5,11,16,68.8,6,24,30,9,20,22,13,7,2,3,70,KS Spójnia Stargard Szczeciński,Sezon 2012/2013
2013-01-09 18:30,BM SLAM STAL Ostrów Wielkopolski(w),72 : 74W,74,17,41,41.5,9,21,42.9,26,62,41.9,13,28,46.4,9,26,35,14,24,26,16,10,3,2,69,KS Spójnia Stargard Szczeciński,Sezon 2012/2013
2013-01-12 17:00,WIKANA START SA Lublin(d),70 : 56W,70,14,28,50.0,11,27,40.7,25,55,45.5,9,14,64.3,8,30,38,18,24,18,15,6,6,0,88,KS Spójnia Stargard Szczeciński,Sezon 2012/2013
2013-01-15 18:00,NETO PTG Sokół Łańcut(d),64 : 80P,64,15,33,45.5,8,25,32.0,23,58,39.7,10,21,47.6,18,21,39,16,22,19,18,7,2,5,64,KS Spójnia Stargard Szczeciński,Sezon 2012/2013
2013-01-20 18:00,Siedlecki Klub Koszykówki Siedlce(w),47 : 78W,78,21,42,50.0,8,28,28.6,29,70,41.4,12,16,75.0,12,25,37,12,14,17,6,14,2,2,92,KS Spójnia Stargard Szczeciński,Sezon 2012/2013
2013-01-30 18:00,MKS Dąbrowa Górnicza II(w),70 : 72W,72,20,41,48.8,5,21,23.8,25,62,40.3,17,23,73.9,10,21,31,14,22,23,9,7,0,0,72,KS Spójnia Stargard Szczeciński,Sezon 2012/2013
2013-02-03 18:00,MKS Znicz Basket Pruszków(w),55 : 72W,72,17,37,45.9,9,23,39.1,26,60,43.3,11,14,78.6,6,27,33,19,22,17,12,7,3,8,85,KS Spójnia Stargard Szczeciński,Sezon 2012/2013
2013-02-09 17:00,UMKS Kielce(d),67 : 62W,67,15,34,44.1,9,22,40.9,24,56,42.9,10,14,71.4,9,20,29,14,19,20,12,6,1,3,69,KS Spójnia Stargard Szczeciński,Sezon 2012/2013
2013-02-16 17:00,AZS WSGK POLFARMEX Kutno(d),79 : 76W,79,22,44,50.0,6,21,28.6,28,65,43.1,17,26,65.4,9,18,27,14,19,22,7,7,1,2,75,KS Spójnia Stargard Szczeciński,Sezon 2012/2013
2013-02-23 19:30,AZS Politechnika Poznań(w),68 : 59P,59,12,32,37.5,3,23,13.0,15,55,27.3,26,35,74.3,10,26,36,8,23,29,13,6,1,3,48,KS Spójnia Stargard Szczeciński,Sezon 2012/2013
2013-02-26 18:00,BUDIMPEX-POLONIA Przemyśl(d),64 : 56W,64,23,41,56.1,2,19,10.5,25,60,41.7,12,16,75.0,11,23,34,13,20,21,11,7,0,3,68,KS Spójnia Stargard Szczeciński,Sezon 2012/2013
2013-03-02 17:00,Polski Cukier SIDEn Toruń(d),57 : 64P,57,17,38,44.7,5,23,21.7,22,61,36.1,8,11,72.7,11,23,34,9,22,16,18,5,2,3,47,KS Spójnia Stargard Szczeciński,Sezon 2012/2013
2013-03-06 18:00,AZS Radex Szczecin(w),98 : 73P,73,21,41,51.2,5,16,31.3,26,57,45.6,16,20,80.0,1,13,14,22,22,21,11,5,0,2,68,KS Spójnia Stargard Szczeciński,Sezon 2012/2013
2013-03-09 17:00,PBS BANK EFIR ENERGY MOSiR Krosno(d),80 : 62W,80,17,41,41.5,11,21,52.4,28,62,45.2,13,19,68.4,16,19,35,20,16,18,15,13,1,3,94,KS Spójnia Stargard Szczeciński,Sezon 2012/2013
2013-03-24 18:00,Franz Astoria Bydgoszcz(w),70 : 71W,71,15,33,45.5,10,22,45.5,25,55,45.5,11,19,57.9,10,25,35,17,19,21,22,6,1,1,70,KS Spójnia Stargard Szczeciński,Sezon 2012/2013
2013-04-06 17:30,AZS WSGK POLFARMEX Kutno(w),69 : 55P,55,16,45,35.6,3,14,21.4,19,59,32.2,14,16,87.5,5,23,28,11,17,20,11,10,0,5,51,KS Spójnia Stargard Szczeciński,Sezon 2012/2013
2013-04-07 17:30,AZS WSGK POLFARMEX Kutno(w),77 : 63P,63,25,49,51.0,3,19,15.8,28,68,41.2,4,7,57.1,11,18,29,14,18,18,9,7,4,5,65,KS Spójnia Stargard Szczeciński,Sezon 2012/2013
2013-04-13 17:00,AZS WSGK POLFARMEX Kutno(d),79 : 80P,79,28,48,58.3,5,17,29.4,33,65,50.8,8,11,72.7,8,23,31,19,17,14,10,5,0,2,89,KS Spójnia Stargard Szczeciński,Sezon 2012/2013
2012-09-29 18:00,UMKS Kielce(d),76 : 60W,76,19,35,54.3,9,24,37.5,28,59,47.5,11,12,91.7,7,28,35,10,19,20,11,8,2,0,88,MKS Znicz Basket Pruszków,Sezon 2012/2013
2012-10-03 18:00,AZS WSGK POLFARMEX Kutno(w),80 : 74P,74,16,35,45.7,4,14,28.6,20,49,40.8,30,39,76.9,6,22,28,7,27,31,14,6,1,0,64,MKS Znicz Basket Pruszków,Sezon 2012/2013
2012-10-07 19:00,AZS Politechnika Poznań(d),67 : 57W,67,18,35,51.4,8,21,38.1,26,56,46.4,7,13,53.8,8,28,36,16,18,21,22,7,3,0,71,MKS Znicz Basket Pruszków,Sezon 2012/2013
2012-10-14 18:30,Polski Cukier SIDEn Toruń(w),58 : 54P,54,17,38,44.7,5,23,21.7,22,61,36.1,5,8,62.5,8,27,35,13,20,16,11,3,6,7,58,MKS Znicz Basket Pruszków,Sezon 2012/2013
2012-10-21 17:00,AZS Radex Szczecin(d),74 : 63W,74,22,41,53.7,4,15,26.7,26,56,46.4,18,26,69.2,9,23,32,10,19,25,16,12,6,0,80,MKS Znicz Basket Pruszków,Sezon 2012/2013
2012-10-27 18:00,PBS BANK EFIR ENERGY MOSiR Krosno(w),78 : 56P,56,15,40,37.5,4,20,20.0,19,60,31.7,14,20,70.0,6,30,36,9,24,23,16,8,5,3,51,MKS Znicz Basket Pruszków,Sezon 2012/2013
2012-11-03 19:00,KS Spójnia Stargard Szczeciński(w),55 : 44P,44,14,32,43.8,3,13,23.1,17,45,37.8,7,9,77.8,6,26,32,10,17,16,23,5,2,2,40,MKS Znicz Basket Pruszków,Sezon 2012/2013
2012-11-10 17:00,Franz Astoria Bydgoszcz(w),82 : 80P,80,25,51,49.0,4,15,26.7,29,66,43.9,18,28,64.3,11,21,32,15,28,25,14,8,4,2,78,MKS Znicz Basket Pruszków,Sezon 2012/2013
2012-11-18 17:00,WKS Śląsk Wrocław(d),58 : 75P,58,15,41,36.6,6,18,33.3,21,59,35.6,10,13,76.9,10,21,31,14,26,15,18,3,6,2,53,MKS Znicz Basket Pruszków,Sezon 2012/2013
2012-11-24 18:30,BM SLAM STAL Ostrów Wielkopolski(w),70 : 81W,81,27,45,60.0,7,21,33.3,34,66,51.5,6,12,50.0,8,20,28,11,15,19,15,12,4,2,83,MKS Znicz Basket Pruszków,Sezon 2012/2013
2012-12-01 20:00,WIKANA START SA Lublin(d),73 : 65W,73,22,39,56.4,5,19,26.3,27,58,46.6,14,20,70.0,5,25,30,16,17,21,10,9,3,1,84,MKS Znicz Basket Pruszków,Sezon 2012/2013
2012-12-05 18:00,Siedlecki Klub Koszykówki Siedlce(w),83 : 65P,65,19,31,61.3,5,20,25.0,24,51,47.1,12,18,66.7,3,20,23,17,21,20,16,6,1,0,63,MKS Znicz Basket Pruszków,Sezon 2012/2013
2012-12-08 18:00,NETO PTG Sokół Łańcut(d),93 : 89W,93,19,33,57.6,8,19,42.1,27,52,51.9,31,47,66.0,6,29,35,18,24,32,22,9,3,4,95,MKS Znicz Basket Pruszków,Sezon 2012/2013
2012-12-14 19:00,MKS Dąbrowa Górnicza II(d),59 : 66P,59,16,47,34.0,7,16,43.8,23,63,36.5,6,7,85.7,6,29,35,15,28,17,20,5,4,4,57,MKS Znicz Basket Pruszków,Sezon 2012/2013
2012-12-19 19:00,BUDIMPEX-POLONIA Przemyśl(d),75 : 61W,75,19,45,42.2,7,22,31.8,26,67,38.8,16,19,84.2,9,29,38,19,21,21,10,5,6,6,89,MKS Znicz Basket Pruszków,Sezon 2012/2013
2013-01-05 17:00,UMKS Kielce(w),68 : 73W,73,23,40,57.5,4,18,22.2,27,58,46.6,15,18,83.3,7,20,27,18,16,23,12,7,1,2,80,MKS Znicz Basket Pruszków,Sezon 2012/2013
2013-01-09 19:00,AZS WSGK POLFARMEX Kutno(d),73 : 75P,73,19,35,54.3,7,16,43.8,26,51,51.0,14,20,70.0,5,29,34,17,23,22,19,10,3,2,87,MKS Znicz Basket Pruszków,Sezon 2012/2013
2013-01-13 17:00,AZS Politechnika Poznań(w),61 : 55P,55,15,40,37.5,4,18,22.2,19,58,32.8,13,17,76.5,12,23,35,13,17,21,16,5,1,5,50,MKS Znicz Basket Pruszków,Sezon 2012/2013
2013-01-20 17:00,Polski Cukier SIDEn Toruń(d),61 : 43W,61,16,42,38.1,7,21,33.3,23,63,36.5,8,12,66.7,9,31,40,8,20,16,14,11,3,4,65,MKS Znicz Basket Pruszków,Sezon 2012/2013
2013-01-26 19:30,AZS Radex Szczecin(w),81 : 92W,92,24,44,54.5,6,17,35.3,30,61,49.2,26,32,81.3,6,32,38,15,25,29,16,9,1,1,102,MKS Znicz Basket Pruszków,Sezon 2012/2013
2013-01-30 19:00,PBS BANK EFIR ENERGY MOSiR Krosno(d),65 : 54W,65,14,34,41.2,6,22,27.3,20,56,35.7,19,32,59.4,12,29,41,13,26,23,17,9,4,4,66,MKS Znicz Basket Pruszków,Sezon 2012/2013
2013-02-03 18:00,KS Spójnia Stargard Szczeciński(d),55 : 72P,55,15,34,44.1,3,21,14.3,18,55,32.7,16,24,66.7,7,25,32,15,17,22,12,4,8,3,57,MKS Znicz Basket Pruszków,Sezon 2012/2013
2013-02-13 19:00,Franz Astoria Bydgoszcz(d),58 : 74P,58,20,50,40.0,1,17,5.9,21,67,31.3,15,24,62.5,13,20,33,10,24,25,12,10,2,3,46,MKS Znicz Basket Pruszków,Sezon 2012/2013
2013-02-17 14:00,WKS Śląsk Wrocław(w),75 : 69P,69,19,42,45.2,7,20,35.0,26,62,41.9,10,17,58.8,10,29,39,17,21,20,17,12,2,2,79,MKS Znicz Basket Pruszków,Sezon 2012/2013
2013-02-23 18:00,BM SLAM STAL Ostrów Wielkopolski(d),82 : 74W,82,23,41,56.1,7,13,53.8,30,54,55.6,15,19,78.9,6,20,26,16,15,20,11,8,4,2,97,MKS Znicz Basket Pruszków,Sezon 2012/2013
2013-03-02 19:00,WIKANA START SA Lublin(w),105 : 87P,87,23,39,59.0,12,21,57.1,35,60,58.3,5,9,55.6,5,19,24,12,20,15,18,7,1,1,84,MKS Znicz Basket Pruszków,Sezon 2012/2013
2013-03-06 19:00,Siedlecki Klub Koszykówki Siedlce(d),81 : 61W,81,27,38,71.1,6,22,27.3,33,60,55.0,9,11,81.8,5,27,32,21,19,15,13,8,4,0,104,MKS Znicz Basket Pruszków,Sezon 2012/2013
2013-03-09 18:00,NETO PTG Sokół Łańcut(w),68 : 74W,74,17,38,44.7,5,19,26.3,22,57,38.6,25,31,80.6,8,23,31,13,23,23,16,8,3,2,72,MKS Znicz Basket Pruszków,Sezon 2012/2013
2013-03-20 18:00,MKS Dąbrowa Górnicza II(w),93 : 77P,77,26,45,57.8,5,14,35.7,31,59,52.5,10,19,52.6,4,26,30,10,21,22,15,4,1,2,70,MKS Znicz Basket Pruszków,Sezon 2012/2013
2013-03-24 18:00,BUDIMPEX-POLONIA Przemyśl(w),52 : 51P,51,15,39,38.5,2,16,12.5,17,55,30.9,15,18,83.3,7,38,45,7,25,18,19,4,2,4,49,MKS Znicz Basket Pruszków,Sezon 2012/2013
2013-04-06 20:00,UMKS Kielce(d),57 : 23W,57,19,38,50.0,5,22,22.7,24,60,40.0,4,7,57.1,9,31,40,9,22,16,12,11,4,2,70,MKS Znicz Basket Pruszków,Sezon 2012/2013
2013-04-07 18:00,UMKS Kielce(d),64 : 71P,64,17,33,51.5,9,29,31.0,26,62,41.9,3,7,42.9,7,23,30,12,19,17,14,5,2,4,59,MKS Znicz Basket Pruszków,Sezon 2012/2013
2013-04-13 17:30,UMKS Kielce(w),70 : 72W,72,22,46,47.8,4,15,26.7,26,61,42.6,16,23,69.6,8,23,31,8,15,23,10,7,0,2,66,MKS Znicz Basket Pruszków,Sezon 2012/2013
2013-04-14 17:30,UMKS Kielce(w),73 : 75W,75,21,34,61.8,8,23,34.8,29,57,50.9,9,14,64.3,9,28,37,16,21,15,17,3,1,3,82,MKS Znicz Basket Pruszków,Sezon 2012/2013
2012-09-30 18:00,AZS Politechnika Poznań(d),83 : 76W,83,15,31,48.4,11,29,37.9,26,60,43.3,20,28,71.4,7,25,32,18,19,27,12,5,5,0,89,NETO PTG Sokół Łańcut,Sezon 2012/2013
2012-10-03 18:30,Polski Cukier SIDEn Toruń(w),72 : 64P,64,15,32,46.9,10,24,41.7,25,56,44.6,4,11,36.4,10,17,27,15,25,18,18,6,6,0,62,NETO PTG Sokół Łańcut,Sezon 2012/2013
2012-10-06 15:00,AZS Radex Szczecin(d),70 : 67W,70,17,39,43.6,5,13,38.5,22,52,42.3,21,33,63.6,10,27,37,12,23,27,19,11,8,0,77,NETO PTG Sokół Łańcut,Sezon 2012/2013
2012-10-13 18:00,PBS BANK EFIR ENERGY MOSiR Krosno(w),77 : 65P,65,16,39,41.0,7,23,30.4,23,62,37.1,12,20,60.0,14,23,37,11,19,21,15,3,3,2,57,NETO PTG Sokół Łańcut,Sezon 2012/2013
2012-10-20 18:00,KS Spójnia Stargard Szczeciński(d),62 : 59W,62,13,28,46.4,10,25,40.0,23,53,43.4,6,9,66.7,5,24,29,15,23,22,19,8,1,1,63,NETO PTG Sokół Łańcut,Sezon 2012/2013
2012-10-28 17:00,Franz Astoria Bydgoszcz(w),79 : 95W,95,19,35,54.3,13,26,50.0,32,61,52.5,18,23,78.3,13,16,29,21,27,25,18,12,2,2,107,NETO PTG Sokół Łańcut,Sezon 2012/2013
2012-11-03 18:00,WKS Śląsk Wrocław(d),65 : 75P,65,16,31,51.6,6,20,30.0,22,51,43.1,15,17,88.2,5,22,27,17,24,23,22,6,1,0,63,NETO PTG Sokół Łańcut,Sezon 2012/2013
2012-11-10 18:30,BM SLAM STAL Ostrów Wielkopolski(w),72 : 63P,63,13,25,52.0,10,30,33.3,23,55,41.8,7,12,58.3,5,24,29,10,29,19,24,9,2,3,52,NETO PTG Sokół Łańcut,Sezon 2012/2013
2012-11-17 18:00,WIKANA START SA Lublin(d),76 : 72W,76,14,37,37.8,10,30,33.3,24,67,35.8,18,26,69.2,17,19,36,16,24,26,4,9,5,1,87,NETO PTG Sokół Łańcut,Sezon 2012/2013
2012-11-24 20:00,Siedlecki Klub Koszykówki Siedlce(w),54 : 88W,88,22,30,73.3,11,32,34.4,33,62,53.2,11,17,64.7,11,21,32,22,19,20,13,15,1,0,110,NETO PTG Sokół Łańcut,Sezon 2012/2013
2012-12-01 18:00,BUDIMPEX-POLONIA Przemyśl(d),65 : 60W,65,11,37,29.7,10,22,45.5,21,59,35.6,13,18,72.2,10,24,34,11,20,20,16,5,4,1,60,NETO PTG Sokół Łańcut,Sezon 2012/2013
2012-12-05 18:00,MKS Dąbrowa Górnicza II(d),82 : 89P,82,22,39,56.4,9,26,34.6,31,65,47.7,11,19,57.9,15,17,32,15,26,20,14,10,2,2,85,NETO PTG Sokół Łańcut,Sezon 2012/2013
2012-12-08 18:00,MKS Znicz Basket Pruszków(w),93 : 89P,89,21,45,46.7,10,26,38.5,31,71,43.7,17,20,85.0,10,20,30,19,32,24,17,13,4,3,95,NETO PTG Sokół Łańcut,Sezon 2012/2013
2012-12-15 18:00,UMKS Kielce(d),75 : 64W,75,22,34,64.7,6,24,25.0,28,58,48.3,13,23,56.5,13,30,43,11,25,23,19,7,1,2,78,NETO PTG Sokół Łańcut,Sezon 2012/2013
2012-12-19 18:00,AZS WSGK POLFARMEX Kutno(w),80 : 85W,85,18,38,47.4,6,20,30.0,24,58,41.4,31,48,64.6,11,24,35,10,22,36,15,11,2,1,77,NETO PTG Sokół Łańcut,Sezon 2012/2013
2013-01-06 18:00,AZS Politechnika Poznań(w),51 : 66W,66,13,29,44.8,6,23,26.1,19,52,36.5,22,32,68.8,9,26,35,11,17,28,15,4,6,0,64,NETO PTG Sokół Łańcut,Sezon 2012/2013
2013-01-09 18:00,Polski Cukier SIDEn Toruń(d),57 : 61P,57,12,42,28.6,6,22,27.3,18,64,28.1,15,18,83.3,12,20,32,9,20,23,16,10,4,8,47,NETO PTG Sokół Łańcut,Sezon 2012/2013
2013-01-13 18:30,AZS Radex Szczecin(w),82 : 61P,61,9,30,30.0,7,24,29.2,16,54,29.6,22,27,81.5,7,15,22,14,19,25,14,8,3,4,51,NETO PTG Sokół Łańcut,Sezon 2012/2013
2013-01-15 18:00,KS Spójnia Stargard Szczeciński(w),64 : 80W,80,24,41,58.5,7,19,36.8,31,60,51.7,11,18,61.1,8,21,29,19,19,21,12,9,5,2,94,NETO PTG Sokół Łańcut,Sezon 2012/2013
2013-01-19 18:00,PBS BANK EFIR ENERGY MOSiR Krosno(d),72 : 68W,72,15,32,46.9,7,19,36.8,22,51,43.1,21,30,70.0,9,29,38,14,19,28,16,5,1,2,76,NETO PTG Sokół Łańcut,Sezon 2012/2013
2013-01-30 18:00,Franz Astoria Bydgoszcz(d),97 : 71W,97,27,47,57.4,11,21,52.4,38,68,55.9,10,12,83.3,11,26,37,25,22,16,17,8,3,4,121,NETO PTG Sokół Łańcut,Sezon 2012/2013
2013-02-03 18:15,WKS Śląsk Wrocław(w),96 : 67P,67,20,41,48.8,7,23,30.4,27,64,42.2,6,11,54.5,4,13,17,11,20,19,15,6,0,4,44,NETO PTG Sokół Łańcut,Sezon 2012/2013
2013-02-09 18:00,BM SLAM STAL Ostrów Wielkopolski(d),88 : 85W,88,15,27,55.6,11,25,44.0,26,52,50.0,25,32,78.1,5,21,26,16,14,26,11,10,0,2,96,NETO PTG Sokół Łańcut,Sezon 2012/2013
2013-02-16 18:00,WIKANA START SA Lublin(w),84 : 63P,63,14,38,36.8,10,20,50.0,24,58,41.4,5,11,45.5,7,19,26,13,19,20,19,5,0,4,48,NETO PTG Sokół Łańcut,Sezon 2012/2013
2013-02-23 18:00,Siedlecki Klub Koszykówki Siedlce(d),64 : 68P,64,12,31,38.7,8,32,25.0,20,63,31.7,16,21,76.2,21,26,47,7,19,22,15,3,1,3,59,NETO PTG Sokół Łańcut,Sezon 2012/2013
2013-03-02 18:00,BUDIMPEX-POLONIA Przemyśl(w),77 : 68P,68,15,34,44.1,8,26,30.8,23,60,38.3,14,19,73.7,8,21,29,6,21,21,11,6,2,1,58,NETO PTG Sokół Łańcut,Sezon 2012/2013
2013-03-06 18:00,MKS Dąbrowa Górnicza II(w),72 : 64P,64,12,35,34.3,8,22,36.4,20,57,35.1,16,22,72.7,12,22,34,13,22,23,14,9,1,0,64,NETO PTG Sokół Łańcut,Sezon 2012/2013
2013-03-09 18:00,MKS Znicz Basket Pruszków(d),68 : 74P,68,12,28,42.9,8,31,25.8,20,59,33.9,20,29,69.0,11,24,35,11,25,23,14,7,2,3,61,NETO PTG Sokół Łańcut,Sezon 2012/2013
2013-03-16 17:30,UMKS Kielce(w),59 : 75W,75,25,45,55.6,6,20,30.0,31,65,47.7,7,10,70.0,12,25,37,12,15,18,10,3,3,2,83,NETO PTG Sokół Łańcut,Sezon 2012/2013
2013-03-24 18:00,AZS WSGK POLFARMEX Kutno(d),90 : 87W,90,21,40,52.5,11,19,57.9,32,59,54.2,15,21,71.4,5,34,39,20,25,20,21,9,6,1,110,NETO PTG Sokół Łańcut,Sezon 2012/2013
2013-04-06 19:00,Polski Cukier SIDEn Toruń(w),78 : 69P,69,12,41,29.3,12,24,50.0,24,65,36.9,9,15,60.0,7,25,32,14,28,19,10,5,3,6,66,NETO PTG Sokół Łańcut,Sezon 2012/2013
2013-04-07 18:00,Polski Cukier SIDEn Toruń(w),81 : 73P,73,17,39,43.6,9,23,39.1,26,62,41.9,12,22,54.5,9,15,24,13,18,21,14,7,1,6,58,NETO PTG Sokół Łańcut,Sezon 2012/2013
2013-04-13 18:00,Polski Cukier SIDEn Toruń(d),77 : 85P,77,11,26,42.3,12,32,37.5,23,58,39.7,19,23,82.6,10,27,37,15,21,19,20,9,2,1,81,NETO PTG Sokół Łańcut,Sezon 2012/2013
2012-09-29 18:30,BM SLAM STAL Ostrów Wielkopolski(w),80 : 66P,66,12,30,40.0,9,23,39.1,21,53,39.6,15,24,62.5,1,22,23,9,29,23,14,8,1,0,52,PBS BANK EFIR ENERGY MOSiR Krosno,Sezon 2012/2013
2012-10-03 18:00,WIKANA START SA Lublin(d),86 : 71W,86,22,37,59.5,6,21,28.6,28,58,48.3,24,29,82.8,11,24,35,11,27,23,16,7,3,0,91,PBS BANK EFIR ENERGY MOSiR Krosno,Sezon 2012/2013
2012-10-07 17:00,Siedlecki Klub Koszykówki Siedlce(w),67 : 69W,69,14,35,40.0,10,20,50.0,24,55,43.6,11,17,64.7,5,15,20,13,23,20,10,5,2,0,62,PBS BANK EFIR ENERGY MOSiR Krosno,Sezon 2012/2013
2012-10-13 18:00,NETO PTG Sokół Łańcut(d),77 : 65W,77,20,39,51.3,10,20,50.0,30,59,50.8,7,8,87.5,6,21,27,19,21,19,9,10,2,3,96,PBS BANK EFIR ENERGY MOSiR Krosno,Sezon 2012/2013
2012-10-21 18:00,MKS Dąbrowa Górnicza II(w),86 : 77P,77,27,49,55.1,4,10,40.0,31,59,52.5,11,15,73.3,6,19,25,10,24,18,14,6,3,0,75,PBS BANK EFIR ENERGY MOSiR Krosno,Sezon 2012/2013
2012-10-27 18:00,MKS Znicz Basket Pruszków(d),78 : 56W,78,21,41,51.2,6,22,27.3,27,63,42.9,18,26,69.2,5,34,39,15,23,23,15,10,3,5,86,PBS BANK EFIR ENERGY MOSiR Krosno,Sezon 2012/2013
2012-11-03 18:30,UMKS Kielce(w),71 : 76W,76,25,41,61.0,5,16,31.3,30,57,52.6,11,13,84.6,6,15,21,20,16,12,16,10,1,2,83,PBS BANK EFIR ENERGY MOSiR Krosno,Sezon 2012/2013
2012-11-10 18:00,AZS WSGK POLFARMEX Kutno(d),78 : 87P,78,23,43,53.5,5,18,27.8,28,61,45.9,17,24,70.8,8,21,29,11,25,22,12,7,2,2,75,PBS BANK EFIR ENERGY MOSiR Krosno,Sezon 2012/2013
2012-11-17 19:30,AZS Politechnika Poznań(w),67 : 85W,85,21,41,51.2,10,24,41.7,31,65,47.7,13,21,61.9,11,27,38,20,24,20,16,13,0,3,98,PBS BANK EFIR ENERGY MOSiR Krosno,Sezon 2012/2013
2012-11-24 18:00,Polski Cukier SIDEn Toruń(d),74 : 82P,74,15,34,44.1,8,19,42.1,23,53,43.4,20,28,71.4,5,17,22,19,23,24,16,14,1,0,76,PBS BANK EFIR ENERGY MOSiR Krosno,Sezon 2012/2013
2012-12-02 20:00,AZS Radex Szczecin(w),76 : 78W,78,18,35,51.4,9,22,40.9,27,57,47.4,15,20,75.0,6,21,27,14,18,20,10,7,1,2,82,PBS BANK EFIR ENERGY MOSiR Krosno,Sezon 2012/2013
2012-12-05 18:00,BUDIMPEX-POLONIA Przemyśl(w),95 : 79P,79,20,38,52.6,5,13,38.5,25,51,49.0,24,27,88.9,4,18,22,8,21,21,14,5,1,3,72,PBS BANK EFIR ENERGY MOSiR Krosno,Sezon 2012/2013
2012-12-09 18:00,KS Spójnia Stargard Szczeciński(d),85 : 64W,85,18,37,48.6,10,20,50.0,28,57,49.1,19,28,67.9,9,25,34,21,19,18,8,9,3,2,106,PBS BANK EFIR ENERGY MOSiR Krosno,Sezon 2012/2013
2012-12-15 17:00,Franz Astoria Bydgoszcz(w),62 : 80W,80,24,43,55.8,6,15,40.0,30,58,51.7,14,17,82.4,5,23,28,18,22,17,12,13,1,2,97,PBS BANK EFIR ENERGY MOSiR Krosno,Sezon 2012/2013
2012-12-19 18:00,WKS Śląsk Wrocław(d),62 : 68P,62,20,38,52.6,5,23,21.7,25,61,41.0,7,12,58.3,5,22,27,14,19,18,14,10,3,2,61,PBS BANK EFIR ENERGY MOSiR Krosno,Sezon 2012/2013
2013-01-06 18:00,BM SLAM STAL Ostrów Wielkopolski(d),78 : 69W,78,16,34,47.1,12,19,63.2,28,53,52.8,10,13,76.9,5,26,31,18,21,20,17,9,2,0,93,PBS BANK EFIR ENERGY MOSiR Krosno,Sezon 2012/2013
2013-01-09 18:00,WIKANA START SA Lublin(w),75 : 70P,70,17,37,45.9,9,25,36.0,26,62,41.9,9,11,81.8,9,20,29,15,24,16,13,5,0,1,68,PBS BANK EFIR ENERGY MOSiR Krosno,Sezon 2012/2013
2013-01-13 18:00,Siedlecki Klub Koszykówki Siedlce(d),67 : 61W,67,14,32,43.8,5,20,25.0,19,52,36.5,24,33,72.7,9,23,32,15,17,26,14,11,1,0,70,PBS BANK EFIR ENERGY MOSiR Krosno,Sezon 2012/2013
2013-01-19 18:00,NETO PTG Sokół Łańcut(w),72 : 68P,68,16,35,45.7,8,24,33.3,24,59,40.7,12,15,80.0,7,21,28,18,28,19,11,8,2,1,75,PBS BANK EFIR ENERGY MOSiR Krosno,Sezon 2012/2013
2013-01-27 18:00,MKS Dąbrowa Górnicza II(d),97 : 75W,97,33,48,68.8,6,15,40.0,39,63,61.9,13,20,65.0,7,24,31,18,26,19,11,4,3,4,111,PBS BANK EFIR ENERGY MOSiR Krosno,Sezon 2012/2013
2013-01-30 19:00,MKS Znicz Basket Pruszków(w),65 : 54P,54,14,37,37.8,2,17,11.8,16,54,29.6,20,30,66.7,9,27,36,12,24,26,16,9,4,4,51,PBS BANK EFIR ENERGY MOSiR Krosno,Sezon 2012/2013
2013-02-03 18:00,UMKS Kielce(d),85 : 61W,85,23,42,54.8,9,20,45.0,32,62,51.6,12,16,75.0,7,32,39,18,21,19,16,10,2,2,104,PBS BANK EFIR ENERGY MOSiR Krosno,Sezon 2012/2013
2013-02-09 17:30,AZS WSGK POLFARMEX Kutno(w),72 : 76W,76,25,49,51.0,5,13,38.5,30,62,48.4,11,14,78.6,3,29,32,13,18,20,13,9,0,5,82,PBS BANK EFIR ENERGY MOSiR Krosno,Sezon 2012/2013
2013-02-16 18:00,AZS Politechnika Poznań(d),75 : 78P,75,20,37,54.1,5,18,27.8,25,55,45.5,20,29,69.0,4,24,28,23,21,24,16,6,1,2,78,PBS BANK EFIR ENERGY MOSiR Krosno,Sezon 2012/2013
2013-02-23 18:30,Polski Cukier SIDEn Toruń(w),74 : 66P,66,20,42,47.6,3,14,21.4,23,56,41.1,17,26,65.4,12,21,33,13,26,25,15,5,0,4,60,PBS BANK EFIR ENERGY MOSiR Krosno,Sezon 2012/2013
2013-03-02 18:00,AZS Radex Szczecin(d),67 : 61W,67,21,42,50.0,4,20,20.0,25,62,40.3,13,22,59.1,13,22,35,13,22,22,13,7,2,1,65,PBS BANK EFIR ENERGY MOSiR Krosno,Sezon 2012/2013
2013-03-06 18:00,BUDIMPEX-POLONIA Przemyśl(d),85 : 73W,85,22,41,53.7,10,19,52.6,32,60,53.3,11,14,78.6,6,19,25,19,21,17,10,10,2,2,100,PBS BANK EFIR ENERGY MOSiR Krosno,Sezon 2012/2013
2013-03-09 17:00,KS Spójnia Stargard Szczeciński(w),80 : 62P,62,14,28,50.0,8,21,38.1,22,49,44.9,10,11,90.9,5,18,23,11,18,16,19,8,3,1,60,PBS BANK EFIR ENERGY MOSiR Krosno,Sezon 2012/2013
2013-03-17 18:00,Franz Astoria Bydgoszcz(d),86 : 90P,86,25,38,65.8,8,21,38.1,33,59,55.9,12,18,66.7,7,24,31,21,19,19,15,7,3,2,101,PBS BANK EFIR ENERGY MOSiR Krosno,Sezon 2012/2013
2013-03-23 18:15,WKS Śląsk Wrocław(w),75 : 74P,74,16,40,40.0,9,17,52.9,25,57,43.9,15,25,60.0,7,24,31,9,23,23,17,9,1,2,65,PBS BANK EFIR ENERGY MOSiR Krosno,Sezon 2012/2013
2013-04-07 18:00,MKS Dąbrowa Górnicza II(w),83 : 81P,81,19,39,48.7,9,23,39.1,28,62,45.2,16,21,76.2,9,26,35,11,25,17,12,7,3,1,86,PBS BANK EFIR ENERGY MOSiR Krosno,Sezon 2012/2013
2013-04-08 18:00,MKS Dąbrowa Górnicza II(w),84 : 89W,89,19,37,51.4,11,22,50.0,30,59,50.8,18,24,75.0,4,21,25,12,26,23,15,12,2,6,90,PBS BANK EFIR ENERGY MOSiR Krosno,Sezon 2012/2013
2013-04-13 18:00,MKS Dąbrowa Górnicza II(d),75 : 62W,75,18,33,54.5,6,21,28.6,24,54,44.4,21,28,75.0,7,26,33,17,27,24,12,7,1,3,84,PBS BANK EFIR ENERGY MOSiR Krosno,Sezon 2012/2013
2013-04-14 18:00,MKS Dąbrowa Górnicza II(d),57 : 83P,57,17,31,54.8,4,25,16.0,21,56,37.5,11,18,61.1,14,16,30,12,19,21,13,5,4,2,53,PBS BANK EFIR ENERGY MOSiR Krosno,Sezon 2012/2013
2013-04-17 18:00,MKS Dąbrowa Górnicza II(w),72 : 89W,89,22,43,51.2,7,15,46.7,29,58,50.0,24,39,61.5,10,30,40,14,19,28,13,7,4,4,97,PBS BANK EFIR ENERGY MOSiR Krosno,Sezon 2012/2013
2013-04-20 17:30,AZS WSGK POLFARMEX Kutno(w),79 : 84W,84,28,44,63.6,7,24,29.2,35,68,51.5,7,7,100.0,6,34,40,18,18,15,15,4,0,1,98,PBS BANK EFIR ENERGY MOSiR Krosno,Sezon 2012/2013
2013-04-21 17:30,AZS WSGK POLFARMEX Kutno(w),61 : 66W,66,15,29,51.7,8,24,33.3,23,53,43.4,12,21,57.1,11,22,33,10,19,17,13,9,0,3,66,PBS BANK EFIR ENERGY MOSiR Krosno,Sezon 2012/2013
2013-04-27 18:00,AZS WSGK POLFARMEX Kutno(d),61 : 76P,61,14,37,37.8,7,23,30.4,21,60,35.0,12,22,54.5,11,27,38,13,16,22,15,6,2,3,56,PBS BANK EFIR ENERGY MOSiR Krosno,Sezon 2012/2013
2013-04-28 18:00,AZS WSGK POLFARMEX Kutno(d),93 : 89W,93,28,37,75.7,5,23,21.7,33,60,55.0,22,35,62.9,7,30,37,19,21,25,10,4,1,0,104,PBS BANK EFIR ENERGY MOSiR Krosno,Sezon 2012/2013
2013-05-05 20:00,WKS Śląsk Wrocław(w),75 : 65P,65,17,31,54.8,8,15,53.3,25,46,54.3,7,12,58.3,4,27,31,16,24,21,25,9,3,1,73,PBS BANK EFIR ENERGY MOSiR Krosno,Sezon 2012/2013
2013-05-06 19:15,WKS Śląsk Wrocław(w),73 : 84W,84,18,36,50.0,8,21,38.1,26,57,45.6,24,34,70.6,7,26,33,11,18,26,8,10,0,3,89,PBS BANK EFIR ENERGY MOSiR Krosno,Sezon 2012/2013
2013-05-11 20:00,WKS Śląsk Wrocław(d),85 : 93P,85,14,34,41.2,14,36,38.9,28,70,40.0,15,26,57.7,11,23,34,20,30,26,15,6,2,2,79,PBS BANK EFIR ENERGY MOSiR Krosno,Sezon 2012/2013
2013-05-12 18:00,WKS Śląsk Wrocław(d),50 : 59P,50,10,25,40.0,6,25,24.0,16,50,32.0,12,19,63.2,4,21,25,12,23,20,11,3,2,2,40,PBS BANK EFIR ENERGY MOSiR Krosno,Sezon 2012/2013
2012-09-29 18:00,Siedlecki Klub Koszykówki Siedlce(w),54 : 65W,65,19,42,45.2,6,20,30.0,25,62,40.3,9,12,75.0,16,20,36,4,17,16,14,8,3,0,62,Polski Cukier SIDEn Toruń,Sezon 2012/2013
2012-10-03 18:30,NETO PTG Sokół Łańcut(d),72 : 64W,72,17,37,45.9,7,17,41.2,24,54,44.4,17,27,63.0,10,21,31,11,19,24,15,9,3,0,71,Polski Cukier SIDEn Toruń,Sezon 2012/2013
2012-10-07 18:00,MKS Dąbrowa Górnicza II(w),76 : 66P,66,19,49,38.8,5,14,35.7,24,63,38.1,13,22,59.1,10,30,40,7,25,24,14,6,2,0,59,Polski Cukier SIDEn Toruń,Sezon 2012/2013
2012-10-14 18:30,MKS Znicz Basket Pruszków(d),58 : 54W,58,16,41,39.0,6,22,27.3,22,63,34.9,8,16,50.0,14,29,43,13,16,19,13,0,7,6,59,Polski Cukier SIDEn Toruń,Sezon 2012/2013
2012-10-20 17:00,UMKS Kielce(w),55 : 69W,69,23,44,52.3,3,13,23.1,26,57,45.6,14,14,100.0,7,32,39,14,21,21,22,7,1,2,77,Polski Cukier SIDEn Toruń,Sezon 2012/2013
2012-10-28 18:30,AZS WSGK POLFARMEX Kutno(d),68 : 67W,68,22,36,61.1,3,17,17.6,25,53,47.2,15,23,65.2,10,24,34,13,21,25,18,3,4,3,68,Polski Cukier SIDEn Toruń,Sezon 2012/2013
2012-11-03 19:30,AZS Politechnika Poznań(w),73 : 60P,60,20,38,52.6,1,21,4.8,21,59,35.6,17,29,58.6,11,21,32,14,16,26,13,8,2,2,53,Polski Cukier SIDEn Toruń,Sezon 2012/2013
2012-11-11 17:00,BUDIMPEX-POLONIA Przemyśl(w),80 : 74P,74,19,49,38.8,6,21,28.6,25,70,35.7,18,22,81.8,9,27,36,14,15,18,9,4,4,5,74,Polski Cukier SIDEn Toruń,Sezon 2012/2013
2012-11-17 18:30,AZS Radex Szczecin(d),72 : 79P,72,21,32,65.6,4,15,26.7,25,47,53.2,18,28,64.3,7,18,25,15,28,23,20,7,3,1,70,Polski Cukier SIDEn Toruń,Sezon 2012/2013
2012-11-24 18:00,PBS BANK EFIR ENERGY MOSiR Krosno(w),74 : 82W,82,16,32,50.0,11,30,36.7,27,62,43.5,17,22,77.3,13,24,37,17,25,23,18,5,0,1,83,Polski Cukier SIDEn Toruń,Sezon 2012/2013
2012-12-01 18:30,KS Spójnia Stargard Szczeciński(d),75 : 84P,75,24,46,52.2,5,18,27.8,29,64,45.3,12,24,50.0,12,30,42,20,25,23,15,4,4,1,83,Polski Cukier SIDEn Toruń,Sezon 2012/2013
2012-12-05 19:00,Franz Astoria Bydgoszcz(w),101 : 90P,90,25,42,59.5,9,21,42.9,34,63,54.0,13,18,72.2,8,22,30,24,25,19,19,6,4,2,101,Polski Cukier SIDEn Toruń,Sezon 2012/2013
2012-12-08 18:30,WKS Śląsk Wrocław(d),62 : 72P,62,19,57,33.3,6,16,37.5,25,73,34.2,6,11,54.5,10,28,38,13,26,20,15,7,2,8,54,Polski Cukier SIDEn Toruń,Sezon 2012/2013
2012-12-15 18:30,BM SLAM STAL Ostrów Wielkopolski(w),76 : 69P,69,16,38,42.1,8,23,34.8,24,61,39.3,13,16,81.3,9,27,36,14,20,22,18,10,2,1,73,Polski Cukier SIDEn Toruń,Sezon 2012/2013
2012-12-19 18:30,WIKANA START SA Lublin(d),81 : 64W,81,21,36,58.3,9,28,32.1,30,64,46.9,12,19,63.2,8,27,35,18,23,22,11,7,4,0,93,Polski Cukier SIDEn Toruń,Sezon 2012/2013
2013-01-05 18:30,Siedlecki Klub Koszykówki Siedlce(d),67 : 53W,67,18,37,48.6,5,18,27.8,23,55,41.8,16,22,72.7,7,24,31,14,17,23,11,7,2,0,72,Polski Cukier SIDEn Toruń,Sezon 2012/2013
2013-01-09 18:00,NETO PTG Sokół Łańcut(w),57 : 61W,61,19,32,59.4,4,18,22.2,23,50,46.0,11,22,50.0,10,32,42,12,24,19,23,8,8,4,70,Polski Cukier SIDEn Toruń,Sezon 2012/2013
2013-01-13 18:30,MKS Dąbrowa Górnicza II(d),75 : 68W,75,22,44,50.0,7,20,35.0,29,64,45.3,10,17,58.8,10,31,41,16,17,20,8,3,3,5,88,Polski Cukier SIDEn Toruń,Sezon 2012/2013
2013-01-20 17:00,MKS Znicz Basket Pruszków(w),61 : 43P,43,14,33,42.4,2,20,10.0,16,53,30.2,9,13,69.2,6,29,35,6,16,20,18,5,4,3,34,Polski Cukier SIDEn Toruń,Sezon 2012/2013
2013-01-26 17:30,UMKS Kielce(d),82 : 64W,82,22,42,52.4,9,23,39.1,31,65,47.7,11,12,91.7,12,26,38,25,17,19,13,8,3,2,108,Polski Cukier SIDEn Toruń,Sezon 2012/2013
2013-01-30 18:00,AZS WSGK POLFARMEX Kutno(w),74 : 67P,67,17,38,44.7,7,13,53.8,24,51,47.1,12,20,60.0,0,22,22,13,16,19,9,2,1,2,61,Polski Cukier SIDEn Toruń,Sezon 2012/2013
2013-02-03 18:30,AZS Politechnika Poznań(d),77 : 68W,77,27,44,61.4,3,12,25.0,30,56,53.6,14,20,70.0,3,22,25,26,13,20,14,8,8,4,98,Polski Cukier SIDEn Toruń,Sezon 2012/2013
2013-02-09 18:30,BUDIMPEX-POLONIA Przemyśl(d),77 : 79P,77,21,42,50.0,7,24,29.2,28,66,42.4,14,23,60.9,12,29,41,17,19,22,18,4,7,1,81,Polski Cukier SIDEn Toruń,Sezon 2012/2013
2013-02-16 18:00,AZS Radex Szczecin(w),81 : 76P,76,20,39,51.3,5,18,27.8,25,57,43.9,21,27,77.8,9,25,34,16,17,24,16,2,2,4,76,Polski Cukier SIDEn Toruń,Sezon 2012/2013
2013-02-23 18:30,PBS BANK EFIR ENERGY MOSiR Krosno(d),74 : 66W,74,17,31,54.8,8,21,38.1,25,52,48.1,16,27,59.3,6,21,27,13,25,26,13,10,4,0,77,Polski Cukier SIDEn Toruń,Sezon 2012/2013
2013-03-02 17:00,KS Spójnia Stargard Szczeciński(w),57 : 64W,64,14,28,50.0,5,22,22.7,19,50,38.0,21,29,72.4,6,22,28,11,16,21,14,10,3,2,63,Polski Cukier SIDEn Toruń,Sezon 2012/2013
2013-03-06 18:30,Franz Astoria Bydgoszcz(d),92 : 77W,92,32,52,61.5,4,14,28.6,36,66,54.5,16,24,66.7,4,27,31,29,23,23,10,5,4,1,113,Polski Cukier SIDEn Toruń,Sezon 2012/2013
2013-03-10 19:15,WKS Śląsk Wrocław(w),75 : 67P,67,23,44,52.3,3,15,20.0,26,59,44.1,12,17,70.6,6,26,32,13,26,23,13,11,1,3,73,Polski Cukier SIDEn Toruń,Sezon 2012/2013
2013-03-17 19:30,BM SLAM STAL Ostrów Wielkopolski(d),86 : 70W,86,28,42,66.7,4,20,20.0,32,62,51.6,18,20,90.0,10,22,32,21,15,23,14,9,3,2,105,Polski Cukier SIDEn Toruń,Sezon 2012/2013
2013-03-24 18:00,WIKANA START SA Lublin(w),78 : 75P,75,24,39,61.5,6,19,31.6,30,58,51.7,9,16,56.3,9,21,30,18,21,20,11,4,2,0,83,Polski Cukier SIDEn Toruń,Sezon 2012/2013
2013-04-06 19:00,NETO PTG Sokół Łańcut(d),78 : 69W,78,23,41,56.1,3,21,14.3,26,62,41.9,23,31,74.2,13,31,44,19,19,28,10,6,6,3,99,Polski Cukier SIDEn Toruń,Sezon 2012/2013
2013-04-07 18:00,NETO PTG Sokół Łańcut(d),81 : 73W,81,18,39,46.2,10,19,52.6,28,58,48.3,15,19,78.9,13,24,37,18,22,16,19,1,6,1,90,Polski Cukier SIDEn Toruń,Sezon 2012/2013
2013-04-13 18:00,NETO PTG Sokół Łańcut(w),77 : 85W,85,24,46,52.2,6,22,27.3,30,68,44.1,19,25,76.0,13,26,39,18,19,21,14,11,1,2,96,Polski Cukier SIDEn Toruń,Sezon 2012/2013
2013-04-20 19:15,WKS Śląsk Wrocław(w),70 : 63P,63,24,55,43.6,3,13,23.1,27,68,39.7,6,9,66.7,10,30,40,10,18,15,13,9,3,4,68,Polski Cukier SIDEn Toruń,Sezon 2012/2013
2013-04-21 19:15,WKS Śląsk Wrocław(w),95 : 52P,52,16,40,40.0,4,12,33.3,20,52,38.5,8,15,53.3,6,16,22,9,23,20,22,12,3,6,37,Polski Cukier SIDEn Toruń,Sezon 2012/2013
2013-04-27 17:30,WKS Śląsk Wrocław(d),80 : 77W,80,24,46,52.2,4,15,26.7,28,61,45.9,20,32,62.5,11,20,31,14,25,29,15,9,3,4,77,Polski Cukier SIDEn Toruń,Sezon 2012/2013
2013-04-28 17:30,WKS Śląsk Wrocław(d),87 : 78W,87,34,61,55.7,3,14,21.4,37,75,49.3,10,11,90.9,11,26,37,16,24,21,11,6,5,3,101,Polski Cukier SIDEn Toruń,Sezon 2012/2013
2013-05-01 19:15,WKS Śląsk Wrocław(w),73 : 57P,57,9,28,32.1,5,18,27.8,14,46,30.4,24,31,77.4,7,25,32,6,19,31,16,12,2,2,54,Polski Cukier SIDEn Toruń,Sezon 2012/2013
2013-05-04 18:00,AZS WSGK POLFARMEX Kutno(d),73 : 73P,73,22,37,59.5,6,15,40.0,28,52,53.8,11,18,61.1,9,32,41,20,15,21,25,4,4,1,86,Polski Cukier SIDEn Toruń,Sezon 2012/2013
2013-05-11 17:30,AZS WSGK POLFARMEX Kutno(w),84 : 81P,81,21,35,60.0,9,18,50.0,30,53,56.6,12,20,60.0,3,24,27,20,19,19,17,4,4,1,88,Polski Cukier SIDEn Toruń,Sezon 2012/2013
2012-09-29 18:00,Polski Cukier SIDEn Toruń(d),54 : 65P,54,20,44,45.5,1,13,7.7,21,57,36.8,11,15,73.3,9,16,25,10,16,17,15,7,1,0,42,Siedlecki Klub Koszykówki Siedlce,Sezon 2012/2013
2012-10-03 18:00,AZS Radex Szczecin(w),58 : 67W,67,20,52,38.5,3,11,27.3,23,63,36.5,18,24,75.0,15,22,37,11,24,24,13,8,1,0,65,Siedlecki Klub Koszykówki Siedlce,Sezon 2012/2013
2012-10-07 17:00,PBS BANK EFIR ENERGY MOSiR Krosno(d),67 : 69P,67,15,30,50.0,8,21,38.1,23,51,45.1,13,19,68.4,10,25,35,13,20,23,19,6,2,0,70,Siedlecki Klub Koszykówki Siedlce,Sezon 2012/2013
2012-10-13 17:00,KS Spójnia Stargard Szczeciński(w),57 : 69W,69,21,45,46.7,3,13,23.1,24,58,41.4,18,28,64.3,14,27,41,13,24,26,10,5,1,0,75,Siedlecki Klub Koszykówki Siedlce,Sezon 2012/2013
2012-10-20 18:00,Franz Astoria Bydgoszcz(d),88 : 78W,88,30,49,61.2,2,13,15.4,32,62,51.6,22,31,71.0,12,24,36,13,21,29,12,9,4,0,99,Siedlecki Klub Koszykówki Siedlce,Sezon 2012/2013
2012-10-28 18:15,WKS Śląsk Wrocław(w),83 : 35P,35,9,36,25.0,3,18,16.7,12,54,22.2,8,14,57.1,6,22,28,3,34,17,16,6,0,0,8,Siedlecki Klub Koszykówki Siedlce,Sezon 2012/2013
2012-11-03 18:00,BM SLAM STAL Ostrów Wielkopolski(d),64 : 97P,64,21,53,39.6,4,15,26.7,25,68,36.8,10,17,58.8,15,18,33,9,29,21,14,4,0,3,46,Siedlecki Klub Koszykówki Siedlce,Sezon 2012/2013
2012-11-11 18:00,WIKANA START SA Lublin(w),85 : 74P,74,23,47,48.9,6,21,28.6,29,68,42.6,10,17,58.8,6,24,30,17,26,20,14,9,2,0,72,Siedlecki Klub Koszykówki Siedlce,Sezon 2012/2013
2012-11-17 18:00,BUDIMPEX-POLONIA Przemyśl(d),50 : 59P,50,16,43,37.2,4,25,16.0,20,68,29.4,6,15,40.0,14,27,41,6,16,16,8,6,1,4,39,Siedlecki Klub Koszykówki Siedlce,Sezon 2012/2013
2012-11-24 20:00,NETO PTG Sokół Łańcut(d),54 : 88P,54,14,35,40.0,6,15,40.0,20,50,40.0,8,19,42.1,9,15,24,6,20,19,24,8,0,1,27,Siedlecki Klub Koszykówki Siedlce,Sezon 2012/2013
2012-12-02 18:00,MKS Dąbrowa Górnicza II(w),96 : 66P,66,21,41,51.2,4,20,20.0,25,61,41.0,12,16,75.0,10,18,28,8,15,16,14,5,3,0,56,Siedlecki Klub Koszykówki Siedlce,Sezon 2012/2013
2012-12-05 18:00,MKS Znicz Basket Pruszków(d),83 : 65W,83,24,48,50.0,7,22,31.8,31,70,44.3,14,20,70.0,16,22,38,16,21,21,13,8,0,1,87,Siedlecki Klub Koszykówki Siedlce,Sezon 2012/2013
2012-12-08 18:30,UMKS Kielce(w),47 : 83W,83,21,41,51.2,8,22,36.4,29,63,46.0,17,19,89.5,10,29,39,19,16,21,11,9,1,0,104,Siedlecki Klub Koszykówki Siedlce,Sezon 2012/2013
2012-12-16 17:00,AZS WSGK POLFARMEX Kutno(d),58 : 70P,58,17,30,56.7,4,20,20.0,21,50,42.0,12,16,75.0,8,26,34,9,15,20,19,5,2,1,56,Siedlecki Klub Koszykówki Siedlce,Sezon 2012/2013
2012-12-19 17:00,AZS Politechnika Poznań(w),77 : 74P,74,16,40,40.0,9,25,36.0,25,65,38.5,15,21,71.4,15,31,46,14,18,22,19,6,3,5,78,Siedlecki Klub Koszykówki Siedlce,Sezon 2012/2013
2013-01-05 18:30,Polski Cukier SIDEn Toruń(w),67 : 53P,53,15,38,39.5,4,13,30.8,19,51,37.3,11,16,68.8,8,22,30,10,23,16,18,3,0,2,41,Siedlecki Klub Koszykówki Siedlce,Sezon 2012/2013
2013-01-09 18:00,AZS Radex Szczecin(d),68 : 77P,68,23,45,51.1,4,13,30.8,27,58,46.6,10,18,55.6,10,21,31,13,20,18,11,1,2,2,65,Siedlecki Klub Koszykówki Siedlce,Sezon 2012/2013
2013-01-13 18:00,PBS BANK EFIR ENERGY MOSiR Krosno(w),67 : 61P,61,16,37,43.2,7,19,36.8,23,56,41.1,8,14,57.1,7,25,32,13,26,17,17,8,0,1,58,Siedlecki Klub Koszykówki Siedlce,Sezon 2012/2013
2013-01-20 18:00,KS Spójnia Stargard Szczeciński(d),47 : 78P,47,10,40,25.0,6,15,40.0,16,55,29.1,9,16,56.3,12,28,40,11,17,14,20,4,2,2,38,Siedlecki Klub Koszykówki Siedlce,Sezon 2012/2013
2013-01-26 17:00,Franz Astoria Bydgoszcz(w),78 : 71P,71,19,36,52.8,4,23,17.4,23,59,39.0,21,30,70.0,11,23,34,16,19,25,14,9,3,3,74,Siedlecki Klub Koszykówki Siedlce,Sezon 2012/2013
2013-01-30 18:00,WKS Śląsk Wrocław(d),58 : 83P,58,17,48,35.4,5,18,27.8,22,66,33.3,9,10,90.0,8,26,34,13,26,17,16,3,2,1,49,Siedlecki Klub Koszykówki Siedlce,Sezon 2012/2013
2013-02-03 18:30,BM SLAM STAL Ostrów Wielkopolski(w),80 : 74P,74,20,41,48.8,8,19,42.1,28,60,46.7,10,18,55.6,12,24,36,14,18,18,15,8,0,3,77,Siedlecki Klub Koszykówki Siedlce,Sezon 2012/2013
2013-02-09 20:00,WIKANA START SA Lublin(d),64 : 75P,64,20,42,47.6,5,25,20.0,25,67,37.3,9,12,75.0,11,17,28,17,25,15,12,5,0,1,57,Siedlecki Klub Koszykówki Siedlce,Sezon 2012/2013
2013-02-16 18:00,BUDIMPEX-POLONIA Przemyśl(w),60 : 72W,72,20,38,52.6,8,18,44.4,28,56,50.0,8,12,66.7,8,32,40,8,20,17,14,6,2,3,82,Siedlecki Klub Koszykówki Siedlce,Sezon 2012/2013
2013-02-23 18:00,NETO PTG Sokół Łańcut(w),64 : 68W,68,20,44,45.5,6,17,35.3,26,61,42.6,10,13,76.9,9,24,33,13,22,19,10,10,3,1,79,Siedlecki Klub Koszykówki Siedlce,Sezon 2012/2013
2013-03-02 19:00,MKS Dąbrowa Górnicza II(d),65 : 69P,65,24,45,53.3,3,17,17.6,27,62,43.5,8,11,72.7,6,31,37,10,22,14,15,5,3,3,67,Siedlecki Klub Koszykówki Siedlce,Sezon 2012/2013
2013-03-06 19:00,MKS Znicz Basket Pruszków(w),81 : 61P,61,17,38,44.7,6,23,26.1,23,61,37.7,9,21,42.9,9,22,31,14,15,19,12,6,0,4,50,Siedlecki Klub Koszykówki Siedlce,Sezon 2012/2013
2013-03-09 18:00,UMKS Kielce(d),66 : 58W,66,17,31,54.8,6,19,31.6,23,50,46.0,14,24,58.3,4,29,33,18,18,20,15,9,1,0,75,Siedlecki Klub Koszykówki Siedlce,Sezon 2012/2013
2013-03-16 17:30,AZS WSGK POLFARMEX Kutno(w),64 : 52P,52,15,39,38.5,2,12,16.7,17,51,33.3,16,25,64.0,7,22,29,9,13,24,16,7,3,10,41,Siedlecki Klub Koszykówki Siedlce,Sezon 2012/2013
2013-03-24 18:00,AZS Politechnika Poznań(d),68 : 94P,68,20,39,51.3,8,23,34.8,28,62,45.2,4,11,36.4,9,18,27,13,14,18,18,8,3,0,60,Siedlecki Klub Koszykówki Siedlce,Sezon 2012/2013
2013-04-06 18:00,BUDIMPEX-POLONIA Przemyśl(w),68 : 54P,54,21,43,48.8,3,21,14.3,24,64,37.5,3,7,42.9,10,26,36,11,18,15,14,6,2,4,51,Siedlecki Klub Koszykówki Siedlce,Sezon 2012/2013
2013-04-07 17:00,BUDIMPEX-POLONIA Przemyśl(w),65 : 62P,62,20,45,44.4,4,13,30.8,24,58,41.4,10,11,90.9,7,27,34,12,25,14,12,5,2,4,68,Siedlecki Klub Koszykówki Siedlce,Sezon 2012/2013
2013-04-13 18:00,BUDIMPEX-POLONIA Przemyśl(d),62 : 70P,62,18,45,40.0,6,23,26.1,24,68,35.3,8,11,72.7,11,22,33,11,27,16,11,4,1,4,53,Siedlecki Klub Koszykówki Siedlce,Sezon 2012/2013
2012-09-29 18:00,MKS Znicz Basket Pruszków(w),76 : 60P,60,15,36,41.7,6,13,46.2,21,49,42.9,12,21,57.1,4,19,23,13,20,19,15,4,2,0,50,UMKS Kielce,Sezon 2012/2013
2012-10-03 18:00,BUDIMPEX-POLONIA Przemyśl(w),64 : 65W,65,23,49,46.9,4,14,28.6,27,63,42.9,7,14,50.0,10,21,31,17,17,16,15,8,0,0,63,UMKS Kielce,Sezon 2012/2013
2012-10-06 17:00,AZS WSGK POLFARMEX Kutno(d),65 : 89P,65,22,42,52.4,2,11,18.2,24,53,45.3,15,25,60.0,5,19,24,9,22,25,19,5,1,0,46,UMKS Kielce,Sezon 2012/2013
2012-10-14 17:00,AZS Politechnika Poznań(w),65 : 73W,73,19,38,50.0,5,16,31.3,24,54,44.4,20,30,66.7,6,29,35,15,19,27,18,7,2,0,74,UMKS Kielce,Sezon 2012/2013
2012-10-20 17:00,Polski Cukier SIDEn Toruń(d),55 : 69P,55,20,44,45.5,2,18,11.1,22,62,35.5,9,16,56.3,6,21,27,10,21,20,14,9,2,1,42,UMKS Kielce,Sezon 2012/2013
2012-10-27 18:00,AZS Radex Szczecin(w),82 : 74P,74,20,35,57.1,6,17,35.3,26,52,50.0,16,18,88.9,5,22,27,17,24,22,20,6,0,1,76,UMKS Kielce,Sezon 2012/2013
2012-11-03 18:30,PBS BANK EFIR ENERGY MOSiR Krosno(d),71 : 76P,71,22,33,66.7,6,21,28.6,28,54,51.9,9,12,75.0,9,16,25,18,13,15,21,8,2,1,74,UMKS Kielce,Sezon 2012/2013
2012-11-10 18:30,KS Spójnia Stargard Szczeciński(d),71 : 68W,71,18,34,52.9,7,21,33.3,25,55,45.5,14,20,70.0,4,23,27,14,17,20,10,8,3,2,77,UMKS Kielce,Sezon 2012/2013
2012-11-17 18:00,Franz Astoria Bydgoszcz(d),66 : 92P,66,21,46,45.7,4,22,18.2,25,68,36.8,12,19,63.2,9,12,21,17,23,20,12,7,3,1,52,UMKS Kielce,Sezon 2012/2013
2012-11-24 19:15,WKS Śląsk Wrocław(w),78 : 62P,62,16,37,43.2,8,23,34.8,24,60,40.0,6,10,60.0,9,23,32,11,18,13,16,7,1,0,57,UMKS Kielce,Sezon 2012/2013
2012-12-01 18:30,BM SLAM STAL Ostrów Wielkopolski(d),68 : 77P,68,13,34,38.2,10,24,41.7,23,58,39.7,12,15,80.0,5,20,25,18,25,20,16,10,3,1,70,UMKS Kielce,Sezon 2012/2013
2012-12-05 18:00,WIKANA START SA Lublin(w),79 : 77P,77,17,37,45.9,11,24,45.8,28,61,45.9,10,15,66.7,7,22,29,14,25,20,18,11,4,1,79,UMKS Kielce,Sezon 2012/2013
2012-12-08 18:30,Siedlecki Klub Koszykówki Siedlce(d),47 : 83P,47,14,31,45.2,2,19,10.5,16,50,32.0,13,18,72.2,4,23,27,8,21,16,18,4,0,1,29,UMKS Kielce,Sezon 2012/2013
2012-12-15 18:00,NETO PTG Sokół Łańcut(w),75 : 64P,64,17,33,51.5,5,20,25.0,22,53,41.5,15,27,55.6,6,21,27,9,23,23,16,7,2,1,50,UMKS Kielce,Sezon 2012/2013
2012-12-19 19:00,MKS Dąbrowa Górnicza II(d),81 : 86P,81,24,51,47.1,7,21,33.3,31,72,43.1,12,17,70.6,7,23,30,21,24,17,15,12,6,0,89,UMKS Kielce,Sezon 2012/2013
2013-01-05 17:00,MKS Znicz Basket Pruszków(d),68 : 73P,68,29,47,61.7,1,16,6.3,30,63,47.6,7,9,77.8,7,19,26,20,23,16,14,6,2,1,73,UMKS Kielce,Sezon 2012/2013
2013-01-09 19:30,BUDIMPEX-POLONIA Przemyśl(d),73 : 77P,73,21,42,50.0,7,18,38.9,28,60,46.7,10,11,90.9,8,20,28,15,19,16,17,9,0,1,75,UMKS Kielce,Sezon 2012/2013
2013-01-12 17:30,AZS WSGK POLFARMEX Kutno(w),77 : 51P,51,18,40,45.0,4,13,30.8,22,53,41.5,3,12,25.0,4,20,24,12,17,15,11,4,2,3,42,UMKS Kielce,Sezon 2012/2013
2013-01-19 17:15,AZS Politechnika Poznań(d),82 : 76W,82,22,37,59.5,7,22,31.8,29,59,49.2,17,20,85.0,7,23,30,20,17,23,16,2,3,4,88,UMKS Kielce,Sezon 2012/2013
2013-01-26 17:30,Polski Cukier SIDEn Toruń(w),82 : 64P,64,19,43,44.2,5,16,31.3,24,59,40.7,11,17,64.7,10,18,28,11,19,17,14,4,2,3,54,UMKS Kielce,Sezon 2012/2013
2013-01-30 19:45,AZS Radex Szczecin(d),66 : 84P,66,19,40,47.5,5,18,27.8,24,58,41.4,13,14,92.9,5,16,21,13,18,15,11,3,2,1,59,UMKS Kielce,Sezon 2012/2013
2013-02-03 18:00,PBS BANK EFIR ENERGY MOSiR Krosno(w),85 : 61P,61,15,43,34.9,6,15,40.0,21,58,36.2,13,20,65.0,6,22,28,12,19,21,18,6,2,2,47,UMKS Kielce,Sezon 2012/2013
2013-02-09 17:00,KS Spójnia Stargard Szczeciński(w),67 : 62P,62,15,30,50.0,7,22,31.8,22,52,42.3,11,16,68.8,7,19,26,8,20,19,14,3,3,1,53,UMKS Kielce,Sezon 2012/2013
2013-02-17 17:00,Franz Astoria Bydgoszcz(w),86 : 75P,75,18,44,40.9,5,21,23.8,23,65,35.4,24,28,85.7,14,25,39,11,19,20,19,8,3,5,71,UMKS Kielce,Sezon 2012/2013
2013-02-22 18:30,WKS Śląsk Wrocław(d),79 : 90P,79,24,51,47.1,9,15,60.0,33,66,50.0,4,6,66.7,6,19,25,20,23,11,8,5,1,2,87,UMKS Kielce,Sezon 2012/2013
2013-03-02 18:30,BM SLAM STAL Ostrów Wielkopolski(w),88 : 54P,54,16,42,38.1,5,16,31.3,21,58,36.2,7,12,58.3,9,16,25,9,17,20,19,8,0,2,35,UMKS Kielce,Sezon 2012/2013
2013-03-06 19:30,WIKANA START SA Lublin(d),89 : 87W,89,25,39,64.1,8,21,38.1,33,60,55.0,15,20,75.0,4,25,29,16,17,21,15,8,3,0,98,UMKS Kielce,Sezon 2012/2013
2013-03-09 18:00,Siedlecki Klub Koszykówki Siedlce(w),66 : 58P,58,22,44,50.0,3,11,27.3,25,55,45.5,5,9,55.6,2,23,25,8,20,18,14,7,0,1,50,UMKS Kielce,Sezon 2012/2013
2013-03-16 17:30,NETO PTG Sokół Łańcut(d),59 : 75P,59,23,43,53.5,2,18,11.1,25,61,41.0,7,10,70.0,6,19,25,14,18,14,16,4,2,3,49,UMKS Kielce,Sezon 2012/2013
2013-03-23 18:00,MKS Dąbrowa Górnicza II(w),90 : 74P,74,22,47,46.8,5,17,29.4,27,64,42.2,15,25,60.0,8,17,25,9,25,25,14,12,0,1,59,UMKS Kielce,Sezon 2012/2013
2013-04-06 20:00,MKS Znicz Basket Pruszków(w),57 : 23P,23,6,26,23.1,1,15,6.7,7,41,17.1,8,22,36.4,7,24,31,3,16,22,23,3,2,4,-9,UMKS Kielce,Sezon 2012/2013
2013-04-07 18:00,MKS Znicz Basket Pruszków(w),64 : 71W,71,17,33,51.5,9,21,42.9,26,54,48.1,10,20,50.0,7,25,32,10,17,18,15,10,4,2,74,UMKS Kielce,Sezon 2012/2013
2013-04-13 17:30,MKS Znicz Basket Pruszków(d),70 : 72P,70,19,44,43.2,7,26,26.9,26,70,37.1,11,12,91.7,13,26,39,15,23,15,12,5,2,0,74,UMKS Kielce,Sezon 2012/2013
2013-04-14 17:30,MKS Znicz Basket Pruszków(d),73 : 75P,73,14,30,46.7,10,28,35.7,24,58,41.4,15,23,65.2,7,16,23,13,15,21,12,8,3,1,66,UMKS Kielce,Sezon 2012/2013
2012-09-29 18:00,AZS Radex Szczecin(w),74 : 85W,85,29,42,69.0,2,18,11.1,31,60,51.7,21,28,75.0,8,15,23,9,17,24,7,9,0,0,83,WIKANA START SA Lublin,Sezon 2012/2013
2012-10-03 18:00,PBS BANK EFIR ENERGY MOSiR Krosno(w),86 : 71P,71,14,35,40.0,7,15,46.7,21,50,42.0,22,29,75.9,4,15,19,11,25,27,14,7,1,0,59,WIKANA START SA Lublin,Sezon 2012/2013
2012-10-07 18:00,KS Spójnia Stargard Szczeciński(d),56 : 79P,56,17,37,45.9,4,19,21.1,21,56,37.5,10,12,83.3,8,28,36,13,20,15,20,3,3,0,54,WIKANA START SA Lublin,Sezon 2012/2013
2012-10-13 19:00,Franz Astoria Bydgoszcz(w),83 : 81P,81,21,40,52.5,7,21,33.3,28,61,45.9,18,25,72.0,12,27,39,16,28,23,16,3,1,3,84,WIKANA START SA Lublin,Sezon 2012/2013
2012-10-19 19:00,WKS Śląsk Wrocław(d),52 : 85P,52,14,38,36.8,4,25,16.0,18,63,28.6,12,13,92.3,8,20,28,11,20,18,11,8,1,1,43,WIKANA START SA Lublin,Sezon 2012/2013
2012-10-27 18:30,BM SLAM STAL Ostrów Wielkopolski(w),88 : 65P,65,19,34,55.9,5,22,22.7,24,56,42.9,12,19,63.2,10,17,27,14,24,26,20,9,3,1,59,WIKANA START SA Lublin,Sezon 2012/2013
2012-11-04 18:00,BUDIMPEX-POLONIA Przemyśl(d),92 : 61W,92,24,42,57.1,8,21,38.1,32,63,50.8,20,28,71.4,12,28,40,23,15,25,9,11,1,1,119,WIKANA START SA Lublin,Sezon 2012/2013
2012-11-11 18:00,Siedlecki Klub Koszykówki Siedlce(d),85 : 74W,85,21,41,51.2,6,29,20.7,27,70,38.6,25,37,67.6,16,32,48,15,20,26,18,7,0,2,82,WIKANA START SA Lublin,Sezon 2012/2013
2012-11-17 18:00,NETO PTG Sokół Łańcut(w),76 : 72P,72,16,43,37.2,7,14,50.0,23,57,40.4,19,27,70.4,16,26,42,11,26,24,14,3,1,5,73,WIKANA START SA Lublin,Sezon 2012/2013
2012-11-24 18:00,MKS Dąbrowa Górnicza II(d),85 : 74W,85,24,49,49.0,7,20,35.0,31,69,44.9,16,21,76.2,14,22,36,13,20,17,7,10,1,1,95,WIKANA START SA Lublin,Sezon 2012/2013
2012-12-01 20:00,MKS Znicz Basket Pruszków(w),73 : 65P,65,13,33,39.4,10,29,34.5,23,62,37.1,9,14,64.3,10,24,34,12,21,17,15,4,1,3,57,WIKANA START SA Lublin,Sezon 2012/2013
2012-12-05 18:00,UMKS Kielce(d),79 : 77W,79,18,41,43.9,8,25,32.0,26,66,39.4,19,28,67.9,16,22,38,13,20,25,15,11,1,4,78,WIKANA START SA Lublin,Sezon 2012/2013
2012-12-08 17:30,AZS WSGK POLFARMEX Kutno(w),89 : 59P,59,16,36,44.4,5,22,22.7,21,58,36.2,12,17,70.6,8,14,22,11,16,17,14,2,0,2,38,WIKANA START SA Lublin,Sezon 2012/2013
2012-12-15 18:00,AZS Politechnika Poznań(d),95 : 62W,95,25,41,61.0,10,24,41.7,35,65,53.8,15,19,78.9,9,29,38,26,17,18,14,9,1,4,121,WIKANA START SA Lublin,Sezon 2012/2013
2012-12-19 18:30,Polski Cukier SIDEn Toruń(w),81 : 64P,64,13,32,40.6,6,27,22.2,19,59,32.2,20,29,69.0,12,19,31,16,22,23,14,8,0,4,56,WIKANA START SA Lublin,Sezon 2012/2013
2013-01-06 18:00,AZS Radex Szczecin(d),84 : 82W,84,15,28,53.6,13,24,54.2,28,52,53.8,15,27,55.6,7,20,27,15,14,22,15,4,1,4,80,WIKANA START SA Lublin,Sezon 2012/2013
2013-01-09 18:00,PBS BANK EFIR ENERGY MOSiR Krosno(d),75 : 70W,75,20,39,51.3,7,23,30.4,27,62,43.5,14,23,60.9,11,21,32,17,17,24,9,8,1,0,80,WIKANA START SA Lublin,Sezon 2012/2013
2013-01-12 17:00,KS Spójnia Stargard Szczeciński(w),70 : 56P,56,11,35,31.4,4,21,19.0,15,56,26.8,22,28,78.6,10,21,31,9,19,24,11,5,0,6,43,WIKANA START SA Lublin,Sezon 2012/2013
2013-01-19 18:00,Franz Astoria Bydgoszcz(d),71 : 70W,71,23,53,43.4,4,14,28.6,27,67,40.3,13,14,92.9,13,27,40,17,20,19,14,9,0,3,82,WIKANA START SA Lublin,Sezon 2012/2013
2013-01-26 19:15,WKS Śląsk Wrocław(w),97 : 67P,67,21,47,44.7,4,8,50.0,25,55,45.5,13,17,76.5,8,15,23,9,20,22,16,10,1,1,60,WIKANA START SA Lublin,Sezon 2012/2013
2013-01-30 18:00,BM SLAM STAL Ostrów Wielkopolski(d),79 : 56W,79,21,43,48.8,6,22,27.3,27,65,41.5,19,23,82.6,11,28,39,9,14,27,10,11,1,4,87,WIKANA START SA Lublin,Sezon 2012/2013
2013-02-03 17:00,BUDIMPEX-POLONIA Przemyśl(w),85 : 98W,98,24,38,63.2,13,31,41.9,37,69,53.6,11,15,73.3,11,16,27,22,19,15,9,8,1,4,111,WIKANA START SA Lublin,Sezon 2012/2013
2013-02-09 20:00,Siedlecki Klub Koszykówki Siedlce(w),64 : 75W,75,25,44,56.8,4,21,19.0,29,65,44.6,13,25,52.0,14,25,39,14,15,25,15,5,1,0,71,WIKANA START SA Lublin,Sezon 2012/2013
2013-02-16 18:00,NETO PTG Sokół Łańcut(d),84 : 63W,84,28,53,52.8,4,18,22.2,32,71,45.1,16,24,66.7,21,27,48,18,20,19,14,15,4,0,108,WIKANA START SA Lublin,Sezon 2012/2013
2013-02-23 18:00,MKS Dąbrowa Górnicza II(w),84 : 83P,83,23,50,46.0,9,17,52.9,32,67,47.8,10,15,66.7,12,21,33,16,19,20,11,3,1,0,85,WIKANA START SA Lublin,Sezon 2012/2013
2013-03-02 19:00,MKS Znicz Basket Pruszków(d),105 : 87W,105,29,42,69.0,11,22,50.0,40,64,62.5,14,18,77.8,7,20,27,25,15,20,9,14,1,1,135,WIKANA START SA Lublin,Sezon 2012/2013
2013-03-06 19:30,UMKS Kielce(w),89 : 87P,87,26,43,60.5,8,28,28.6,34,71,47.9,11,14,78.6,6,25,31,20,22,17,12,8,0,3,94,WIKANA START SA Lublin,Sezon 2012/2013
2013-03-10 19:00,AZS WSGK POLFARMEX Kutno(d),63 : 73P,63,21,56,37.5,5,21,23.8,26,77,33.8,6,12,50.0,20,31,51,15,13,17,12,6,3,2,69,WIKANA START SA Lublin,Sezon 2012/2013
2013-03-17 18:30,AZS Politechnika Poznań(w),71 : 86W,86,19,39,48.7,10,25,40.0,29,64,45.3,18,20,90.0,11,24,35,26,19,19,15,11,2,4,108,WIKANA START SA Lublin,Sezon 2012/2013
2013-03-24 18:00,Polski Cukier SIDEn Toruń(d),78 : 75W,78,17,33,51.5,10,28,35.7,27,61,44.3,14,19,73.7,9,20,29,18,20,21,8,6,0,2,84,WIKANA START SA Lublin,Sezon 2012/2013
2013-04-06 20:15,WKS Śląsk Wrocław(w),82 : 72P,72,24,50,48.0,3,18,16.7,27,68,39.7,15,20,75.0,10,25,35,5,24,17,13,7,1,7,61,WIKANA START SA Lublin,Sezon 2012/2013
2013-04-07 20:15,WKS Śląsk Wrocław(w),76 : 64P,64,12,32,37.5,9,24,37.5,21,56,37.5,13,17,76.5,7,21,28,9,26,17,17,13,2,2,60,WIKANA START SA Lublin,Sezon 2012/2013
2013-04-13 18:00,WKS Śląsk Wrocław(d),65 : 83P,65,21,44,47.7,3,20,15.0,24,64,37.5,14,20,70.0,10,24,34,11,27,19,12,5,1,1,58,WIKANA START SA Lublin,Sezon 2012/2013
2012-09-29 19:15,KS Spójnia Stargard Szczeciński(d),75 : 80P,75,22,38,57.9,3,21,14.3,25,59,42.4,22,32,68.8,9,21,30,6,25,26,8,12,4,0,75,WKS Śląsk Wrocław,Sezon 2012/2013
2012-10-03 19:00,Franz Astoria Bydgoszcz(w),61 : 92W,92,29,47,61.7,8,24,33.3,37,71,52.1,10,19,52.6,13,20,33,21,22,25,13,13,0,0,103,WKS Śląsk Wrocław,Sezon 2012/2013
2012-10-06 19:15,BUDIMPEX-POLONIA Przemyśl(d),75 : 66W,75,12,32,37.5,11,22,50.0,23,54,42.6,18,27,66.7,12,26,38,14,18,23,20,14,2,0,83,WKS Śląsk Wrocław,Sezon 2012/2013
2012-10-14 15:00,BM SLAM STAL Ostrów Wielkopolski(d),88 : 72W,88,26,46,56.5,5,21,23.8,31,67,46.3,21,27,77.8,13,23,36,16,24,24,9,20,1,0,110,WKS Śląsk Wrocław,Sezon 2012/2013
2012-10-19 19:00,WIKANA START SA Lublin(w),52 : 85W,85,29,50,58.0,5,16,31.3,34,66,51.5,12,16,75.0,12,34,46,14,18,20,15,1,1,1,96,WKS Śląsk Wrocław,Sezon 2012/2013
2012-10-28 18:15,Siedlecki Klub Koszykówki Siedlce(d),83 : 35W,83,24,37,64.9,4,17,23.5,28,54,51.9,23,39,59.0,6,37,43,14,17,33,8,16,0,0,106,WKS Śląsk Wrocław,Sezon 2012/2013
2012-11-03 18:00,NETO PTG Sokół Łańcut(w),65 : 75W,75,21,43,48.8,5,17,29.4,26,60,43.3,18,27,66.7,10,19,29,11,24,24,15,9,0,1,66,WKS Śląsk Wrocław,Sezon 2012/2013
2012-11-11 18:15,MKS Dąbrowa Górnicza II(d),94 : 62W,94,26,44,59.1,7,17,41.2,33,61,54.1,21,26,80.8,11,24,35,18,25,27,11,15,4,0,122,WKS Śląsk Wrocław,Sezon 2012/2013
2012-11-18 17:00,MKS Znicz Basket Pruszków(w),58 : 75W,75,22,51,43.1,5,14,35.7,27,65,41.5,16,22,72.7,15,30,45,12,15,26,12,9,2,6,87,WKS Śląsk Wrocław,Sezon 2012/2013
2012-11-24 19:15,UMKS Kielce(d),78 : 62W,78,26,50,52.0,5,20,25.0,31,70,44.3,11,17,64.7,14,26,40,18,13,18,9,17,0,0,99,WKS Śląsk Wrocław,Sezon 2012/2013
2012-12-01 17:30,AZS WSGK POLFARMEX Kutno(w),55 : 96W,96,26,47,55.3,8,13,61.5,34,60,56.7,20,24,83.3,9,24,33,14,26,25,16,4,0,1,101,WKS Śląsk Wrocław,Sezon 2012/2013
2012-12-05 19:15,AZS Politechnika Poznań(d),107 : 61W,107,31,50,62.0,6,23,26.1,37,73,50.7,27,35,77.1,16,31,47,24,20,34,11,14,2,3,139,WKS Śląsk Wrocław,Sezon 2012/2013
2012-12-08 18:30,Polski Cukier SIDEn Toruń(w),62 : 72W,72,20,42,47.6,3,14,21.4,23,56,41.1,23,28,82.1,3,29,32,13,20,25,11,7,8,2,83,WKS Śląsk Wrocław,Sezon 2012/2013
2012-12-16 14:00,AZS Radex Szczecin(d),77 : 57W,77,25,44,56.8,2,7,28.6,27,51,52.9,21,26,80.8,4,16,20,14,18,24,9,3,2,0,78,WKS Śląsk Wrocław,Sezon 2012/2013
2012-12-19 18:00,PBS BANK EFIR ENERGY MOSiR Krosno(w),62 : 68W,68,9,36,25.0,13,20,65.0,22,56,39.3,11,16,68.8,11,30,41,10,19,19,21,5,2,3,66,WKS Śląsk Wrocław,Sezon 2012/2013
2013-01-05 17:00,KS Spójnia Stargard Szczeciński(w),71 : 75W,75,21,43,48.8,6,14,42.9,27,57,47.4,15,19,78.9,7,24,31,13,22,19,16,5,3,2,77,WKS Śląsk Wrocław,Sezon 2012/2013
2013-01-09 19:15,Franz Astoria Bydgoszcz(d),104 : 53W,104,31,54,57.4,7,19,36.8,38,73,52.1,21,25,84.0,16,38,54,17,24,23,11,16,3,0,144,WKS Śląsk Wrocław,Sezon 2012/2013
2013-01-12 18:00,BUDIMPEX-POLONIA Przemyśl(w),72 : 86W,86,20,46,43.5,12,18,66.7,32,64,50.0,10,12,83.3,9,28,37,12,21,17,15,5,1,4,92,WKS Śląsk Wrocław,Sezon 2012/2013
2013-01-19 18:30,BM SLAM STAL Ostrów Wielkopolski(w),64 : 87W,87,25,40,62.5,9,24,37.5,34,64,53.1,10,12,83.3,7,21,28,17,22,16,11,13,2,2,104,WKS Śląsk Wrocław,Sezon 2012/2013
2013-01-26 19:15,WIKANA START SA Lublin(d),97 : 67W,97,25,39,64.1,12,22,54.5,37,61,60.7,11,14,78.6,9,23,32,17,22,20,11,15,1,1,124,WKS Śląsk Wrocław,Sezon 2012/2013
2013-01-30 18:00,Siedlecki Klub Koszykówki Siedlce(w),58 : 83W,83,20,46,43.5,7,24,29.2,27,70,38.6,22,29,75.9,14,31,45,9,17,26,10,6,1,2,84,WKS Śląsk Wrocław,Sezon 2012/2013
2013-02-03 18:15,NETO PTG Sokół Łańcut(d),96 : 67W,96,28,49,57.1,9,22,40.9,37,71,52.1,13,20,65.0,14,28,42,12,19,20,9,14,4,0,118,WKS Śląsk Wrocław,Sezon 2012/2013
2013-02-13 19:00,MKS Dąbrowa Górnicza II(w),78 : 87W,87,24,55,43.6,6,17,35.3,30,72,41.7,21,25,84.0,18,22,40,9,22,21,11,12,2,0,93,WKS Śląsk Wrocław,Sezon 2012/2013
2013-02-17 14:00,MKS Znicz Basket Pruszków(d),75 : 69W,75,18,43,41.9,9,23,39.1,27,66,40.9,12,18,66.7,10,28,38,13,20,21,12,17,2,2,88,WKS Śląsk Wrocław,Sezon 2012/2013
2013-02-22 18:30,UMKS Kielce(w),79 : 90W,90,22,38,57.9,9,21,42.9,31,59,52.5,19,23,82.6,8,23,31,20,11,23,8,2,2,1,105,WKS Śląsk Wrocław,Sezon 2012/2013
2013-03-03 18:15,AZS WSGK POLFARMEX Kutno(d),91 : 67W,91,21,40,52.5,11,21,52.4,32,61,52.5,16,22,72.7,5,22,27,12,16,19,8,11,4,1,102,WKS Śląsk Wrocław,Sezon 2012/2013
2013-03-06 17:30,AZS Politechnika Poznań(w),72 : 51P,51,13,35,37.1,4,18,22.2,17,53,32.1,13,18,72.2,6,20,26,10,14,19,23,9,4,2,36,WKS Śląsk Wrocław,Sezon 2012/2013
2013-03-10 19:15,Polski Cukier SIDEn Toruń(d),75 : 67W,75,17,42,40.5,6,18,33.3,23,60,38.3,23,34,67.6,13,28,41,16,24,25,13,12,3,1,86,WKS Śląsk Wrocław,Sezon 2012/2013
2013-03-16 18:00,AZS Radex Szczecin(w),86 : 81P,81,22,44,50.0,4,15,26.7,26,59,44.1,25,35,71.4,12,22,34,16,21,25,12,7,0,2,83,WKS Śląsk Wrocław,Sezon 2012/2013
2013-03-23 18:15,PBS BANK EFIR ENERGY MOSiR Krosno(d),75 : 74W,75,24,48,50.0,4,18,22.2,28,66,42.4,15,18,83.3,12,22,34,11,24,22,17,14,2,1,78,WKS Śląsk Wrocław,Sezon 2012/2013
2013-04-06 20:15,WIKANA START SA Lublin(d),82 : 72W,82,17,34,50.0,10,28,35.7,27,62,43.5,18,28,64.3,6,26,32,13,18,23,8,13,7,1,94,WKS Śląsk Wrocław,Sezon 2012/2013
2013-04-07 20:15,WIKANA START SA Lublin(d),76 : 64W,76,20,37,54.1,8,20,40.0,28,57,49.1,12,26,46.2,11,28,39,17,18,26,14,18,2,2,95,WKS Śląsk Wrocław,Sezon 2012/2013
2013-04-13 18:00,WIKANA START SA Lublin(w),65 : 83W,83,14,39,35.9,9,22,40.9,23,61,37.7,28,36,77.8,12,25,37,10,19,26,11,10,1,1,84,WKS Śląsk Wrocław,Sezon 2012/2013
2013-04-20 19:15,Polski Cukier SIDEn Toruń(d),70 : 63W,70,19,51,37.3,8,25,32.0,27,76,35.5,8,13,61.5,15,27,42,10,15,18,9,12,4,3,75,WKS Śląsk Wrocław,Sezon 2012/2013
2013-04-21 19:15,Polski Cukier SIDEn Toruń(d),95 : 52W,95,29,56,51.8,8,16,50.0,37,72,51.4,13,20,65.0,15,27,42,18,20,23,14,17,6,3,122,WKS Śląsk Wrocław,Sezon 2012/2013
2013-04-27 17:30,Polski Cukier SIDEn Toruń(w),80 : 77P,77,16,41,39.0,7,21,33.3,23,62,37.1,24,31,77.4,14,23,37,15,29,25,15,6,4,3,78,WKS Śląsk Wrocław,Sezon 2012/2013
2013-04-28 17:30,Polski Cukier SIDEn Toruń(w),87 : 78P,78,19,44,43.2,9,25,36.0,28,69,40.6,13,15,86.7,9,22,31,14,21,24,15,3,3,5,71,WKS Śląsk Wrocław,Sezon 2012/2013
2013-05-01 19:15,Polski Cukier SIDEn Toruń(d),73 : 57W,73,16,37,43.2,9,28,32.1,25,65,38.5,14,19,73.7,13,26,39,12,32,18,12,12,2,2,81,WKS Śląsk Wrocław,Sezon 2012/2013
2013-05-05 20:00,PBS BANK EFIR ENERGY MOSiR Krosno(d),75 : 65W,75,17,42,40.5,10,35,28.6,27,77,35.1,11,16,68.8,23,18,41,15,21,24,11,24,1,3,90,WKS Śląsk Wrocław,Sezon 2012/2013
2013-05-06 19:15,PBS BANK EFIR ENERGY MOSiR Krosno(d),73 : 84P,73,18,37,48.6,7,31,22.6,25,68,36.8,16,19,84.2,14,21,35,11,26,18,10,8,3,0,74,WKS Śląsk Wrocław,Sezon 2012/2013
2013-05-11 20:00,PBS BANK EFIR ENERGY MOSiR Krosno(w),85 : 93W,93,23,59,39.0,6,14,42.9,29,73,39.7,29,37,78.4,15,29,44,18,26,30,12,5,2,2,98,WKS Śląsk Wrocław,Sezon 2012/2013
2013-05-12 18:00,PBS BANK EFIR ENERGY MOSiR Krosno(w),50 : 59W,59,15,41,36.6,4,21,19.0,19,62,30.6,17,21,81.0,13,26,39,8,20,23,8,6,2,2,59,WKS Śląsk Wrocław,Sezon 2012/2013
2011-10-02 17:30,MKS Start Lublin(d),93 : 69W,93,29,42,69.0,7,13,53.8,36,55,65.5,14,20,70.0,5,23,28,19,17,28,12,1,3,0,107,AZS Radex Szczecin,Sezon 2011/2012
2011-10-08 18:00,MKS Dąbrowa Górnicza(w),71 : 51P,51,18,42,42.9,3,14,21.4,21,56,37.5,6,11,54.5,10,27,37,9,23,19,22,7,3,0,45,AZS Radex Szczecin,Sezon 2011/2012
2011-10-15 20:00,MKS Znicz Basket Pruszków(d),86 : 78W,86,26,39,66.7,7,17,41.2,33,56,58.9,13,19,68.4,5,20,25,14,25,20,13,8,1,0,92,AZS Radex Szczecin,Sezon 2011/2012
2011-10-19 18:30,Polski Cukier SIDEn Toruń(w),80 : 78P,78,22,40,55.0,5,15,33.3,27,55,49.1,19,21,90.5,4,17,21,21,25,21,15,2,4,0,81,AZS Radex Szczecin,Sezon 2011/2012
2011-10-29 18:00,AZS WSGK POLFARMEX Kutno(d),79 : 66W,79,23,38,60.5,7,18,38.9,30,56,53.6,12,14,85.7,10,20,30,10,15,20,17,9,2,0,85,AZS Radex Szczecin,Sezon 2011/2012
2011-11-05 18:00,MKS Budimpex Polonia Przemyśl(w),76 : 67P,67,21,45,46.7,4,16,25.0,25,61,41.0,13,20,65.0,15,16,31,12,16,23,16,8,0,0,59,AZS Radex Szczecin,Sezon 2011/2012
2011-11-07 18:00,NETO PTG Sokół Łańcut(w),74 : 54P,54,20,48,41.7,3,15,20.0,23,63,36.5,5,9,55.6,12,17,29,8,27,14,22,9,0,0,34,AZS Radex Szczecin,Sezon 2011/2012
2011-11-13 17:30,Delikatesy Centrum PBS Bank MOSiR Krosno(d),75 : 72W,75,17,29,58.6,8,22,36.4,25,51,49.0,17,24,70.8,7,27,34,15,19,24,11,6,4,0,90,AZS Radex Szczecin,Sezon 2011/2012
2011-11-16 18:00,Rosa Radom(w),77 : 57P,57,18,41,43.9,7,20,35.0,25,61,41.0,0,3,0.0,17,17,34,7,15,13,13,4,0,0,50,AZS Radex Szczecin,Sezon 2011/2012
2011-11-19 19:00,Focus Mall Sudety Jelenia Góra(d),89 : 77W,89,28,49,57.1,3,13,23.1,31,62,50.0,24,26,92.3,7,26,33,19,26,22,10,3,1,0,102,AZS Radex Szczecin,Sezon 2011/2012
2011-11-27 16:00,Siedlecki Klub Koszykówki Siedlce(w),60 : 59P,59,12,47,25.5,4,18,22.2,16,65,24.6,23,27,85.2,10,21,31,8,21,25,8,7,1,0,45,AZS Radex Szczecin,Sezon 2011/2012
2011-12-03 18:00,POLOmarket Sportino Inowrocław(w),76 : 74P,74,25,47,53.2,4,20,20.0,29,67,43.3,12,21,57.1,9,24,33,12,22,23,9,7,3,0,73,AZS Radex Szczecin,Sezon 2011/2012
2011-12-10 17:00,KS Spójnia Stargard Szczeciński(w),81 : 58P,58,16,39,41.0,5,16,31.3,21,55,38.2,11,17,64.7,10,21,31,11,19,17,19,5,2,0,48,AZS Radex Szczecin,Sezon 2011/2012
2011-12-17 17:00,Start Gdynia(w),67 : 74W,74,20,39,51.3,4,15,26.7,24,54,44.4,22,25,88.0,7,27,34,10,21,27,14,5,0,0,76,AZS Radex Szczecin,Sezon 2011/2012
2011-12-21 18:00,MKS Start Lublin(w),70 : 60P,60,18,50,36.0,6,18,33.3,24,68,35.3,6,12,50.0,14,21,35,16,19,15,16,12,1,0,58,AZS Radex Szczecin,Sezon 2011/2012
2012-01-06 17:00,MKS Dąbrowa Górnicza(d),75 : 68W,75,20,35,57.1,6,24,25.0,26,59,44.1,17,19,89.5,12,25,37,19,29,22,14,4,3,0,89,AZS Radex Szczecin,Sezon 2011/2012
2012-01-14 18:00,MKS Znicz Basket Pruszków(w),77 : 70P,70,20,35,57.1,5,23,21.7,25,58,43.1,15,25,60.0,10,24,34,17,29,22,18,8,1,0,69,AZS Radex Szczecin,Sezon 2011/2012
2012-01-18 18:00,Polski Cukier SIDEn Toruń(d),71 : 69W,71,25,45,55.6,4,16,25.0,29,61,47.5,9,18,50.0,9,24,33,15,25,23,10,8,2,0,78,AZS Radex Szczecin,Sezon 2011/2012
2012-02-04 17:30,AZS WSGK POLFARMEX Kutno(w),76 : 69P,69,25,40,62.5,3,19,15.8,28,59,47.5,10,13,76.9,4,18,22,12,24,14,15,8,0,0,62,AZS Radex Szczecin,Sezon 2011/2012
2012-02-11 16:00,MKS Budimpex Polonia Przemyśl(d),89 : 76W,89,27,44,61.4,6,19,31.6,33,63,52.4,17,23,73.9,11,25,36,20,25,20,5,4,2,0,110,AZS Radex Szczecin,Sezon 2011/2012
2012-02-13 18:00,NETO PTG Sokół Łańcut(d),70 : 82P,70,19,36,52.8,5,16,31.3,24,52,46.2,17,22,77.3,10,25,35,12,26,21,22,10,0,0,72,AZS Radex Szczecin,Sezon 2011/2012
2012-02-25 18:00,Delikatesy Centrum PBS Bank MOSiR Krosno(w),84 : 65P,65,13,32,40.6,7,21,33.3,20,53,37.7,18,24,75.0,9,15,24,7,29,24,15,4,3,0,49,AZS Radex Szczecin,Sezon 2011/2012
2012-02-29 18:00,Rosa Radom(d),76 : 80P,76,24,36,66.7,5,28,17.9,29,64,45.3,13,15,86.7,13,20,33,21,20,18,8,4,2,0,91,AZS Radex Szczecin,Sezon 2011/2012
2012-03-03 18:30,Focus Mall Sudety Jelenia Góra(w),76 : 85W,85,26,46,56.5,7,21,33.3,33,67,49.3,12,14,85.7,9,19,28,17,18,21,9,9,5,0,99,AZS Radex Szczecin,Sezon 2011/2012
2012-03-10 18:00,Siedlecki Klub Koszykówki Siedlce(d),78 : 76W,78,13,34,38.2,11,30,36.7,24,64,37.5,19,25,76.0,12,22,34,18,21,24,6,5,1,0,84,AZS Radex Szczecin,Sezon 2011/2012
2012-03-17 16:00,POLOmarket Sportino Inowrocław(d),82 : 72W,82,26,45,57.8,6,19,31.6,32,64,50.0,12,20,60.0,9,21,30,18,18,21,9,9,2,0,92,AZS Radex Szczecin,Sezon 2011/2012
2012-03-24 20:00,KS Spójnia Stargard Szczeciński(d),75 : 69W,75,18,29,62.1,5,15,33.3,23,44,52.3,24,30,80.0,5,26,31,11,21,23,11,7,5,0,91,AZS Radex Szczecin,Sezon 2011/2012
2012-03-31 16:00,Start Gdynia(d),76 : 70W,76,21,42,50.0,7,14,50.0,28,56,50.0,13,17,76.5,8,29,37,14,14,20,8,5,4,0,96,AZS Radex Szczecin,Sezon 2011/2012
2012-04-14 18:00,Focus Mall Sudety Jelenia Góra(d),69 : 91P,69,19,34,55.9,3,20,15.0,22,54,40.7,22,30,73.3,11,21,32,9,23,22,15,8,1,0,64,AZS Radex Szczecin,Sezon 2011/2012
2012-04-15 18:00,Focus Mall Sudety Jelenia Góra(d),83 : 72W,83,25,37,67.6,6,16,37.5,31,53,58.5,15,18,83.3,7,21,28,19,24,20,12,6,2,0,101,AZS Radex Szczecin,Sezon 2011/2012
2012-04-21 18:00,Focus Mall Sudety Jelenia Góra(w),70 : 76W,76,16,37,43.2,7,22,31.8,23,59,39.0,23,30,76.7,9,28,37,12,21,26,12,8,2,0,80,AZS Radex Szczecin,Sezon 2011/2012
2012-04-22 18:00,Focus Mall Sudety Jelenia Góra(w),79 : 83W,83,23,42,54.8,4,12,33.3,27,54,50.0,25,28,89.3,9,24,33,13,17,24,11,4,0,0,92,AZS Radex Szczecin,Sezon 2011/2012
2011-10-01 17:30,Start Gdynia(d),65 : 73P,65,24,39,61.5,2,7,28.6,26,46,56.5,11,17,64.7,1,15,16,17,25,24,10,4,1,0,67,AZS WSGK POLFARMEX Kutno,Sezon 2011/2012
2011-10-08 18:00,MKS Start Lublin(w),64 : 57P,57,19,47,40.4,2,20,10.0,21,67,31.3,13,18,72.2,11,30,41,10,20,18,15,6,3,0,51,AZS WSGK POLFARMEX Kutno,Sezon 2011/2012
2011-10-15 17:30,MKS Dąbrowa Górnicza(d),66 : 65W,66,18,31,58.1,4,15,26.7,22,46,47.8,18,25,72.0,6,25,31,7,19,20,12,7,3,0,71,AZS WSGK POLFARMEX Kutno,Sezon 2011/2012
2011-10-19 19:00,MKS Znicz Basket Pruszków(w),64 : 56P,56,11,37,29.7,9,28,32.1,20,65,30.8,7,19,36.8,11,23,34,12,22,21,13,10,2,0,44,AZS WSGK POLFARMEX Kutno,Sezon 2011/2012
2011-10-22 17:30,Polski Cukier SIDEn Toruń(d),68 : 93P,68,22,41,53.7,5,19,26.3,27,60,45.0,9,16,56.3,7,21,28,17,26,18,12,7,5,0,73,AZS WSGK POLFARMEX Kutno,Sezon 2011/2012
2011-10-29 18:00,AZS Radex Szczecin(w),79 : 66P,66,21,38,55.3,5,21,23.8,26,59,44.1,9,13,69.2,9,11,20,9,20,15,9,10,1,0,60,AZS WSGK POLFARMEX Kutno,Sezon 2011/2012
2011-11-12 17:30,MKS Budimpex Polonia Przemyśl(d),75 : 62W,75,31,52,59.6,0,8,0.0,31,60,51.7,13,18,72.2,11,16,27,16,16,18,9,9,0,0,84,AZS WSGK POLFARMEX Kutno,Sezon 2011/2012
2011-11-16 18:00,Delikatesy Centrum PBS Bank MOSiR Krosno(w),62 : 69W,69,19,42,45.2,7,17,41.2,26,59,44.1,10,17,58.8,8,26,34,8,22,20,15,3,1,0,60,AZS WSGK POLFARMEX Kutno,Sezon 2011/2012
2011-11-19 17:30,Rosa Radom(d),76 : 58W,76,21,36,58.3,6,16,37.5,27,52,51.9,16,19,84.2,7,19,26,11,19,20,9,10,3,0,89,AZS WSGK POLFARMEX Kutno,Sezon 2011/2012
2011-11-26 18:30,Focus Mall Sudety Jelenia Góra(w),62 : 81W,81,22,31,71.0,10,24,41.7,32,55,58.2,7,8,87.5,9,23,32,17,24,14,16,14,3,0,107,AZS WSGK POLFARMEX Kutno,Sezon 2011/2012
2011-12-03 17:30,Siedlecki Klub Koszykówki Siedlce(d),70 : 68W,70,15,41,36.6,10,21,47.6,25,62,40.3,10,12,83.3,5,22,27,19,27,22,9,7,2,0,77,AZS WSGK POLFARMEX Kutno,Sezon 2011/2012
2011-12-11 18:00,POLOmarket Sportino Inowrocław(w),64 : 76W,76,24,37,64.9,5,18,27.8,29,55,52.7,13,22,59.1,10,23,33,21,25,22,16,8,0,0,87,AZS WSGK POLFARMEX Kutno,Sezon 2011/2012
2011-12-14 18:00,KS Spójnia Stargard Szczeciński(d),64 : 68P,64,15,27,55.6,9,17,52.9,24,44,54.5,7,10,70.0,1,19,20,13,26,19,13,8,1,0,70,AZS WSGK POLFARMEX Kutno,Sezon 2011/2012
2011-12-17 17:30,NETO PTG Sokół Łańcut(w),61 : 69W,4,2,2,100.0,0,0,0.0,2,2,100.0,0,0,0.0,0,2,2,1,4,2,4,2,0,0,5,AZS WSGK POLFARMEX Kutno,Sezon 2011/2012
2011-12-21 16:00,Start Gdynia(w),92 : 74P,74,22,36,61.1,8,22,36.4,30,58,51.7,6,11,54.5,9,10,19,15,15,12,15,11,3,0,74,AZS WSGK POLFARMEX Kutno,Sezon 2011/2012
2012-01-07 17:30,MKS Start Lublin(d),88 : 76W,88,27,47,57.4,6,18,33.3,33,65,50.8,16,24,66.7,9,19,28,14,17,23,10,8,3,0,91,AZS WSGK POLFARMEX Kutno,Sezon 2011/2012
2012-01-14 17:00,MKS Dąbrowa Górnicza(w),84 : 78P,78,19,40,47.5,8,30,26.7,27,70,38.6,16,26,61.5,13,24,37,17,30,23,15,11,3,0,78,AZS WSGK POLFARMEX Kutno,Sezon 2011/2012
2012-01-18 18:00,MKS Znicz Basket Pruszków(d),72 : 65W,72,16,29,55.2,8,33,24.2,24,62,38.7,16,30,53.3,19,27,46,13,29,22,11,8,3,0,79,AZS WSGK POLFARMEX Kutno,Sezon 2011/2012
2012-01-28 17:00,Polski Cukier SIDEn Toruń(w),80 : 85W,85,19,35,54.3,9,29,31.0,28,64,43.8,20,29,69.0,12,21,33,15,29,26,15,4,2,0,79,AZS WSGK POLFARMEX Kutno,Sezon 2011/2012
2012-02-04 17:30,AZS Radex Szczecin(d),76 : 69W,76,19,31,61.3,6,18,33.3,25,49,51.0,20,22,90.9,5,21,26,15,14,24,12,3,0,0,82,AZS WSGK POLFARMEX Kutno,Sezon 2011/2012
2012-02-18 17:30,Delikatesy Centrum PBS Bank MOSiR Krosno(d),62 : 63P,62,17,35,48.6,4,19,21.1,21,54,38.9,16,22,72.7,7,21,28,8,23,27,8,4,1,0,56,AZS WSGK POLFARMEX Kutno,Sezon 2011/2012
2012-02-25 18:00,MKS Budimpex Polonia Przemyśl(w),77 : 68P,68,13,39,33.3,10,22,45.5,23,61,37.7,12,15,80.0,8,20,28,17,20,19,10,8,2,0,72,AZS WSGK POLFARMEX Kutno,Sezon 2011/2012
2012-03-03 18:00,Rosa Radom(w),72 : 71P,71,15,24,62.5,9,26,34.6,24,50,48.0,14,20,70.0,5,23,28,9,20,18,19,10,0,0,67,AZS WSGK POLFARMEX Kutno,Sezon 2011/2012
2012-03-10 17:30,Focus Mall Sudety Jelenia Góra(d),66 : 54W,66,27,43,62.8,1,16,6.3,28,59,47.5,9,13,69.2,5,26,31,15,17,14,5,6,2,0,80,AZS WSGK POLFARMEX Kutno,Sezon 2011/2012
2012-03-18 17:00,Siedlecki Klub Koszykówki Siedlce(w),78 : 54P,54,22,43,51.2,1,18,5.6,23,61,37.7,7,18,38.9,3,21,24,14,23,21,11,7,1,0,40,AZS WSGK POLFARMEX Kutno,Sezon 2011/2012
2012-03-24 17:30,POLOmarket Sportino Inowrocław(d),68 : 54W,68,21,42,50.0,4,15,26.7,25,57,43.9,14,20,70.0,9,21,30,14,14,18,5,6,1,0,76,AZS WSGK POLFARMEX Kutno,Sezon 2011/2012
2012-03-28 18:00,KS Spójnia Stargard Szczeciński(w),72 : 66P,66,12,29,41.4,8,25,32.0,20,54,37.0,18,24,75.0,9,16,25,12,21,24,13,1,2,0,53,AZS WSGK POLFARMEX Kutno,Sezon 2011/2012
2012-04-01 17:30,NETO PTG Sokół Łańcut(d),73 : 59W,73,19,40,47.5,7,15,46.7,26,55,47.3,14,23,60.9,9,26,35,12,19,23,11,5,1,0,77,AZS WSGK POLFARMEX Kutno,Sezon 2011/2012
2012-04-14 15:00,Start Gdynia(w),82 : 61P,61,21,38,55.3,3,23,13.0,24,61,39.3,10,17,58.8,7,12,19,12,13,20,15,8,0,0,41,AZS WSGK POLFARMEX Kutno,Sezon 2011/2012
2012-04-15 17:00,Start Gdynia(w),95 : 73P,73,15,31,48.4,8,26,30.8,23,57,40.4,19,25,76.0,7,10,17,15,21,23,7,7,3,0,68,AZS WSGK POLFARMEX Kutno,Sezon 2011/2012
2012-04-21 17:30,Start Gdynia(d),69 : 72P,69,19,33,57.6,6,15,40.0,25,48,52.1,13,17,76.5,5,17,22,17,16,21,8,9,3,0,85,AZS WSGK POLFARMEX Kutno,Sezon 2011/2012
2011-10-01 18:00,KS Spójnia Stargard Szczeciński(d),55 : 80P,55,14,37,37.8,6,17,35.3,20,54,37.0,9,16,56.3,4,19,23,11,16,18,9,6,0,0,45,Delikatesy Centrum PBS Bank MOSiR Krosno,Sezon 2011/2012
2011-10-08 17:30,NETO PTG Sokół Łańcut(w),74 : 61P,61,16,37,43.2,6,20,30.0,22,57,38.6,11,18,61.1,6,9,15,10,23,21,12,12,0,0,44,Delikatesy Centrum PBS Bank MOSiR Krosno,Sezon 2011/2012
2011-10-16 18:00,Start Gdynia(d),78 : 74W,78,21,43,48.8,6,16,37.5,27,59,45.8,18,23,78.3,6,21,27,13,15,24,8,9,0,0,82,Delikatesy Centrum PBS Bank MOSiR Krosno,Sezon 2011/2012
2011-10-19 18:00,MKS Start Lublin(w),68 : 53P,53,10,37,27.0,7,25,28.0,17,62,27.4,12,21,57.1,8,19,27,10,19,27,9,8,1,0,36,Delikatesy Centrum PBS Bank MOSiR Krosno,Sezon 2011/2012
2011-10-22 18:00,MKS Dąbrowa Górnicza(d),67 : 84P,67,25,40,62.5,3,15,20.0,28,55,50.9,8,11,72.7,4,16,20,11,20,19,13,9,0,0,64,Delikatesy Centrum PBS Bank MOSiR Krosno,Sezon 2011/2012
2011-10-29 18:00,MKS Znicz Basket Pruszków(w),65 : 56P,56,16,30,53.3,4,18,22.2,20,48,41.7,12,25,48.0,8,19,27,10,23,23,16,11,5,0,52,Delikatesy Centrum PBS Bank MOSiR Krosno,Sezon 2011/2012
2011-11-05 17:00,Polski Cukier SIDEn Toruń(w),83 : 70P,70,22,38,57.9,4,19,21.1,26,57,45.6,14,18,77.8,8,13,21,10,25,23,13,4,1,0,58,Delikatesy Centrum PBS Bank MOSiR Krosno,Sezon 2011/2012
2011-11-13 17:30,AZS Radex Szczecin(w),75 : 72P,72,21,42,50.0,4,16,25.0,25,58,43.1,18,23,78.3,1,18,19,9,24,18,4,4,0,0,62,Delikatesy Centrum PBS Bank MOSiR Krosno,Sezon 2011/2012
2011-11-16 18:00,AZS WSGK POLFARMEX Kutno(d),62 : 69P,62,21,34,61.8,2,18,11.1,23,52,44.2,14,22,63.6,4,20,24,7,20,22,10,8,3,0,57,Delikatesy Centrum PBS Bank MOSiR Krosno,Sezon 2011/2012
2011-11-20 17:00,MKS Budimpex Polonia Przemyśl(w),84 : 77P,77,24,43,55.8,4,12,33.3,28,55,50.9,17,18,94.4,2,19,21,10,20,19,11,14,2,0,85,Delikatesy Centrum PBS Bank MOSiR Krosno,Sezon 2011/2012
2011-12-04 18:00,Rosa Radom(d),65 : 76P,65,11,23,47.8,7,26,26.9,18,49,36.7,22,31,71.0,4,15,19,9,17,29,15,10,2,0,50,Delikatesy Centrum PBS Bank MOSiR Krosno,Sezon 2011/2012
2011-12-10 19:00,Focus Mall Sudety Jelenia Góra(w),50 : 60W,60,13,29,44.8,8,20,40.0,21,49,42.9,10,12,83.3,4,18,22,9,19,16,9,4,0,0,56,Delikatesy Centrum PBS Bank MOSiR Krosno,Sezon 2011/2012
2011-12-14 18:00,Siedlecki Klub Koszykówki Siedlce(d),62 : 69P,62,13,25,52.0,8,27,29.6,21,52,40.4,12,16,75.0,5,16,21,10,17,18,7,6,1,0,58,Delikatesy Centrum PBS Bank MOSiR Krosno,Sezon 2011/2012
2011-12-17 18:00,POLOmarket Sportino Inowrocław(w),95 : 91P,91,23,38,60.5,7,20,35.0,30,58,51.7,24,32,75.0,5,30,35,10,22,26,12,7,1,0,96,Delikatesy Centrum PBS Bank MOSiR Krosno,Sezon 2011/2012
2011-12-20 18:00,KS Spójnia Stargard Szczeciński(w),84 : 60P,60,16,43,37.2,6,17,35.3,22,60,36.7,10,14,71.4,4,19,23,8,18,18,11,3,1,0,42,Delikatesy Centrum PBS Bank MOSiR Krosno,Sezon 2011/2012
2012-01-07 18:00,NETO PTG Sokół Łańcut(d),53 : 75P,53,19,42,45.2,2,16,12.5,21,58,36.2,9,19,47.4,6,24,30,7,24,19,16,4,1,0,32,Delikatesy Centrum PBS Bank MOSiR Krosno,Sezon 2011/2012
2012-01-13 19:00,Start Gdynia(w),99 : 46P,46,13,36,36.1,5,18,27.8,18,54,33.3,5,8,62.5,9,15,24,8,23,14,23,7,1,0,24,Delikatesy Centrum PBS Bank MOSiR Krosno,Sezon 2011/2012
2012-01-18 18:00,MKS Start Lublin(d),76 : 69W,76,18,35,51.4,8,29,27.6,26,64,40.6,16,20,80.0,10,21,31,14,24,20,8,10,3,0,84,Delikatesy Centrum PBS Bank MOSiR Krosno,Sezon 2011/2012
2012-01-28 18:00,MKS Dąbrowa Górnicza(w),82 : 60P,60,12,34,35.3,8,27,29.6,20,61,32.8,12,16,75.0,6,16,22,12,26,19,7,9,2,0,53,Delikatesy Centrum PBS Bank MOSiR Krosno,Sezon 2011/2012
2012-02-05 18:00,MKS Znicz Basket Pruszków(d),62 : 72P,62,6,24,25.0,13,29,44.8,19,53,35.8,11,15,73.3,3,21,24,15,22,16,16,5,4,0,56,Delikatesy Centrum PBS Bank MOSiR Krosno,Sezon 2011/2012
2012-02-08 18:00,Polski Cukier SIDEn Toruń(d),69 : 82P,69,17,32,53.1,10,27,37.0,27,59,45.8,5,11,45.5,10,16,26,14,25,21,15,5,3,0,64,Delikatesy Centrum PBS Bank MOSiR Krosno,Sezon 2011/2012
2012-02-18 17:30,AZS WSGK POLFARMEX Kutno(w),62 : 63W,63,13,24,54.2,6,20,30.0,19,44,43.2,19,26,73.1,2,21,23,6,27,23,11,5,2,0,56,Delikatesy Centrum PBS Bank MOSiR Krosno,Sezon 2011/2012
2012-02-25 18:00,AZS Radex Szczecin(d),84 : 65W,84,25,41,61.0,4,13,30.8,29,54,53.7,22,30,73.3,10,23,33,10,24,29,10,8,3,0,95,Delikatesy Centrum PBS Bank MOSiR Krosno,Sezon 2011/2012
2012-03-04 18:00,MKS Budimpex Polonia Przemyśl(d),75 : 65W,75,21,36,58.3,5,14,35.7,26,50,52.0,18,26,69.2,5,28,33,8,21,24,23,9,2,0,72,Delikatesy Centrum PBS Bank MOSiR Krosno,Sezon 2011/2012
2012-03-17 18:00,Rosa Radom(w),75 : 64P,64,16,25,64.0,5,21,23.8,21,46,45.7,17,23,73.9,6,23,29,10,22,22,23,7,1,0,57,Delikatesy Centrum PBS Bank MOSiR Krosno,Sezon 2011/2012
2012-03-24 18:00,Focus Mall Sudety Jelenia Góra(d),85 : 67W,85,27,46,58.7,7,22,31.8,34,68,50.0,10,19,52.6,12,30,42,19,17,17,8,5,3,0,103,Delikatesy Centrum PBS Bank MOSiR Krosno,Sezon 2011/2012
2012-03-28 18:00,Siedlecki Klub Koszykówki Siedlce(w),49 : 68W,68,17,37,45.9,9,25,36.0,26,62,41.9,7,13,53.8,7,19,26,17,21,15,9,8,6,0,74,Delikatesy Centrum PBS Bank MOSiR Krosno,Sezon 2011/2012
2012-03-31 18:00,POLOmarket Sportino Inowrocław(d),85 : 70W,85,24,46,52.2,10,25,40.0,34,71,47.9,7,12,58.3,13,23,36,19,25,12,14,10,4,0,98,Delikatesy Centrum PBS Bank MOSiR Krosno,Sezon 2011/2012
2012-04-14 18:00,MKS Start Lublin(w),75 : 70P,70,16,34,47.1,10,34,29.4,26,68,38.2,8,9,88.9,6,27,33,13,21,15,8,6,1,0,72,Delikatesy Centrum PBS Bank MOSiR Krosno,Sezon 2011/2012
2012-04-15 18:00,MKS Start Lublin(w),66 : 68W,68,13,31,41.9,9,24,37.5,22,55,40.0,15,24,62.5,6,17,23,10,26,23,10,7,1,0,57,Delikatesy Centrum PBS Bank MOSiR Krosno,Sezon 2011/2012
2012-04-21 18:00,MKS Start Lublin(d),75 : 64W,75,23,39,59.0,7,24,29.2,30,63,47.6,8,10,80.0,5,26,31,14,27,15,11,10,1,0,85,Delikatesy Centrum PBS Bank MOSiR Krosno,Sezon 2011/2012
2012-04-22 18:00,MKS Start Lublin(d),61 : 49W,61,18,39,46.2,5,17,29.4,23,56,41.1,10,20,50.0,9,30,39,10,25,23,17,8,1,0,59,Delikatesy Centrum PBS Bank MOSiR Krosno,Sezon 2011/2012
2011-10-01 19:00,Siedlecki Klub Koszykówki Siedlce(d),52 : 64P,52,12,37,32.4,4,15,26.7,16,52,30.8,16,22,72.7,8,21,29,9,23,18,13,9,1,0,45,Focus Mall Sudety Jelenia Góra,Sezon 2011/2012
2011-10-08 18:00,POLOmarket Sportino Inowrocław(w),46 : 62W,62,23,52,44.2,4,14,28.6,27,66,40.9,4,9,44.4,7,29,36,7,19,15,10,8,4,0,63,Focus Mall Sudety Jelenia Góra,Sezon 2011/2012
2011-10-15 19:00,KS Spójnia Stargard Szczeciński(d),54 : 71P,54,16,31,51.6,3,15,20.0,19,46,41.3,13,20,65.0,6,18,24,13,25,23,22,11,0,0,46,Focus Mall Sudety Jelenia Góra,Sezon 2011/2012
2011-10-19 18:00,NETO PTG Sokół Łańcut(w),98 : 40P,40,11,42,26.2,3,14,21.4,14,56,25.0,9,12,75.0,8,14,22,5,20,12,16,8,2,0,16,Focus Mall Sudety Jelenia Góra,Sezon 2011/2012
2011-10-22 18:30,Start Gdynia(d),39 : 67P,39,14,44,31.8,3,12,25.0,17,56,30.4,2,2,100.0,9,22,31,8,17,12,16,4,4,0,31,Focus Mall Sudety Jelenia Góra,Sezon 2011/2012
2011-10-29 18:00,MKS Start Lublin(w),43 : 62W,62,19,43,44.2,5,16,31.3,24,59,40.7,9,15,60.0,12,32,44,10,18,19,19,8,3,0,67,Focus Mall Sudety Jelenia Góra,Sezon 2011/2012
2011-11-05 19:00,MKS Dąbrowa Górnicza(d),72 : 79P,72,24,36,66.7,2,9,22.2,26,45,57.8,18,23,78.3,6,19,25,11,20,22,16,5,0,0,73,Focus Mall Sudety Jelenia Góra,Sezon 2011/2012
2011-11-12 16:00,MKS Znicz Basket Pruszków(w),79 : 74P,74,25,47,53.2,6,18,33.3,31,65,47.7,6,13,46.2,5,20,25,13,17,18,12,10,0,0,69,Focus Mall Sudety Jelenia Góra,Sezon 2011/2012
2011-11-16 18:30,Polski Cukier SIDEn Toruń(d),76 : 85P,76,21,39,53.8,7,19,36.8,28,58,48.3,13,17,76.5,12,14,26,15,27,20,17,7,3,0,76,Focus Mall Sudety Jelenia Góra,Sezon 2011/2012
2011-11-19 19:00,AZS Radex Szczecin(w),89 : 77P,77,20,36,55.6,7,21,33.3,27,57,47.4,16,24,66.7,8,17,25,12,22,26,10,1,0,0,67,Focus Mall Sudety Jelenia Góra,Sezon 2011/2012
2011-11-26 18:30,AZS WSGK POLFARMEX Kutno(d),62 : 81P,62,15,35,42.9,4,17,23.5,19,52,36.5,20,25,80.0,13,13,26,8,14,24,15,10,3,0,56,Focus Mall Sudety Jelenia Góra,Sezon 2011/2012
2011-12-04 17:00,MKS Budimpex Polonia Przemyśl(w),85 : 54P,54,20,44,45.5,1,10,10.0,21,54,38.9,11,13,84.6,4,14,18,8,16,21,15,11,1,0,42,Focus Mall Sudety Jelenia Góra,Sezon 2011/2012
2011-12-10 19:00,Delikatesy Centrum PBS Bank MOSiR Krosno(d),50 : 60P,50,18,36,50.0,2,15,13.3,20,51,39.2,8,12,66.7,11,21,32,13,16,19,15,5,3,0,53,Focus Mall Sudety Jelenia Góra,Sezon 2011/2012
2011-12-14 18:00,Rosa Radom(w),79 : 44P,44,11,35,31.4,4,14,28.6,15,49,30.6,10,18,55.6,7,19,26,5,17,22,21,10,0,0,22,Focus Mall Sudety Jelenia Góra,Sezon 2011/2012
2011-12-21 20:00,Siedlecki Klub Koszykówki Siedlce(w),85 : 63P,63,21,42,50.0,6,23,26.1,27,65,41.5,3,8,37.5,8,16,24,13,14,10,11,4,1,0,51,Focus Mall Sudety Jelenia Góra,Sezon 2011/2012
2012-01-07 19:00,POLOmarket Sportino Inowrocław(d),73 : 84P,73,19,40,47.5,9,19,47.4,28,59,47.5,8,12,66.7,6,25,31,19,25,18,10,6,2,0,86,Focus Mall Sudety Jelenia Góra,Sezon 2011/2012
2012-01-14 17:00,KS Spójnia Stargard Szczeciński(w),69 : 57P,57,12,41,29.3,8,24,33.3,20,65,30.8,9,13,69.2,16,19,35,12,20,21,17,8,1,0,47,Focus Mall Sudety Jelenia Góra,Sezon 2011/2012
2012-01-21 18:30,NETO PTG Sokół Łańcut(d),78 : 87P,78,21,39,53.8,7,21,33.3,28,60,46.7,15,17,88.2,8,18,26,20,36,22,22,7,1,0,76,Focus Mall Sudety Jelenia Góra,Sezon 2011/2012
2012-01-28 17:00,Start Gdynia(w),82 : 59P,59,20,39,51.3,3,19,15.8,23,58,39.7,10,12,83.3,8,19,27,9,19,18,21,6,0,0,43,Focus Mall Sudety Jelenia Góra,Sezon 2011/2012
2012-02-04 18:30,MKS Start Lublin(d),86 : 79W,86,24,51,47.1,8,21,38.1,32,72,44.4,14,16,87.5,13,30,43,15,22,19,13,3,1,0,93,Focus Mall Sudety Jelenia Góra,Sezon 2011/2012
2012-02-12 18:00,MKS Dąbrowa Górnicza(w),72 : 53P,53,13,42,31.0,8,20,40.0,21,62,33.9,3,6,50.0,8,17,25,15,22,15,12,8,2,0,47,Focus Mall Sudety Jelenia Góra,Sezon 2011/2012
2012-02-25 16:00,MKS Znicz Basket Pruszków(d),49 : 83P,49,13,43,30.2,6,24,25.0,19,67,28.4,5,10,50.0,12,22,34,12,22,17,17,11,1,0,37,Focus Mall Sudety Jelenia Góra,Sezon 2011/2012
2012-02-29 18:30,Polski Cukier SIDEn Toruń(w),67 : 57P,57,12,35,34.3,7,23,30.4,19,58,32.8,12,16,75.0,7,24,31,10,20,22,13,8,2,0,52,Focus Mall Sudety Jelenia Góra,Sezon 2011/2012
2012-03-03 18:30,AZS Radex Szczecin(d),76 : 85P,76,17,34,50.0,10,22,45.5,27,56,48.2,12,13,92.3,6,22,28,21,21,18,15,5,3,0,88,Focus Mall Sudety Jelenia Góra,Sezon 2011/2012
2012-03-10 17:30,AZS WSGK POLFARMEX Kutno(w),66 : 54P,54,16,28,57.1,4,20,20.0,20,48,41.7,10,17,58.8,1,24,25,10,14,17,10,2,2,0,48,Focus Mall Sudety Jelenia Góra,Sezon 2011/2012
2012-03-17 19:00,MKS Budimpex Polonia Przemyśl(d),72 : 82P,72,21,37,56.8,7,20,35.0,28,57,49.1,9,11,81.8,3,18,21,21,26,19,11,10,1,0,83,Focus Mall Sudety Jelenia Góra,Sezon 2011/2012
2012-03-24 18:00,Delikatesy Centrum PBS Bank MOSiR Krosno(w),85 : 67P,67,16,45,35.6,9,19,47.4,25,64,39.1,8,11,72.7,9,22,31,10,17,17,14,4,0,0,56,Focus Mall Sudety Jelenia Góra,Sezon 2011/2012
2012-03-28 18:30,Rosa Radom(d),64 : 88P,64,21,42,50.0,5,18,27.8,26,60,43.3,7,10,70.0,7,19,26,17,18,19,16,5,1,0,60,Focus Mall Sudety Jelenia Góra,Sezon 2011/2012
2012-04-14 18:00,AZS Radex Szczecin(w),69 : 91W,91,26,41,63.4,9,16,56.3,35,57,61.4,12,14,85.7,2,18,20,10,22,22,11,5,0,0,91,Focus Mall Sudety Jelenia Góra,Sezon 2011/2012
2012-04-15 18:00,AZS Radex Szczecin(w),83 : 72P,72,21,34,61.8,5,20,25.0,26,54,48.1,15,19,78.9,5,14,19,10,20,24,15,9,1,0,64,Focus Mall Sudety Jelenia Góra,Sezon 2011/2012
2012-04-21 18:00,AZS Radex Szczecin(d),70 : 76P,70,22,45,48.9,3,17,17.6,25,62,40.3,17,18,94.4,5,26,31,14,26,21,14,9,0,0,72,Focus Mall Sudety Jelenia Góra,Sezon 2011/2012
2012-04-22 18:00,AZS Radex Szczecin(d),79 : 83P,79,20,35,57.1,9,25,36.0,29,60,48.3,12,19,63.2,8,18,26,18,24,17,10,4,1,0,80,Focus Mall Sudety Jelenia Góra,Sezon 2011/2012
2011-10-01 18:00,Delikatesy Centrum PBS Bank MOSiR Krosno(w),55 : 80W,80,23,35,65.7,9,32,28.1,32,67,47.8,7,8,87.5,13,34,47,16,18,16,11,9,3,0,108,KS Spójnia Stargard Szczeciński,Sezon 2011/2012
2011-10-08 17:00,Rosa Radom(d),61 : 49W,61,12,34,35.3,9,23,39.1,21,57,36.8,10,13,76.9,11,26,37,14,23,17,16,5,4,0,66,KS Spójnia Stargard Szczeciński,Sezon 2011/2012
2011-10-15 19:00,Focus Mall Sudety Jelenia Góra(w),54 : 71W,71,14,27,51.9,7,19,36.8,21,46,45.7,22,29,75.9,7,21,28,10,23,25,20,7,2,0,66,KS Spójnia Stargard Szczeciński,Sezon 2011/2012
2011-10-19 18:00,Siedlecki Klub Koszykówki Siedlce(d),77 : 71W,77,18,33,54.5,9,27,33.3,27,60,45.0,14,23,60.9,7,22,29,16,25,24,7,8,5,0,86,KS Spójnia Stargard Szczeciński,Sezon 2011/2012
2011-10-22 17:00,POLOmarket Sportino Inowrocław(d),74 : 65W,74,15,33,45.5,9,23,39.1,24,56,42.9,17,19,89.5,11,18,29,11,21,21,15,7,1,0,73,KS Spójnia Stargard Szczeciński,Sezon 2011/2012
2011-11-05 17:30,NETO PTG Sokół Łańcut(w),69 : 56P,56,16,30,53.3,5,20,25.0,21,50,42.0,9,12,75.0,9,23,32,9,23,18,21,6,2,0,52,KS Spójnia Stargard Szczeciński,Sezon 2011/2012
2011-11-12 17:00,Start Gdynia(w),76 : 66P,66,14,34,41.2,8,21,38.1,22,55,40.0,14,20,70.0,6,21,27,14,18,22,11,5,1,0,63,KS Spójnia Stargard Szczeciński,Sezon 2011/2012
2011-11-16 18:00,MKS Start Lublin(d),71 : 66W,71,17,36,47.2,6,29,20.7,23,65,35.4,19,26,73.1,16,31,47,10,21,22,9,1,4,0,75,KS Spójnia Stargard Szczeciński,Sezon 2011/2012
2011-11-19 18:00,MKS Dąbrowa Górnicza(w),91 : 62P,62,15,39,38.5,7,20,35.0,22,59,37.3,11,13,84.6,10,16,26,17,17,18,19,7,3,0,57,KS Spójnia Stargard Szczeciński,Sezon 2011/2012
2011-11-26 17:00,MKS Znicz Basket Pruszków(d),79 : 73W,79,20,42,47.6,6,15,40.0,26,57,45.6,21,30,70.0,9,15,24,13,25,26,11,13,0,0,78,KS Spójnia Stargard Szczeciński,Sezon 2011/2012
2011-12-04 18:30,Polski Cukier SIDEn Toruń(w),75 : 61P,61,11,36,30.6,7,25,28.0,18,61,29.5,18,24,75.0,12,22,34,11,22,24,18,7,2,0,48,KS Spójnia Stargard Szczeciński,Sezon 2011/2012
2011-12-10 17:00,AZS Radex Szczecin(d),81 : 58W,81,22,41,53.7,8,21,38.1,30,62,48.4,13,20,65.0,13,24,37,20,18,18,10,6,5,0,100,KS Spójnia Stargard Szczeciński,Sezon 2011/2012
2011-12-14 18:00,AZS WSGK POLFARMEX Kutno(w),64 : 68W,68,14,29,48.3,8,19,42.1,22,48,45.8,16,24,66.7,8,17,25,10,20,25,15,7,0,0,61,KS Spójnia Stargard Szczeciński,Sezon 2011/2012
2011-12-17 17:00,MKS Budimpex Polonia Przemyśl(d),64 : 71P,64,12,39,30.8,8,27,29.6,20,66,30.3,16,17,94.1,10,22,32,12,22,15,9,9,3,0,64,KS Spójnia Stargard Szczeciński,Sezon 2011/2012
2011-12-20 18:00,Delikatesy Centrum PBS Bank MOSiR Krosno(d),84 : 60W,84,21,28,75.0,10,26,38.5,31,54,57.4,12,17,70.6,5,31,36,22,18,17,11,6,6,0,115,KS Spójnia Stargard Szczeciński,Sezon 2011/2012
2012-01-07 18:00,Rosa Radom(w),70 : 68P,68,16,31,51.6,10,32,31.3,26,63,41.3,6,12,50.0,14,23,37,18,15,18,14,8,1,0,75,KS Spójnia Stargard Szczeciński,Sezon 2011/2012
2012-01-14 17:00,Focus Mall Sudety Jelenia Góra(d),69 : 57W,69,19,36,52.8,7,13,53.8,26,49,53.1,10,14,71.4,5,26,31,17,21,20,16,9,4,0,87,KS Spójnia Stargard Szczeciński,Sezon 2011/2012
2012-01-18 18:00,Siedlecki Klub Koszykówki Siedlce(w),72 : 62P,62,14,41,34.1,8,23,34.8,22,64,34.4,10,15,66.7,4,20,24,13,23,20,11,9,2,0,52,KS Spójnia Stargard Szczeciński,Sezon 2011/2012
2012-01-28 18:00,POLOmarket Sportino Inowrocław(w),67 : 78W,78,22,37,59.5,7,19,36.8,29,56,51.8,13,19,68.4,5,25,30,17,20,22,12,10,5,0,95,KS Spójnia Stargard Szczeciński,Sezon 2011/2012
2012-02-11 17:00,NETO PTG Sokół Łańcut(d),65 : 62W,65,23,37,62.2,3,16,18.8,26,53,49.1,10,14,71.4,1,23,24,14,26,17,15,7,1,0,65,KS Spójnia Stargard Szczeciński,Sezon 2011/2012
2012-02-18 19:00,MKS Start Lublin(w),69 : 64P,64,13,35,37.1,10,26,38.5,23,61,37.7,8,17,47.1,11,27,38,17,23,21,11,5,1,0,67,KS Spójnia Stargard Szczeciński,Sezon 2011/2012
2012-02-23 18:00,Start Gdynia(d),59 : 76P,59,14,32,43.8,4,16,25.0,18,48,37.5,19,22,86.4,5,17,22,11,16,19,18,6,3,0,50,KS Spójnia Stargard Szczeciński,Sezon 2011/2012
2012-03-07 18:00,MKS Dąbrowa Górnicza(d),77 : 51W,77,25,55,45.5,5,11,45.5,30,66,45.5,12,15,80.0,11,33,44,20,22,20,18,8,2,0,94,KS Spójnia Stargard Szczeciński,Sezon 2011/2012
2012-03-11 17:00,MKS Znicz Basket Pruszków(w),73 : 54P,54,14,34,41.2,5,20,25.0,19,54,35.2,11,18,61.1,7,25,32,12,21,20,15,6,2,0,49,KS Spójnia Stargard Szczeciński,Sezon 2011/2012
2012-03-17 17:00,Polski Cukier SIDEn Toruń(d),94 : 62W,94,16,31,51.6,16,26,61.5,32,57,56.1,14,18,77.8,7,27,34,19,21,18,13,7,1,0,113,KS Spójnia Stargard Szczeciński,Sezon 2011/2012
2012-03-24 20:00,AZS Radex Szczecin(w),75 : 69P,69,18,31,58.1,7,20,35.0,25,51,49.0,12,21,57.1,7,17,24,9,23,21,12,4,0,0,59,KS Spójnia Stargard Szczeciński,Sezon 2011/2012
2012-03-28 18:00,AZS WSGK POLFARMEX Kutno(d),72 : 66W,72,15,36,41.7,8,17,47.1,23,53,43.4,18,20,90.0,6,22,28,11,24,21,11,9,2,0,79,KS Spójnia Stargard Szczeciński,Sezon 2011/2012
2012-04-01 17:30,MKS Budimpex Polonia Przemyśl(w),63 : 70W,70,27,46,58.7,2,11,18.2,29,57,50.9,10,13,76.9,6,28,34,21,20,17,14,8,5,0,93,KS Spójnia Stargard Szczeciński,Sezon 2011/2012
2012-04-14 20:00,MKS Znicz Basket Pruszków(w),80 : 64P,64,10,24,41.7,9,23,39.1,19,47,40.4,17,24,70.8,11,22,33,8,21,21,18,4,3,0,59,KS Spójnia Stargard Szczeciński,Sezon 2011/2012
2012-04-15 17:00,MKS Znicz Basket Pruszków(w),59 : 57P,57,13,37,35.1,4,24,16.7,17,61,27.9,19,23,82.6,16,20,36,11,20,23,11,8,2,0,55,KS Spójnia Stargard Szczeciński,Sezon 2011/2012
2012-04-21 19:00,MKS Znicz Basket Pruszków(d),76 : 69W,76,18,38,47.4,7,18,38.9,25,56,44.6,19,26,73.1,5,21,26,16,20,29,18,6,4,0,72,KS Spójnia Stargard Szczeciński,Sezon 2011/2012
2012-04-22 17:00,MKS Znicz Basket Pruszków(d),78 : 68W,78,18,34,52.9,7,19,36.8,25,53,47.2,21,25,84.0,5,28,33,16,16,23,12,6,2,0,91,KS Spójnia Stargard Szczeciński,Sezon 2011/2012
2012-04-25 19:00,MKS Znicz Basket Pruszków(w),96 : 69P,69,22,46,47.8,4,14,28.6,26,60,43.3,13,20,65.0,6,14,20,14,16,22,13,9,1,0,59,KS Spójnia Stargard Szczeciński,Sezon 2011/2012
2011-10-01 18:00,NETO PTG Sokół Łańcut(d),66 : 82P,67,17,34,50.0,7,21,33.3,24,55,43.6,11,15,73.3,7,21,28,9,22,16,14,3,5,0,63,MKS Budimpex Polonia Przemyśl,Sezon 2011/2012
2011-10-09 17:00,Start Gdynia(w),86 : 78P,78,21,42,50.0,7,24,29.2,28,66,42.4,15,23,65.2,8,23,31,11,27,24,12,6,1,0,69,MKS Budimpex Polonia Przemyśl,Sezon 2011/2012
2011-10-16 17:00,MKS Start Lublin(d),77 : 65W,77,21,35,60.0,8,28,28.6,29,63,46.0,11,14,78.6,9,22,31,20,20,18,10,10,3,0,94,MKS Budimpex Polonia Przemyśl,Sezon 2011/2012
2011-10-19 20:00,MKS Dąbrowa Górnicza(w),81 : 67P,67,12,36,33.3,10,28,35.7,22,64,34.4,13,17,76.5,6,16,22,14,19,20,16,6,0,0,47,MKS Budimpex Polonia Przemyśl,Sezon 2011/2012
2011-10-22 18:00,MKS Znicz Basket Pruszków(d),74 : 67W,74,22,44,50.0,5,23,21.7,27,67,40.3,15,17,88.2,12,31,43,9,18,19,17,9,4,0,80,MKS Budimpex Polonia Przemyśl,Sezon 2011/2012
2011-10-30 18:00,Polski Cukier SIDEn Toruń(w),94 : 74P,74,14,34,41.2,9,20,45.0,23,54,42.6,19,28,67.9,6,17,23,17,20,24,11,1,4,0,68,MKS Budimpex Polonia Przemyśl,Sezon 2011/2012
2011-11-05 18:00,AZS Radex Szczecin(d),76 : 67W,76,25,44,56.8,5,9,55.6,30,53,56.6,11,12,91.7,8,23,31,15,23,16,17,9,0,0,90,MKS Budimpex Polonia Przemyśl,Sezon 2011/2012
2011-11-12 17:30,AZS WSGK POLFARMEX Kutno(w),75 : 62P,62,20,27,74.1,5,20,25.0,25,47,53.2,7,7,100.0,3,12,15,5,19,16,16,3,2,0,49,MKS Budimpex Polonia Przemyśl,Sezon 2011/2012
2011-11-20 17:00,Delikatesy Centrum PBS Bank MOSiR Krosno(d),84 : 77W,84,26,44,59.1,7,20,35.0,33,64,51.6,11,14,78.6,6,22,28,27,19,20,14,7,1,0,99,MKS Budimpex Polonia Przemyśl,Sezon 2011/2012
2011-11-26 18:00,Rosa Radom(w),61 : 57P,57,18,39,46.2,6,25,24.0,24,64,37.5,3,5,60.0,8,18,26,13,19,16,12,11,1,0,54,MKS Budimpex Polonia Przemyśl,Sezon 2011/2012
2011-12-04 17:00,Focus Mall Sudety Jelenia Góra(d),85 : 54W,85,32,45,71.1,5,16,31.3,37,61,60.7,6,8,75.0,7,28,35,26,21,16,17,12,4,0,119,MKS Budimpex Polonia Przemyśl,Sezon 2011/2012
2011-12-10 17:00,Siedlecki Klub Koszykówki Siedlce(w),59 : 70W,70,21,40,52.5,8,26,30.8,29,66,43.9,4,6,66.7,9,27,36,18,19,16,11,8,0,0,82,MKS Budimpex Polonia Przemyśl,Sezon 2011/2012
2011-12-14 18:00,POLOmarket Sportino Inowrocław(d),85 : 65W,85,24,40,60.0,10,21,47.6,34,61,55.7,7,12,58.3,6,23,29,20,15,15,11,14,2,0,107,MKS Budimpex Polonia Przemyśl,Sezon 2011/2012
2011-12-17 17:00,KS Spójnia Stargard Szczeciński(w),64 : 71W,71,15,29,51.7,7,22,31.8,22,51,43.1,20,26,76.9,6,31,37,11,16,21,15,6,6,0,81,MKS Budimpex Polonia Przemyśl,Sezon 2011/2012
2011-12-21 18:00,NETO PTG Sokół Łańcut(w),71 : 67P,67,18,32,56.3,5,24,20.8,23,56,41.1,16,23,69.6,9,27,36,14,24,22,16,7,1,0,69,MKS Budimpex Polonia Przemyśl,Sezon 2011/2012
2012-01-07 18:00,Start Gdynia(d),79 : 76W,79,22,44,50.0,5,12,41.7,27,56,48.2,20,21,95.2,9,24,33,19,17,20,17,13,1,0,98,MKS Budimpex Polonia Przemyśl,Sezon 2011/2012
2012-01-14 19:15,MKS Start Lublin(w),73 : 68P,68,20,44,45.5,6,28,21.4,26,72,36.1,10,16,62.5,13,29,42,11,20,16,15,9,2,0,65,MKS Budimpex Polonia Przemyśl,Sezon 2011/2012
2012-01-18 18:00,MKS Dąbrowa Górnicza(d),99 : 93W,99,22,38,57.9,9,19,47.4,31,57,54.4,28,30,93.3,8,29,37,21,21,25,14,5,0,0,120,MKS Budimpex Polonia Przemyśl,Sezon 2011/2012
2012-01-28 18:00,MKS Znicz Basket Pruszków(w),79 : 58P,58,14,32,43.8,6,21,28.6,20,53,37.7,12,22,54.5,9,21,30,12,17,21,20,4,3,0,44,MKS Budimpex Polonia Przemyśl,Sezon 2011/2012
2012-02-05 17:00,Polski Cukier SIDEn Toruń(d),85 : 84W,85,21,44,47.7,7,26,26.9,28,70,40.0,22,25,88.0,12,20,32,18,19,19,11,8,2,0,89,MKS Budimpex Polonia Przemyśl,Sezon 2011/2012
2012-02-11 16:00,AZS Radex Szczecin(w),89 : 76P,76,20,38,52.6,5,19,26.3,25,57,43.9,21,24,87.5,7,23,30,13,20,25,10,1,1,0,76,MKS Budimpex Polonia Przemyśl,Sezon 2011/2012
2012-02-25 18:00,AZS WSGK POLFARMEX Kutno(d),77 : 68W,77,20,42,47.6,6,12,50.0,26,54,48.1,19,20,95.0,3,29,32,21,19,19,11,6,3,0,99,MKS Budimpex Polonia Przemyśl,Sezon 2011/2012
2012-03-04 18:00,Delikatesy Centrum PBS Bank MOSiR Krosno(w),75 : 65P,65,20,47,42.6,5,16,31.3,25,63,39.7,10,15,66.7,9,22,31,12,24,21,18,8,2,0,57,MKS Budimpex Polonia Przemyśl,Sezon 2011/2012
2012-03-10 17:00,Rosa Radom(d),87 : 88P,87,25,46,54.3,5,19,26.3,30,65,46.2,22,25,88.0,11,15,26,22,15,20,11,8,4,0,98,MKS Budimpex Polonia Przemyśl,Sezon 2011/2012
2012-03-17 19:00,Focus Mall Sudety Jelenia Góra(w),72 : 82W,82,20,40,50.0,6,21,28.6,26,61,42.6,24,27,88.9,15,24,39,16,19,26,12,7,0,0,94,MKS Budimpex Polonia Przemyśl,Sezon 2011/2012
2012-03-24 18:00,Siedlecki Klub Koszykówki Siedlce(d),77 : 71W,77,23,42,54.8,8,30,26.7,31,72,43.1,7,8,87.5,17,19,36,17,18,14,10,4,2,0,84,MKS Budimpex Polonia Przemyśl,Sezon 2011/2012
2012-03-28 18:00,POLOmarket Sportino Inowrocław(w),83 : 72P,72,17,30,56.7,9,31,29.0,26,61,42.6,11,15,73.3,11,16,27,9,17,18,13,7,1,0,64,MKS Budimpex Polonia Przemyśl,Sezon 2011/2012
2012-04-01 17:30,KS Spójnia Stargard Szczeciński(d),63 : 70P,63,19,35,54.3,5,27,18.5,24,62,38.7,10,12,83.3,7,20,27,18,17,20,12,8,1,0,65,MKS Budimpex Polonia Przemyśl,Sezon 2011/2012
2012-04-14 18:00,POLOmarket Sportino Inowrocław(d),91 : 85W,91,25,42,59.5,7,22,31.8,32,64,50.0,20,23,87.0,8,26,34,12,20,24,21,12,3,0,96,MKS Budimpex Polonia Przemyśl,Sezon 2011/2012
2012-04-15 18:00,POLOmarket Sportino Inowrocław(d),100 : 74W,100,27,39,69.2,10,26,38.5,37,65,56.9,16,20,80.0,12,19,31,28,24,15,12,4,2,0,121,MKS Budimpex Polonia Przemyśl,Sezon 2011/2012
2012-04-19 18:00,POLOmarket Sportino Inowrocław(w),81 : 73P,73,16,35,45.7,8,26,30.8,24,61,39.3,17,23,73.9,13,24,37,11,26,26,17,5,0,0,66,MKS Budimpex Polonia Przemyśl,Sezon 2011/2012
2011-10-02 18:00,Polski Cukier SIDEn Toruń(w),97 : 85P,85,16,37,43.2,12,24,50.0,28,61,45.9,17,27,63.0,6,22,28,19,28,27,13,2,6,0,84,MKS Dąbrowa Górnicza,Sezon 2011/2012
2011-10-08 18:00,AZS Radex Szczecin(d),71 : 51W,71,17,40,42.5,6,22,27.3,23,62,37.1,19,23,82.6,9,21,30,13,19,23,15,9,4,0,69,MKS Dąbrowa Górnicza,Sezon 2011/2012
2011-10-15 17:30,AZS WSGK POLFARMEX Kutno(w),66 : 65P,65,21,34,61.8,4,19,21.1,25,53,47.2,11,17,64.7,7,18,25,9,20,19,9,8,1,0,65,MKS Dąbrowa Górnicza,Sezon 2011/2012
2011-10-19 20:00,MKS Budimpex Polonia Przemyśl(d),81 : 67W,81,21,35,60.0,8,20,40.0,29,55,52.7,15,20,75.0,4,28,32,20,20,19,11,6,4,0,101,MKS Dąbrowa Górnicza,Sezon 2011/2012
2011-10-22 18:00,Delikatesy Centrum PBS Bank MOSiR Krosno(w),67 : 84W,84,21,34,61.8,8,17,47.1,29,51,56.9,18,23,78.3,7,18,25,12,20,20,14,8,0,0,88,MKS Dąbrowa Górnicza,Sezon 2011/2012
2011-10-29 18:00,Rosa Radom(d),66 : 67P,66,16,32,50.0,5,33,15.2,21,65,32.3,19,32,59.4,13,23,36,8,19,27,10,6,4,0,53,MKS Dąbrowa Górnicza,Sezon 2011/2012
2011-11-05 19:00,Focus Mall Sudety Jelenia Góra(w),72 : 79W,79,21,35,60.0,8,27,29.6,29,62,46.8,13,16,81.3,11,14,25,12,22,19,9,12,1,0,84,MKS Dąbrowa Górnicza,Sezon 2011/2012
2011-11-12 18:00,Siedlecki Klub Koszykówki Siedlce(d),71 : 51W,71,17,35,48.6,9,27,33.3,26,62,41.9,10,15,66.7,11,22,33,18,14,22,10,10,2,0,83,MKS Dąbrowa Górnicza,Sezon 2011/2012
2011-11-16 18:00,POLOmarket Sportino Inowrocław(w),51 : 82W,82,24,43,55.8,8,25,32.0,32,68,47.1,10,13,76.9,14,31,45,16,13,15,11,10,4,0,107,MKS Dąbrowa Górnicza,Sezon 2011/2012
2011-11-19 18:00,KS Spójnia Stargard Szczeciński(d),91 : 62W,91,19,37,51.4,14,26,53.8,33,63,52.4,11,15,73.3,8,25,33,28,18,17,15,10,4,0,117,MKS Dąbrowa Górnicza,Sezon 2011/2012
2011-11-26 17:30,NETO PTG Sokół Łańcut(w),79 : 72P,72,17,37,45.9,7,23,30.4,24,60,40.0,17,23,73.9,11,10,21,10,25,24,19,13,1,0,56,MKS Dąbrowa Górnicza,Sezon 2011/2012
2011-12-03 18:00,Start Gdynia(d),107 : 100W,107,21,43,48.8,12,31,38.7,33,74,44.6,29,42,69.0,9,29,38,18,24,31,14,6,5,0,106,MKS Dąbrowa Górnicza,Sezon 2011/2012
2011-12-10 19:00,MKS Start Lublin(w),83 : 91W,91,24,37,64.9,9,28,32.1,33,65,50.8,16,21,76.2,9,26,35,14,19,21,9,8,4,0,106,MKS Dąbrowa Górnicza,Sezon 2011/2012
2011-12-18 18:00,MKS Znicz Basket Pruszków(d),86 : 62W,86,24,50,48.0,7,23,30.4,31,73,42.5,17,24,70.8,16,26,42,17,19,26,9,5,3,0,95,MKS Dąbrowa Górnicza,Sezon 2011/2012
2011-12-21 18:00,Polski Cukier SIDEn Toruń(d),82 : 61W,82,21,36,58.3,9,25,36.0,30,61,49.2,13,20,65.0,9,27,36,15,21,17,12,6,3,0,92,MKS Dąbrowa Górnicza,Sezon 2011/2012
2012-01-06 17:00,AZS Radex Szczecin(w),75 : 68P,68,17,34,50.0,5,24,20.8,22,58,37.9,19,33,57.6,8,21,29,6,25,29,8,4,2,0,51,MKS Dąbrowa Górnicza,Sezon 2011/2012
2012-01-14 17:00,AZS WSGK POLFARMEX Kutno(d),84 : 78W,84,21,39,53.8,6,23,26.1,27,62,43.5,24,40,60.0,11,30,41,19,23,30,15,7,2,0,87,MKS Dąbrowa Górnicza,Sezon 2011/2012
2012-01-18 18:00,MKS Budimpex Polonia Przemyśl(w),99 : 93P,93,24,45,53.3,11,25,44.0,35,70,50.0,12,21,57.1,9,14,23,18,26,21,9,12,2,0,95,MKS Dąbrowa Górnicza,Sezon 2011/2012
2012-01-28 18:00,Delikatesy Centrum PBS Bank MOSiR Krosno(d),82 : 60W,82,20,36,55.6,11,27,40.7,31,63,49.2,9,20,45.0,12,29,41,16,19,26,15,2,2,0,85,MKS Dąbrowa Górnicza,Sezon 2011/2012
2012-02-04 18:00,Rosa Radom(w),77 : 73P,73,16,31,51.6,9,28,32.1,25,59,42.4,14,23,60.9,9,24,33,15,17,23,11,8,1,0,76,MKS Dąbrowa Górnicza,Sezon 2011/2012
2012-02-12 18:00,Focus Mall Sudety Jelenia Góra(d),72 : 53W,72,18,28,64.3,8,30,26.7,26,58,44.8,12,15,80.0,9,30,39,17,15,22,16,6,4,0,87,MKS Dąbrowa Górnicza,Sezon 2011/2012
2012-02-25 18:00,Siedlecki Klub Koszykówki Siedlce(w),66 : 58P,58,18,41,43.9,2,22,9.1,20,63,31.7,16,24,66.7,8,26,34,12,26,24,15,6,3,0,47,MKS Dąbrowa Górnicza,Sezon 2011/2012
2012-02-29 18:00,POLOmarket Sportino Inowrocław(d),69 : 87P,69,13,29,44.8,9,21,42.9,22,50,44.0,16,30,53.3,8,21,29,13,21,27,16,4,2,0,59,MKS Dąbrowa Górnicza,Sezon 2011/2012
2012-03-07 18:00,KS Spójnia Stargard Szczeciński(w),77 : 51P,51,8,26,30.8,5,30,16.7,13,56,23.2,20,26,76.9,7,21,28,11,20,22,18,9,2,0,34,MKS Dąbrowa Górnicza,Sezon 2011/2012
2012-03-10 18:00,NETO PTG Sokół Łańcut(d),92 : 75W,92,19,34,55.9,12,21,57.1,31,55,56.4,18,29,62.1,7,21,28,21,24,27,14,5,4,0,101,MKS Dąbrowa Górnicza,Sezon 2011/2012
2012-03-20 17:00,Start Gdynia(w),93 : 92P,92,21,38,55.3,12,29,41.4,33,67,49.3,14,18,77.8,7,27,34,19,21,21,7,3,1,0,104,MKS Dąbrowa Górnicza,Sezon 2011/2012
2012-03-25 18:00,MKS Start Lublin(d),89 : 58W,89,14,33,42.4,15,29,51.7,29,62,46.8,16,24,66.7,9,29,38,21,17,21,11,14,5,0,115,MKS Dąbrowa Górnicza,Sezon 2011/2012
2012-03-31 18:00,MKS Znicz Basket Pruszków(w),90 : 83P,83,19,39,48.7,7,26,26.9,26,65,40.0,24,35,68.6,4,25,29,9,29,27,11,13,12,0,85,MKS Dąbrowa Górnicza,Sezon 2011/2012
2012-04-14 16:00,Siedlecki Klub Koszykówki Siedlce(w),77 : 79W,79,23,36,63.9,7,28,25.0,30,64,46.9,12,20,60.0,5,23,28,14,24,23,7,7,0,0,79,MKS Dąbrowa Górnicza,Sezon 2011/2012
2012-04-15 16:00,Siedlecki Klub Koszykówki Siedlce(w),71 : 86W,86,19,33,57.6,10,28,35.7,29,61,47.5,18,30,60.0,9,18,27,17,17,25,9,5,3,0,85,MKS Dąbrowa Górnicza,Sezon 2011/2012
2012-04-21 18:00,Siedlecki Klub Koszykówki Siedlce(d),98 : 65W,98,13,26,50.0,20,36,55.6,33,62,53.2,12,22,54.5,4,29,33,24,13,22,10,8,5,0,119,MKS Dąbrowa Górnicza,Sezon 2011/2012
2012-04-28 18:00,Rosa Radom(w),80 : 79P,79,19,34,55.9,6,32,18.8,25,66,37.9,23,31,74.2,15,28,43,11,22,21,15,3,1,0,73,MKS Dąbrowa Górnicza,Sezon 2011/2012
2012-04-29 18:00,Rosa Radom(w),85 : 91W,91,19,35,54.3,12,28,42.9,31,63,49.2,17,27,63.0,3,29,32,26,31,24,13,10,5,0,109,MKS Dąbrowa Górnicza,Sezon 2011/2012
2012-05-05 18:00,Rosa Radom(d),61 : 65P,61,15,31,48.4,8,32,25.0,23,63,36.5,7,12,58.3,6,24,30,16,22,19,13,8,5,0,62,MKS Dąbrowa Górnicza,Sezon 2011/2012
2012-05-06 18:00,Rosa Radom(d),94 : 90W,94,23,46,50.0,8,20,40.0,31,66,47.0,24,33,72.7,11,30,41,14,27,28,12,5,3,0,101,MKS Dąbrowa Górnicza,Sezon 2011/2012
2012-05-09 18:00,Rosa Radom(w),94 : 87P,87,11,27,40.7,16,41,39.0,27,68,39.7,17,25,68.0,3,25,28,13,32,27,11,4,1,0,73,MKS Dąbrowa Górnicza,Sezon 2011/2012
2012-05-12 18:00,MKS Znicz Basket Pruszków(d),70 : 78P,70,19,34,55.9,6,20,30.0,25,54,46.3,14,18,77.8,4,20,24,15,18,21,20,10,6,0,72,MKS Dąbrowa Górnicza,Sezon 2011/2012
2012-05-20 19:00,MKS Znicz Basket Pruszków(w),67 : 81W,81,15,39,38.5,11,23,47.8,26,62,41.9,18,39,46.2,11,26,37,12,19,30,14,7,3,0,69,MKS Dąbrowa Górnicza,Sezon 2011/2012
2011-10-02 17:30,AZS Radex Szczecin(w),93 : 69P,69,20,33,60.6,7,18,38.9,27,51,52.9,8,11,72.7,4,13,17,6,28,17,5,1,0,0,61,MKS Start Lublin,Sezon 2011/2012
2011-10-08 18:00,AZS WSGK POLFARMEX Kutno(d),64 : 57W,64,16,45,35.6,6,18,33.3,22,63,34.9,14,24,58.3,7,29,36,12,18,20,14,5,0,0,52,MKS Start Lublin,Sezon 2011/2012
2011-10-16 17:00,MKS Budimpex Polonia Przemyśl(w),77 : 65P,65,19,31,61.3,5,17,29.4,24,48,50.0,12,20,60.0,5,26,31,7,18,20,17,5,0,0,59,MKS Start Lublin,Sezon 2011/2012
2011-10-19 18:00,Delikatesy Centrum PBS Bank MOSiR Krosno(d),68 : 53W,68,17,32,53.1,7,22,31.8,24,54,44.4,13,19,68.4,9,38,47,7,27,19,19,5,2,0,74,MKS Start Lublin,Sezon 2011/2012
2011-10-22 18:00,Rosa Radom(w),82 : 44P,44,8,30,26.7,4,20,20.0,12,50,24.0,16,23,69.6,9,22,31,4,20,25,23,2,2,0,15,MKS Start Lublin,Sezon 2011/2012
2011-10-29 18:00,Focus Mall Sudety Jelenia Góra(d),43 : 62P,43,16,41,39.0,2,18,11.1,18,59,30.5,5,11,45.5,6,23,29,9,19,18,18,9,0,0,25,MKS Start Lublin,Sezon 2011/2012
2011-11-05 18:00,Siedlecki Klub Koszykówki Siedlce(w),85 : 64P,64,11,36,30.6,10,21,47.6,21,57,36.8,12,18,66.7,4,18,22,19,23,22,17,7,1,0,54,MKS Start Lublin,Sezon 2011/2012
2011-11-12 18:00,POLOmarket Sportino Inowrocław(d),80 : 61W,80,24,42,57.1,6,19,31.6,30,61,49.2,14,19,73.7,5,24,29,19,16,17,12,9,2,0,91,MKS Start Lublin,Sezon 2011/2012
2011-11-16 18:00,KS Spójnia Stargard Szczeciński(w),71 : 66P,66,17,40,42.5,6,20,30.0,23,60,38.3,14,18,77.8,5,20,25,16,22,20,9,4,1,0,62,MKS Start Lublin,Sezon 2011/2012
2011-11-19 18:00,NETO PTG Sokół Łańcut(d),59 : 49W,59,14,43,32.6,7,19,36.8,21,62,33.9,10,17,58.8,12,31,43,13,19,22,13,7,2,0,63,MKS Start Lublin,Sezon 2011/2012
2011-11-26 17:00,Start Gdynia(w),91 : 74P,74,23,44,52.3,3,16,18.8,26,60,43.3,19,24,79.2,7,19,26,10,18,23,13,7,0,0,65,MKS Start Lublin,Sezon 2011/2012
2011-12-10 19:00,MKS Dąbrowa Górnicza(d),83 : 91P,83,20,42,47.6,10,21,47.6,30,63,47.6,13,16,81.3,7,21,28,14,21,18,12,2,0,0,79,MKS Start Lublin,Sezon 2011/2012
2011-12-14 18:00,MKS Znicz Basket Pruszków(d),70 : 57W,70,14,37,37.8,7,18,38.9,21,55,38.2,21,30,70.0,7,33,40,11,17,24,14,6,0,0,70,MKS Start Lublin,Sezon 2011/2012
2011-12-17 18:00,Polski Cukier SIDEn Toruń(d),82 : 63W,82,21,55,38.2,10,23,43.5,31,78,39.7,10,10,100.0,8,26,34,9,20,15,5,11,0,0,84,MKS Start Lublin,Sezon 2011/2012
2011-12-21 18:00,AZS Radex Szczecin(d),70 : 60W,70,14,36,38.9,12,26,46.2,26,62,41.9,6,13,46.2,9,26,35,12,15,19,16,6,2,0,66,MKS Start Lublin,Sezon 2011/2012
2012-01-07 17:30,AZS WSGK POLFARMEX Kutno(w),88 : 76P,76,25,38,65.8,4,13,30.8,29,51,56.9,14,17,82.4,2,19,21,11,23,17,19,9,1,0,74,MKS Start Lublin,Sezon 2011/2012
2012-01-14 19:15,MKS Budimpex Polonia Przemyśl(d),73 : 68W,73,18,38,47.4,9,25,36.0,27,63,42.9,10,18,55.6,9,26,35,11,16,20,14,8,1,0,70,MKS Start Lublin,Sezon 2011/2012
2012-01-18 18:00,Delikatesy Centrum PBS Bank MOSiR Krosno(w),76 : 69P,69,14,26,53.8,8,21,38.1,22,47,46.8,17,23,73.9,3,27,30,11,20,24,20,3,0,0,62,MKS Start Lublin,Sezon 2011/2012
2012-01-28 18:00,Rosa Radom(d),66 : 79P,66,15,35,42.9,9,25,36.0,24,60,40.0,9,14,64.3,12,24,36,12,16,15,16,8,0,0,65,MKS Start Lublin,Sezon 2011/2012
2012-02-04 18:30,Focus Mall Sudety Jelenia Góra(w),86 : 79P,79,24,51,47.1,5,18,27.8,29,69,42.0,16,20,80.0,9,26,35,13,19,22,9,9,2,0,85,MKS Start Lublin,Sezon 2011/2012
2012-02-11 19:00,Siedlecki Klub Koszykówki Siedlce(d),65 : 70P,65,15,34,44.1,7,22,31.8,22,56,39.3,14,22,63.6,8,24,32,11,21,24,13,3,0,0,56,MKS Start Lublin,Sezon 2011/2012
2012-02-18 19:00,KS Spójnia Stargard Szczeciński(d),69 : 64W,69,17,36,47.2,5,21,23.8,22,57,38.6,20,29,69.0,10,28,38,11,21,23,10,7,1,0,72,MKS Start Lublin,Sezon 2011/2012
2012-02-25 18:00,POLOmarket Sportino Inowrocław(w),84 : 61P,61,18,41,43.9,4,20,20.0,22,61,36.1,13,21,61.9,11,24,35,10,13,20,17,4,1,0,47,MKS Start Lublin,Sezon 2011/2012
2012-03-03 17:30,NETO PTG Sokół Łańcut(w),56 : 69W,69,18,38,47.4,6,15,40.0,24,53,45.3,15,21,71.4,5,22,27,14,23,22,14,13,0,0,74,MKS Start Lublin,Sezon 2011/2012
2012-03-10 19:00,Start Gdynia(d),63 : 72P,63,15,42,35.7,6,17,35.3,21,59,35.6,15,24,62.5,11,26,37,10,21,18,12,1,0,0,52,MKS Start Lublin,Sezon 2011/2012
2012-03-25 18:00,MKS Dąbrowa Górnicza(w),89 : 58P,58,19,44,43.2,3,15,20.0,22,59,37.3,11,21,52.4,11,22,33,9,21,17,19,5,3,0,42,MKS Start Lublin,Sezon 2011/2012
2012-03-28 19:00,MKS Znicz Basket Pruszków(w),95 : 96W,96,26,47,55.3,10,22,45.5,36,69,52.2,14,22,63.6,6,29,35,14,26,22,17,7,2,0,96,MKS Start Lublin,Sezon 2011/2012
2012-04-01 17:30,Polski Cukier SIDEn Toruń(w),76 : 71P,71,15,36,41.7,11,26,42.3,26,62,41.9,8,16,50.0,7,23,30,17,20,21,14,8,1,0,69,MKS Start Lublin,Sezon 2011/2012
2012-04-14 18:00,Delikatesy Centrum PBS Bank MOSiR Krosno(d),75 : 70W,75,19,33,57.6,6,25,24.0,25,58,43.1,19,24,79.2,5,28,33,12,15,21,12,4,1,0,75,MKS Start Lublin,Sezon 2011/2012
2012-04-15 18:00,Delikatesy Centrum PBS Bank MOSiR Krosno(d),66 : 68P,66,20,33,60.6,3,11,27.3,23,44,52.3,17,24,70.8,4,21,25,9,23,26,16,4,4,0,64,MKS Start Lublin,Sezon 2011/2012
2012-04-21 18:00,Delikatesy Centrum PBS Bank MOSiR Krosno(w),75 : 64P,64,15,40,37.5,4,10,40.0,19,50,38.0,22,36,61.1,6,27,33,6,15,27,13,6,1,0,52,MKS Start Lublin,Sezon 2011/2012
2012-04-22 18:00,Delikatesy Centrum PBS Bank MOSiR Krosno(w),61 : 49P,49,13,35,37.1,3,19,15.8,16,54,29.6,14,24,58.3,8,20,28,7,23,25,15,5,0,0,26,MKS Start Lublin,Sezon 2011/2012
2011-10-09 17:00,Polski Cukier SIDEn Toruń(d),71 : 67W,71,20,35,57.1,5,24,20.8,25,59,42.4,16,23,69.6,8,22,30,14,29,25,20,10,1,0,65,MKS Znicz Basket Pruszków,Sezon 2011/2012
2011-10-15 20:00,AZS Radex Szczecin(w),86 : 78P,78,20,35,57.1,9,25,36.0,29,60,48.3,11,19,57.9,9,15,24,12,20,25,13,5,0,0,67,MKS Znicz Basket Pruszków,Sezon 2011/2012
2011-10-19 19:00,AZS WSGK POLFARMEX Kutno(d),64 : 56W,64,15,32,46.9,7,23,30.4,22,55,40.0,13,19,68.4,8,34,42,10,21,22,18,5,3,0,67,MKS Znicz Basket Pruszków,Sezon 2011/2012
2011-10-22 18:00,MKS Budimpex Polonia Przemyśl(w),74 : 67P,67,19,33,57.6,7,29,24.1,26,62,41.9,8,17,47.1,6,23,29,15,19,18,13,9,4,0,66,MKS Znicz Basket Pruszków,Sezon 2011/2012
2011-10-29 18:00,Delikatesy Centrum PBS Bank MOSiR Krosno(d),65 : 56W,65,18,40,45.0,7,18,38.9,25,58,43.1,8,18,44.4,12,19,31,13,23,23,17,13,3,0,65,MKS Znicz Basket Pruszków,Sezon 2011/2012
2011-11-05 18:00,Rosa Radom(w),91 : 103W,103,15,23,65.2,12,28,42.9,27,51,52.9,37,57,64.9,8,24,32,10,30,39,16,9,5,0,99,MKS Znicz Basket Pruszków,Sezon 2011/2012
2011-11-12 16:00,Focus Mall Sudety Jelenia Góra(d),79 : 74W,79,17,33,51.5,11,26,42.3,28,59,47.5,12,20,60.0,11,28,39,19,18,17,19,6,0,0,85,MKS Znicz Basket Pruszków,Sezon 2011/2012
2011-11-16 18:00,Siedlecki Klub Koszykówki Siedlce(w),94 : 75P,75,14,34,41.2,9,24,37.5,23,58,39.7,20,28,71.4,7,14,21,14,25,22,12,8,2,0,65,MKS Znicz Basket Pruszków,Sezon 2011/2012
2011-11-20 17:00,POLOmarket Sportino Inowrocław(d),74 : 69W,74,18,38,47.4,5,19,26.3,23,57,40.4,23,36,63.9,17,25,42,12,19,28,21,8,1,0,69,MKS Znicz Basket Pruszków,Sezon 2011/2012
2011-11-26 17:00,KS Spójnia Stargard Szczeciński(w),79 : 73P,73,17,28,60.7,7,20,35.0,24,48,50.0,18,23,78.3,6,22,28,10,26,25,21,6,3,0,70,MKS Znicz Basket Pruszków,Sezon 2011/2012
2011-12-04 18:00,NETO PTG Sokół Łańcut(d),71 : 57W,71,12,25,48.0,10,24,41.7,22,49,44.9,17,28,60.7,10,24,34,15,25,24,23,8,3,0,70,MKS Znicz Basket Pruszków,Sezon 2011/2012
2011-12-10 19:30,Start Gdynia(w),107 : 56P,56,12,30,40.0,7,20,35.0,19,50,38.0,11,17,64.7,4,16,20,11,21,19,26,6,3,0,33,MKS Znicz Basket Pruszków,Sezon 2011/2012
2011-12-14 18:00,MKS Start Lublin(w),70 : 57P,57,18,48,37.5,5,23,21.7,23,71,32.4,6,13,46.2,12,28,40,10,24,17,10,10,3,0,55,MKS Znicz Basket Pruszków,Sezon 2011/2012
2011-12-18 18:00,MKS Dąbrowa Górnicza(w),86 : 62P,62,17,41,41.5,5,23,21.7,22,64,34.4,13,16,81.3,8,25,33,10,26,19,14,4,6,0,56,MKS Znicz Basket Pruszków,Sezon 2011/2012
2012-01-07 17:00,Polski Cukier SIDEn Toruń(w),72 : 73W,73,21,37,56.8,8,31,25.8,29,68,42.6,7,9,77.8,12,30,42,19,31,20,19,5,3,0,82,MKS Znicz Basket Pruszków,Sezon 2011/2012
2012-01-14 18:00,AZS Radex Szczecin(d),77 : 70W,77,22,45,48.9,3,18,16.7,25,63,39.7,24,36,66.7,16,23,39,14,22,29,15,7,1,0,73,MKS Znicz Basket Pruszków,Sezon 2011/2012
2012-01-18 18:00,AZS WSGK POLFARMEX Kutno(w),72 : 65P,65,17,34,50.0,3,15,20.0,20,49,40.8,22,33,66.7,6,25,31,9,22,28,14,6,1,0,58,MKS Znicz Basket Pruszków,Sezon 2011/2012
2012-01-28 18:00,MKS Budimpex Polonia Przemyśl(d),79 : 58W,79,24,38,63.2,6,21,28.6,30,59,50.8,13,15,86.7,5,25,30,23,21,17,12,11,2,0,102,MKS Znicz Basket Pruszków,Sezon 2011/2012
2012-02-05 18:00,Delikatesy Centrum PBS Bank MOSiR Krosno(w),62 : 72W,72,14,32,43.8,7,14,50.0,21,46,45.7,23,29,79.3,2,24,26,11,16,22,16,9,1,0,72,MKS Znicz Basket Pruszków,Sezon 2011/2012
2012-02-11 18:00,Rosa Radom(d),73 : 69W,73,19,34,55.9,5,20,25.0,24,54,44.4,20,32,62.5,3,30,33,9,24,27,15,4,5,0,67,MKS Znicz Basket Pruszków,Sezon 2011/2012
2012-02-25 16:00,Focus Mall Sudety Jelenia Góra(w),49 : 83W,83,23,38,60.5,6,14,42.9,29,52,55.8,19,23,82.6,4,34,38,19,17,22,19,12,5,0,111,MKS Znicz Basket Pruszków,Sezon 2011/2012
2012-02-29 19:00,Siedlecki Klub Koszykówki Siedlce(d),42 : 62P,42,15,42,35.7,0,21,0.0,15,63,23.8,12,16,75.0,12,23,35,8,24,20,12,6,2,0,29,MKS Znicz Basket Pruszków,Sezon 2011/2012
2012-03-03 18:00,POLOmarket Sportino Inowrocław(w),71 : 73W,73,20,37,54.1,6,17,35.3,26,54,48.1,15,21,71.4,8,27,35,10,20,21,16,7,3,0,78,MKS Znicz Basket Pruszków,Sezon 2011/2012
2012-03-11 17:00,KS Spójnia Stargard Szczeciński(d),73 : 54W,73,24,42,57.1,5,18,27.8,29,60,48.3,10,18,55.6,7,28,35,16,20,21,13,6,3,0,81,MKS Znicz Basket Pruszków,Sezon 2011/2012
2012-03-17 17:30,NETO PTG Sokół Łańcut(w),51 : 75W,75,19,36,52.8,8,20,40.0,27,56,48.2,13,23,56.5,7,31,38,15,20,23,13,12,3,0,91,MKS Znicz Basket Pruszków,Sezon 2011/2012
2012-03-24 18:00,Start Gdynia(d),68 : 76P,68,16,39,41.0,8,29,27.6,24,68,35.3,12,12,100.0,11,20,31,13,26,15,16,7,3,0,62,MKS Znicz Basket Pruszków,Sezon 2011/2012
2012-03-28 19:00,MKS Start Lublin(d),95 : 96P,95,17,41,41.5,14,36,38.9,31,77,40.3,19,25,76.0,15,26,41,16,22,25,15,8,4,0,97,MKS Znicz Basket Pruszków,Sezon 2011/2012
2012-03-31 18:00,MKS Dąbrowa Górnicza(d),90 : 83W,90,27,52,51.9,5,22,22.7,32,74,43.2,21,30,70.0,13,32,45,16,27,29,18,6,5,0,93,MKS Znicz Basket Pruszków,Sezon 2011/2012
2012-04-14 20:00,KS Spójnia Stargard Szczeciński(d),80 : 64W,80,14,30,46.7,12,32,37.5,26,62,41.9,16,20,80.0,9,16,25,17,21,21,7,9,1,0,85,MKS Znicz Basket Pruszków,Sezon 2011/2012
2012-04-15 17:00,KS Spójnia Stargard Szczeciński(d),59 : 57W,59,17,38,44.7,5,17,29.4,22,55,40.0,10,13,76.9,8,25,33,13,23,19,13,6,4,0,66,MKS Znicz Basket Pruszków,Sezon 2011/2012
2012-04-21 19:00,KS Spójnia Stargard Szczeciński(w),76 : 69P,69,17,34,50.0,8,22,36.4,25,56,44.6,11,18,61.1,10,23,33,17,29,20,21,5,3,0,68,MKS Znicz Basket Pruszków,Sezon 2011/2012
2012-04-22 17:00,KS Spójnia Stargard Szczeciński(w),78 : 68P,68,13,35,37.1,11,29,37.9,24,64,37.5,9,11,81.8,7,20,27,16,23,16,11,8,2,0,68,MKS Znicz Basket Pruszków,Sezon 2011/2012
2012-04-25 19:00,KS Spójnia Stargard Szczeciński(d),96 : 69W,96,20,36,55.6,14,27,51.9,34,63,54.0,14,16,87.5,12,28,40,19,22,16,19,7,2,0,114,MKS Znicz Basket Pruszków,Sezon 2011/2012
2012-04-28 17:00,Start Gdynia(w),68 : 57P,57,16,30,53.3,5,27,18.5,21,57,36.8,10,11,90.9,4,22,26,8,19,20,18,5,1,0,42,MKS Znicz Basket Pruszków,Sezon 2011/2012
2012-04-29 17:00,Start Gdynia(w),78 : 75P,75,19,41,46.3,6,14,42.9,25,55,45.5,19,24,79.2,5,14,19,14,22,24,16,4,2,0,63,MKS Znicz Basket Pruszków,Sezon 2011/2012
2012-05-05 17:00,Start Gdynia(d),93 : 85W,93,21,40,52.5,9,20,45.0,30,60,50.0,24,31,77.4,9,27,36,14,19,24,11,7,2,0,104,MKS Znicz Basket Pruszków,Sezon 2011/2012
2012-05-06 17:00,Start Gdynia(d),76 : 77P,76,16,38,42.1,11,22,50.0,27,60,45.0,11,20,55.0,4,27,31,12,30,23,19,5,4,0,67,MKS Znicz Basket Pruszków,Sezon 2011/2012
2012-05-12 18:00,MKS Dąbrowa Górnicza(w),70 : 78W,78,27,51,52.9,4,14,28.6,31,65,47.7,12,18,66.7,9,24,33,12,21,17,18,10,1,0,76,MKS Znicz Basket Pruszków,Sezon 2011/2012
2012-05-20 19:00,MKS Dąbrowa Górnicza(d),67 : 81P,67,17,33,51.5,8,24,33.3,25,57,43.9,9,17,52.9,6,29,35,16,30,19,20,6,6,0,70,MKS Znicz Basket Pruszków,Sezon 2011/2012
2011-10-01 18:00,MKS Budimpex Polonia Przemyśl(w),66 : 82W,82,19,41,46.3,9,16,56.3,28,57,49.1,17,24,70.8,8,29,37,7,17,17,12,7,4,0,89,NETO PTG Sokół Łańcut,Sezon 2011/2012
2011-10-08 17:30,Delikatesy Centrum PBS Bank MOSiR Krosno(d),74 : 61W,74,21,40,52.5,6,11,54.5,27,51,52.9,14,16,87.5,8,29,37,9,21,23,23,8,1,0,80,NETO PTG Sokół Łańcut,Sezon 2011/2012
2011-10-15 18:00,Rosa Radom(w),68 : 66P,66,14,36,38.9,7,24,29.2,21,60,35.0,17,20,85.0,12,25,37,13,18,27,14,3,2,0,65,NETO PTG Sokół Łańcut,Sezon 2011/2012
2011-10-19 18:00,Focus Mall Sudety Jelenia Góra(d),98 : 40W,98,31,44,70.5,7,22,31.8,38,66,57.6,15,17,88.2,12,28,40,26,12,20,11,11,3,0,137,NETO PTG Sokół Łańcut,Sezon 2011/2012
2011-10-23 16:00,Siedlecki Klub Koszykówki Siedlce(w),64 : 81W,81,19,36,52.8,9,22,40.9,28,58,48.3,16,25,64.0,10,19,29,12,20,27,11,5,5,0,82,NETO PTG Sokół Łańcut,Sezon 2011/2012
2011-10-29 17:30,POLOmarket Sportino Inowrocław(d),65 : 46W,65,21,43,48.8,6,13,46.2,27,56,48.2,5,7,71.4,9,21,30,15,18,15,9,14,11,0,95,NETO PTG Sokół Łańcut,Sezon 2011/2012
2011-11-05 17:30,KS Spójnia Stargard Szczeciński(d),69 : 56W,69,18,36,50.0,6,21,28.6,24,57,42.1,15,22,68.2,13,22,35,10,18,23,11,15,3,0,81,NETO PTG Sokół Łańcut,Sezon 2011/2012
2011-11-07 18:00,AZS Radex Szczecin(d),74 : 54W,74,22,41,53.7,4,16,25.0,26,57,45.6,18,25,72.0,15,25,40,11,15,27,20,15,4,0,86,NETO PTG Sokół Łańcut,Sezon 2011/2012
2011-11-16 18:00,Start Gdynia(d),78 : 69W,78,19,39,48.7,7,17,41.2,26,56,46.4,19,27,70.4,11,18,29,14,20,25,18,17,3,0,85,NETO PTG Sokół Łańcut,Sezon 2011/2012
2011-11-19 18:00,MKS Start Lublin(w),59 : 49P,49,15,37,40.5,3,24,12.5,18,61,29.5,10,17,58.8,14,24,38,5,22,19,17,9,1,0,35,NETO PTG Sokół Łańcut,Sezon 2011/2012
2011-11-26 17:30,MKS Dąbrowa Górnicza(d),79 : 72W,79,22,35,62.9,4,17,23.5,26,52,50.0,23,27,85.2,14,24,38,11,24,25,22,8,5,0,89,NETO PTG Sokół Łańcut,Sezon 2011/2012
2011-12-04 18:00,MKS Znicz Basket Pruszków(w),71 : 57P,57,15,34,44.1,5,20,25.0,20,54,37.0,12,23,52.2,10,16,26,8,24,25,18,10,2,0,40,NETO PTG Sokół Łańcut,Sezon 2011/2012
2011-12-08 18:00,Polski Cukier SIDEn Toruń(d),79 : 71W,79,26,44,59.1,6,25,24.0,32,69,46.4,9,15,60.0,20,19,39,11,28,26,12,11,1,0,86,NETO PTG Sokół Łańcut,Sezon 2011/2012
2011-12-17 17:30,AZS WSGK POLFARMEX Kutno(d),61 : 69P,36,11,29,37.9,2,11,18.2,13,40,32.5,8,11,72.7,8,17,25,3,17,16,9,12,3,0,40,NETO PTG Sokół Łańcut,Sezon 2011/2012
2011-12-21 18:00,MKS Budimpex Polonia Przemyśl(d),71 : 67W,71,14,34,41.2,8,28,28.6,22,62,35.5,19,25,76.0,13,25,38,16,23,24,10,8,2,0,79,NETO PTG Sokół Łańcut,Sezon 2011/2012
2012-01-07 18:00,Delikatesy Centrum PBS Bank MOSiR Krosno(w),53 : 75W,75,21,40,52.5,7,18,38.9,28,58,48.3,12,19,63.2,4,31,35,16,19,24,10,8,1,0,88,NETO PTG Sokół Łańcut,Sezon 2011/2012
2012-01-14 17:30,Rosa Radom(d),72 : 68W,72,12,29,41.4,9,25,36.0,21,54,38.9,21,27,77.8,7,30,37,17,22,29,16,6,4,0,81,NETO PTG Sokół Łańcut,Sezon 2011/2012
2012-01-21 18:30,Focus Mall Sudety Jelenia Góra(w),78 : 87W,87,23,35,65.7,4,20,20.0,27,55,49.1,29,45,64.4,14,19,33,15,22,36,14,11,2,0,90,NETO PTG Sokół Łańcut,Sezon 2011/2012
2012-01-28 17:30,Siedlecki Klub Koszykówki Siedlce(d),67 : 63W,67,16,34,47.1,8,26,30.8,24,60,40.0,11,16,68.8,14,25,39,12,16,19,14,6,3,0,72,NETO PTG Sokół Łańcut,Sezon 2011/2012
2012-02-04 18:00,POLOmarket Sportino Inowrocław(w),57 : 80W,80,24,43,55.8,5,18,27.8,29,61,47.5,17,21,81.0,14,22,36,14,13,24,11,13,5,0,101,NETO PTG Sokół Łańcut,Sezon 2011/2012
2012-02-11 17:00,KS Spójnia Stargard Szczeciński(w),65 : 62P,62,11,26,42.3,8,26,30.8,19,52,36.5,16,23,69.6,8,24,32,10,17,26,14,10,4,0,64,NETO PTG Sokół Łańcut,Sezon 2011/2012
2012-02-13 18:00,AZS Radex Szczecin(w),70 : 82W,82,23,41,56.1,6,21,28.6,29,62,46.8,18,21,85.7,7,16,23,12,21,26,15,8,3,0,77,NETO PTG Sokół Łańcut,Sezon 2011/2012
2012-02-29 15:00,Start Gdynia(w),93 : 54P,54,19,48,39.6,1,15,6.7,20,63,31.7,13,20,65.0,9,23,32,7,23,24,18,5,1,0,31,NETO PTG Sokół Łańcut,Sezon 2011/2012
2012-03-03 17:30,MKS Start Lublin(d),56 : 69P,56,14,39,35.9,4,23,17.4,18,62,29.0,16,22,72.7,17,24,41,8,22,23,17,7,3,0,48,NETO PTG Sokół Łańcut,Sezon 2011/2012
2012-03-10 18:00,MKS Dąbrowa Górnicza(w),92 : 75P,75,24,51,47.1,3,15,20.0,27,66,40.9,18,24,75.0,14,19,33,8,27,24,15,9,4,0,69,NETO PTG Sokół Łańcut,Sezon 2011/2012
2012-03-17 17:30,MKS Znicz Basket Pruszków(d),51 : 75P,51,12,36,33.3,5,26,19.2,17,62,27.4,12,21,57.1,15,25,40,8,23,20,17,8,4,0,40,NETO PTG Sokół Łańcut,Sezon 2011/2012
2012-03-24 17:00,Polski Cukier SIDEn Toruń(w),75 : 73P,73,13,28,46.4,9,30,30.0,22,58,37.9,20,28,71.4,12,17,29,11,23,29,11,11,1,0,70,NETO PTG Sokół Łańcut,Sezon 2011/2012
2012-04-01 17:30,AZS WSGK POLFARMEX Kutno(w),73 : 59P,59,16,30,53.3,4,24,16.7,20,54,37.0,15,23,65.2,4,21,25,8,23,19,13,4,1,0,42,NETO PTG Sokół Łańcut,Sezon 2011/2012
2012-04-14 18:00,Rosa Radom(w),81 : 64P,64,13,31,41.9,7,18,38.9,20,49,40.8,17,23,73.9,7,28,35,5,14,23,23,8,4,0,58,NETO PTG Sokół Łańcut,Sezon 2011/2012
2012-04-15 18:00,Rosa Radom(w),75 : 60P,60,15,40,37.5,7,21,33.3,22,61,36.1,9,15,60.0,16,19,35,8,22,18,19,6,1,0,46,NETO PTG Sokół Łańcut,Sezon 2011/2012
2012-04-21 17:30,Rosa Radom(d),82 : 72W,82,14,33,42.4,12,25,48.0,26,58,44.8,18,20,90.0,5,29,34,17,19,21,14,15,4,0,104,NETO PTG Sokół Łańcut,Sezon 2011/2012
2012-04-22 17:30,Rosa Radom(d),54 : 69P,54,14,34,41.2,6,30,20.0,20,64,31.3,8,14,57.1,18,17,35,8,23,14,11,7,8,0,51,NETO PTG Sokół Łańcut,Sezon 2011/2012
2011-10-01 18:00,Rosa Radom(w),67 : 52P,52,12,35,34.3,6,28,21.4,18,63,28.6,10,12,83.3,11,25,36,7,25,17,11,5,2,0,44,POLOmarket Sportino Inowrocław,Sezon 2011/2012
2011-10-08 18:00,Focus Mall Sudety Jelenia Góra(d),46 : 62P,46,12,33,36.4,4,26,15.4,16,59,27.1,10,16,62.5,11,29,40,7,15,19,13,1,2,0,34,POLOmarket Sportino Inowrocław,Sezon 2011/2012
2011-10-15 18:00,Siedlecki Klub Koszykówki Siedlce(w),72 : 64P,64,18,36,50.0,4,22,18.2,22,58,37.9,16,21,76.2,4,15,19,4,34,23,6,6,2,0,48,POLOmarket Sportino Inowrocław,Sezon 2011/2012
2011-10-22 17:00,KS Spójnia Stargard Szczeciński(w),74 : 65P,65,18,32,56.3,7,18,38.9,25,50,50.0,8,12,66.7,5,15,20,14,21,21,15,5,3,0,63,POLOmarket Sportino Inowrocław,Sezon 2011/2012
2011-10-29 17:30,NETO PTG Sokół Łańcut(w),65 : 46P,46,6,31,19.4,9,23,39.1,15,54,27.8,7,16,43.8,17,18,35,6,15,17,19,7,0,0,27,POLOmarket Sportino Inowrocław,Sezon 2011/2012
2011-11-05 18:00,Start Gdynia(d),58 : 82P,58,18,39,46.2,5,17,29.4,23,56,41.1,7,20,35.0,10,13,23,10,21,23,15,7,3,0,40,POLOmarket Sportino Inowrocław,Sezon 2011/2012
2011-11-12 18:00,MKS Start Lublin(w),80 : 61P,61,16,35,45.7,7,19,36.8,23,54,42.6,8,14,57.1,5,21,26,10,19,16,20,8,1,0,49,POLOmarket Sportino Inowrocław,Sezon 2011/2012
2011-11-16 18:00,MKS Dąbrowa Górnicza(d),51 : 82P,51,13,30,43.3,6,24,25.0,19,54,35.2,7,10,70.0,6,19,25,9,15,13,13,3,0,0,37,POLOmarket Sportino Inowrocław,Sezon 2011/2012
2011-11-20 17:00,MKS Znicz Basket Pruszków(w),74 : 69P,69,17,31,54.8,9,31,29.0,26,62,41.9,8,16,50.0,7,20,27,17,28,19,16,9,1,0,63,POLOmarket Sportino Inowrocław,Sezon 2011/2012
2011-11-26 18:00,Polski Cukier SIDEn Toruń(d),60 : 73P,60,17,42,40.5,4,22,18.2,21,64,32.8,14,19,73.7,9,17,26,10,23,20,11,10,2,0,49,POLOmarket Sportino Inowrocław,Sezon 2011/2012
2011-12-03 18:00,AZS Radex Szczecin(d),76 : 74W,76,18,38,47.4,8,27,29.6,26,65,40.0,16,25,64.0,11,29,40,20,23,22,10,5,2,0,85,POLOmarket Sportino Inowrocław,Sezon 2011/2012
2011-12-11 18:00,AZS WSGK POLFARMEX Kutno(d),64 : 76P,64,13,25,52.0,8,26,30.8,21,51,41.2,14,23,60.9,6,19,25,11,22,25,15,9,2,0,57,POLOmarket Sportino Inowrocław,Sezon 2011/2012
2011-12-14 18:00,MKS Budimpex Polonia Przemyśl(w),85 : 65P,65,17,31,54.8,8,22,36.4,25,53,47.2,7,10,70.0,6,21,27,13,15,15,17,7,0,0,64,POLOmarket Sportino Inowrocław,Sezon 2011/2012
2011-12-17 18:00,Delikatesy Centrum PBS Bank MOSiR Krosno(d),95 : 91W,95,20,41,48.8,13,32,40.6,33,73,45.2,16,20,80.0,10,25,35,19,26,22,11,4,2,0,100,POLOmarket Sportino Inowrocław,Sezon 2011/2012
2011-12-21 16:00,Rosa Radom(d),59 : 75P,59,14,34,41.2,7,21,33.3,21,55,38.2,10,20,50.0,11,21,32,12,14,23,17,6,3,0,51,POLOmarket Sportino Inowrocław,Sezon 2011/2012
2012-01-07 19:00,Focus Mall Sudety Jelenia Góra(w),73 : 84W,84,23,37,62.2,7,19,36.8,30,56,53.6,17,25,68.0,4,26,30,13,18,25,11,6,2,0,90,POLOmarket Sportino Inowrocław,Sezon 2011/2012
2012-01-14 18:00,Siedlecki Klub Koszykówki Siedlce(d),61 : 66P,61,15,36,41.7,7,32,21.9,22,68,32.4,10,16,62.5,8,20,28,17,27,19,9,13,1,0,59,POLOmarket Sportino Inowrocław,Sezon 2011/2012
2012-01-28 18:00,KS Spójnia Stargard Szczeciński(d),67 : 78P,67,16,36,44.4,7,22,31.8,23,58,39.7,14,17,82.4,6,22,28,14,22,20,16,4,0,0,59,POLOmarket Sportino Inowrocław,Sezon 2011/2012
2012-02-04 18:00,NETO PTG Sokół Łańcut(d),57 : 80P,57,15,38,39.5,8,17,47.1,23,55,41.8,3,6,50.0,7,18,25,11,24,13,18,2,4,0,46,POLOmarket Sportino Inowrocław,Sezon 2011/2012
2012-02-11 17:00,Start Gdynia(w),84 : 69P,69,15,32,46.9,8,20,40.0,23,52,44.2,15,17,88.2,4,18,22,15,28,20,19,7,2,0,65,POLOmarket Sportino Inowrocław,Sezon 2011/2012
2012-02-25 18:00,MKS Start Lublin(d),84 : 61W,84,20,40,50.0,13,28,46.4,33,68,48.5,5,10,50.0,10,27,37,20,20,13,13,10,0,0,98,POLOmarket Sportino Inowrocław,Sezon 2011/2012
2012-02-29 18:00,MKS Dąbrowa Górnicza(w),69 : 87W,87,21,28,75.0,10,29,34.5,31,57,54.4,15,22,68.2,7,24,31,18,28,21,11,10,3,0,105,POLOmarket Sportino Inowrocław,Sezon 2011/2012
2012-03-03 18:00,MKS Znicz Basket Pruszków(d),71 : 73P,71,10,28,35.7,13,39,33.3,23,67,34.3,12,19,63.2,16,18,34,17,21,20,12,7,1,0,67,POLOmarket Sportino Inowrocław,Sezon 2011/2012
2012-03-11 17:00,Polski Cukier SIDEn Toruń(w),83 : 74P,74,21,46,45.7,7,24,29.2,28,70,40.0,11,20,55.0,12,16,28,17,30,24,8,5,1,0,66,POLOmarket Sportino Inowrocław,Sezon 2011/2012
2012-03-17 16:00,AZS Radex Szczecin(w),82 : 72P,72,19,30,63.3,8,29,27.6,27,59,45.8,10,15,66.7,9,26,35,15,21,18,16,2,1,0,72,POLOmarket Sportino Inowrocław,Sezon 2011/2012
2012-03-24 17:30,AZS WSGK POLFARMEX Kutno(w),68 : 54P,54,12,23,52.2,8,23,34.8,20,46,43.5,6,7,85.7,2,19,21,6,18,14,8,2,1,0,49,POLOmarket Sportino Inowrocław,Sezon 2011/2012
2012-03-28 18:00,MKS Budimpex Polonia Przemyśl(d),83 : 72W,83,20,28,71.4,12,29,41.4,32,57,56.1,7,13,53.8,9,20,29,23,18,17,14,9,1,0,100,POLOmarket Sportino Inowrocław,Sezon 2011/2012
2012-03-31 18:00,Delikatesy Centrum PBS Bank MOSiR Krosno(w),85 : 70P,70,14,29,48.3,9,22,40.9,23,51,45.1,15,29,51.7,8,20,28,14,14,25,18,9,3,0,64,POLOmarket Sportino Inowrocław,Sezon 2011/2012
2012-04-14 18:00,MKS Budimpex Polonia Przemyśl(w),91 : 85P,85,22,36,61.1,11,30,36.7,33,66,50.0,8,14,57.1,7,21,28,22,25,20,20,19,1,0,96,POLOmarket Sportino Inowrocław,Sezon 2011/2012
2012-04-15 18:00,MKS Budimpex Polonia Przemyśl(w),100 : 74P,74,16,34,47.1,6,16,37.5,22,50,44.0,24,29,82.8,6,13,19,9,16,24,17,6,1,0,59,POLOmarket Sportino Inowrocław,Sezon 2011/2012
2012-04-19 18:00,MKS Budimpex Polonia Przemyśl(d),81 : 73W,81,21,37,56.8,6,15,40.0,27,52,51.9,21,32,65.6,4,24,28,17,26,26,12,7,1,0,86,POLOmarket Sportino Inowrocław,Sezon 2011/2012
2011-10-02 18:00,MKS Dąbrowa Górnicza(d),97 : 85W,97,23,48,47.9,7,12,58.3,30,60,50.0,30,37,81.1,9,28,37,19,27,28,6,7,5,0,122,Polski Cukier SIDEn Toruń,Sezon 2011/2012
2011-10-09 17:00,MKS Znicz Basket Pruszków(w),71 : 67P,67,16,29,55.2,6,20,30.0,22,49,44.9,17,33,51.5,7,17,24,13,25,29,21,14,1,0,55,Polski Cukier SIDEn Toruń,Sezon 2011/2012
2011-10-19 18:30,AZS Radex Szczecin(d),80 : 78W,80,19,35,54.3,8,20,40.0,27,55,49.1,18,27,66.7,10,19,29,15,21,25,14,3,2,0,78,Polski Cukier SIDEn Toruń,Sezon 2011/2012
2011-10-22 17:30,AZS WSGK POLFARMEX Kutno(w),68 : 93W,93,26,38,68.4,6,14,42.9,32,52,61.5,23,30,76.7,5,23,28,8,18,26,11,1,2,0,94,Polski Cukier SIDEn Toruń,Sezon 2011/2012
2011-10-30 18:00,MKS Budimpex Polonia Przemyśl(d),94 : 74W,94,25,38,65.8,8,18,44.4,33,56,58.9,20,24,83.3,5,23,28,22,24,20,14,4,5,0,112,Polski Cukier SIDEn Toruń,Sezon 2011/2012
2011-11-05 17:00,Delikatesy Centrum PBS Bank MOSiR Krosno(d),83 : 70W,83,23,35,65.7,7,20,35.0,30,55,54.5,16,25,64.0,6,20,26,31,23,25,15,5,3,0,99,Polski Cukier SIDEn Toruń,Sezon 2011/2012
2011-11-13 17:00,Rosa Radom(d),76 : 63W,76,11,27,40.7,12,30,40.0,23,57,40.4,18,23,78.3,8,21,29,18,23,24,11,8,3,0,84,Polski Cukier SIDEn Toruń,Sezon 2011/2012
2011-11-16 18:30,Focus Mall Sudety Jelenia Góra(w),76 : 85W,85,19,30,63.3,8,18,44.4,27,48,56.3,23,25,92.0,5,16,21,16,20,27,16,8,2,0,93,Polski Cukier SIDEn Toruń,Sezon 2011/2012
2011-11-20 17:00,Siedlecki Klub Koszykówki Siedlce(d),70 : 81P,70,14,41,34.1,6,27,22.2,20,68,29.4,24,30,80.0,13,19,32,11,29,29,11,10,2,0,60,Polski Cukier SIDEn Toruń,Sezon 2011/2012
2011-11-26 18:00,POLOmarket Sportino Inowrocław(w),60 : 73W,73,20,32,62.5,6,14,42.9,26,46,56.5,15,21,71.4,7,29,36,11,20,23,20,5,3,0,82,Polski Cukier SIDEn Toruń,Sezon 2011/2012
2011-12-04 18:30,KS Spójnia Stargard Szczeciński(d),75 : 61W,75,24,42,57.1,5,15,33.3,29,57,50.9,12,20,60.0,5,29,34,22,24,21,16,8,5,0,92,Polski Cukier SIDEn Toruń,Sezon 2011/2012
2011-12-08 18:00,NETO PTG Sokół Łańcut(w),79 : 71P,71,11,23,47.8,5,18,27.8,16,41,39.0,34,39,87.2,3,15,18,6,26,27,15,8,0,0,58,Polski Cukier SIDEn Toruń,Sezon 2011/2012
2011-12-14 18:30,Start Gdynia(d),73 : 83P,73,18,32,56.3,7,23,30.4,25,55,45.5,16,27,59.3,10,23,33,14,23,28,18,4,4,0,69,Polski Cukier SIDEn Toruń,Sezon 2011/2012
2011-12-17 18:00,MKS Start Lublin(w),82 : 63P,63,18,38,47.4,4,17,23.5,22,55,40.0,15,23,65.2,8,34,42,10,15,20,20,3,4,0,61,Polski Cukier SIDEn Toruń,Sezon 2011/2012
2011-12-21 18:00,MKS Dąbrowa Górnicza(w),82 : 61P,61,19,39,48.7,3,20,15.0,22,59,37.3,14,17,82.4,5,14,19,8,18,21,12,4,3,0,43,Polski Cukier SIDEn Toruń,Sezon 2011/2012
2012-01-07 17:00,MKS Znicz Basket Pruszków(d),72 : 73P,72,20,45,44.4,4,14,28.6,24,59,40.7,20,29,69.0,4,23,27,15,20,31,13,10,1,0,68,Polski Cukier SIDEn Toruń,Sezon 2011/2012
2012-01-18 18:00,AZS Radex Szczecin(w),71 : 69P,69,17,31,54.8,4,20,20.0,21,51,41.2,23,28,82.1,9,17,26,10,23,25,16,2,4,0,60,Polski Cukier SIDEn Toruń,Sezon 2011/2012
2012-01-28 17:00,AZS WSGK POLFARMEX Kutno(d),80 : 85P,80,23,47,48.9,5,19,26.3,28,66,42.4,19,28,67.9,12,24,36,14,26,29,13,8,0,0,78,Polski Cukier SIDEn Toruń,Sezon 2011/2012
2012-02-05 17:00,MKS Budimpex Polonia Przemyśl(w),85 : 84P,84,22,37,59.5,9,21,42.9,31,58,53.4,13,14,92.9,5,23,28,17,19,19,15,5,3,0,94,Polski Cukier SIDEn Toruń,Sezon 2011/2012
2012-02-08 18:00,Delikatesy Centrum PBS Bank MOSiR Krosno(w),69 : 82W,82,21,37,56.8,8,14,57.1,29,51,56.9,16,22,72.7,2,19,21,11,21,25,12,6,0,0,80,Polski Cukier SIDEn Toruń,Sezon 2011/2012
2012-02-25 19:00,Rosa Radom(w),77 : 50P,50,11,28,39.3,1,15,6.7,12,43,27.9,25,31,80.6,5,21,26,6,23,29,16,4,1,0,34,Polski Cukier SIDEn Toruń,Sezon 2011/2012
2012-02-29 18:30,Focus Mall Sudety Jelenia Góra(d),67 : 57W,67,18,34,52.9,6,22,27.3,24,56,42.9,13,19,68.4,8,30,38,15,22,20,17,3,0,0,68,Polski Cukier SIDEn Toruń,Sezon 2011/2012
2012-03-04 17:00,Siedlecki Klub Koszykówki Siedlce(w),80 : 56P,56,19,43,44.2,3,27,11.1,22,70,31.4,9,9,100.0,9,17,26,10,21,17,11,15,1,0,49,Polski Cukier SIDEn Toruń,Sezon 2011/2012
2012-03-11 17:00,POLOmarket Sportino Inowrocław(d),83 : 74W,83,13,26,50.0,7,17,41.2,20,43,46.5,36,37,97.3,6,27,33,14,24,30,17,5,2,0,96,Polski Cukier SIDEn Toruń,Sezon 2011/2012
2012-03-17 17:00,KS Spójnia Stargard Szczeciński(w),94 : 62P,62,15,32,46.9,6,19,31.6,21,51,41.2,14,20,70.0,3,13,16,10,19,21,14,5,2,0,45,Polski Cukier SIDEn Toruń,Sezon 2011/2012
2012-03-24 17:00,NETO PTG Sokół Łańcut(d),75 : 73W,75,19,43,44.2,4,9,44.4,23,52,44.2,25,32,78.1,11,27,38,16,29,22,17,4,2,0,82,Polski Cukier SIDEn Toruń,Sezon 2011/2012
2012-03-28 17:00,Start Gdynia(w),95 : 85P,85,17,37,45.9,6,20,30.0,23,57,40.4,33,38,86.8,9,17,26,7,22,33,10,5,1,0,75,Polski Cukier SIDEn Toruń,Sezon 2011/2012
2012-04-01 17:30,MKS Start Lublin(d),76 : 71W,76,22,34,64.7,6,21,28.6,28,55,50.9,14,20,70.0,4,31,35,18,22,19,17,8,3,0,90,Polski Cukier SIDEn Toruń,Sezon 2011/2012
2011-10-01 18:00,POLOmarket Sportino Inowrocław(d),67 : 52W,67,16,37,43.2,3,17,17.6,19,54,35.2,26,35,74.3,4,36,40,9,17,25,12,7,4,0,71,Rosa Radom,Sezon 2011/2012
2011-10-08 17:00,KS Spójnia Stargard Szczeciński(w),61 : 49P,49,14,29,48.3,3,27,11.1,17,56,30.4,12,18,66.7,11,25,36,3,17,22,12,10,1,0,42,Rosa Radom,Sezon 2011/2012
2011-10-15 18:00,NETO PTG Sokół Łańcut(d),68 : 66W,68,20,49,40.8,5,16,31.3,25,65,38.5,13,17,76.5,10,23,33,12,27,18,14,4,2,0,61,Rosa Radom,Sezon 2011/2012
2011-10-19 16:00,Start Gdynia(w),90 : 76P,76,20,40,50.0,7,19,36.8,27,59,45.8,15,18,83.3,8,20,28,14,23,21,20,5,1,0,69,Rosa Radom,Sezon 2011/2012
2011-10-22 18:00,MKS Start Lublin(d),82 : 44W,82,27,51,52.9,6,16,37.5,33,67,49.3,10,12,83.3,8,32,40,25,25,20,11,12,5,0,117,Rosa Radom,Sezon 2011/2012
2011-10-29 18:00,MKS Dąbrowa Górnicza(w),66 : 67W,67,18,40,45.0,6,21,28.6,24,61,39.3,13,19,68.4,12,34,46,13,27,19,13,6,1,0,77,Rosa Radom,Sezon 2011/2012
2011-11-05 18:00,MKS Znicz Basket Pruszków(d),91 : 103P,91,22,51,43.1,10,22,45.5,32,73,43.8,17,34,50.0,14,26,40,16,39,30,16,4,6,0,83,Rosa Radom,Sezon 2011/2012
2011-11-13 17:00,Polski Cukier SIDEn Toruń(w),76 : 63P,63,13,36,36.1,7,14,50.0,20,50,40.0,16,26,61.5,9,21,30,14,24,23,18,4,3,0,56,Rosa Radom,Sezon 2011/2012
2011-11-16 18:00,AZS Radex Szczecin(d),77 : 57W,77,25,40,62.5,6,21,28.6,31,61,50.8,9,14,64.3,12,19,31,14,13,15,11,7,4,0,87,Rosa Radom,Sezon 2011/2012
2011-11-19 17:30,AZS WSGK POLFARMEX Kutno(w),76 : 58P,58,15,33,45.5,5,19,26.3,20,52,38.5,13,18,72.2,10,14,24,6,20,19,18,5,5,0,43,Rosa Radom,Sezon 2011/2012
2011-11-26 18:00,MKS Budimpex Polonia Przemyśl(d),61 : 57W,61,21,47,44.7,1,10,10.0,22,57,38.6,16,19,84.2,11,31,42,8,16,19,17,6,3,0,65,Rosa Radom,Sezon 2011/2012
2011-12-04 18:00,Delikatesy Centrum PBS Bank MOSiR Krosno(w),65 : 76W,76,23,39,59.0,7,22,31.8,30,61,49.2,9,15,60.0,15,32,47,14,29,17,23,7,3,0,87,Rosa Radom,Sezon 2011/2012
2011-12-14 18:00,Focus Mall Sudety Jelenia Góra(d),79 : 44W,79,31,51,60.8,3,15,20.0,34,66,51.5,8,11,72.7,11,36,47,16,22,16,17,9,7,0,106,Rosa Radom,Sezon 2011/2012
2011-12-18 18:00,Siedlecki Klub Koszykówki Siedlce(w),69 : 55P,55,14,35,40.0,4,16,25.0,18,51,35.3,15,22,68.2,8,16,24,9,18,20,19,11,0,0,40,Rosa Radom,Sezon 2011/2012
2011-12-21 16:00,POLOmarket Sportino Inowrocław(w),59 : 75W,75,25,44,56.8,6,22,27.3,31,66,47.0,7,9,77.8,11,21,32,16,23,14,15,8,4,0,83,Rosa Radom,Sezon 2011/2012
2012-01-07 18:00,KS Spójnia Stargard Szczeciński(d),70 : 68W,70,21,36,58.3,7,22,31.8,28,58,48.3,7,11,63.6,5,24,29,19,18,15,11,8,0,0,81,Rosa Radom,Sezon 2011/2012
2012-01-14 17:30,NETO PTG Sokół Łańcut(w),72 : 68P,68,16,36,44.4,7,32,21.9,23,68,33.8,15,21,71.4,7,25,32,11,29,22,10,9,2,0,61,Rosa Radom,Sezon 2011/2012
2012-01-18 18:00,Start Gdynia(d),72 : 80P,72,24,47,51.1,4,22,18.2,28,69,40.6,12,19,63.2,11,17,28,10,27,21,11,11,0,0,62,Rosa Radom,Sezon 2011/2012
2012-01-28 18:00,MKS Start Lublin(w),66 : 79W,79,18,43,41.9,11,20,55.0,29,63,46.0,10,15,66.7,9,25,34,15,15,16,13,14,2,0,92,Rosa Radom,Sezon 2011/2012
2012-02-04 18:00,MKS Dąbrowa Górnicza(d),77 : 73W,77,23,45,51.1,7,22,31.8,30,67,44.8,10,15,66.7,10,25,35,20,23,17,10,6,2,0,88,Rosa Radom,Sezon 2011/2012
2012-02-11 18:00,MKS Znicz Basket Pruszków(w),73 : 69P,69,15,43,34.9,7,26,26.9,22,69,31.9,18,26,69.2,10,29,39,13,28,24,11,7,2,0,64,Rosa Radom,Sezon 2011/2012
2012-02-25 19:00,Polski Cukier SIDEn Toruń(d),77 : 50W,77,23,46,50.0,6,17,35.3,29,63,46.0,13,20,65.0,10,29,39,16,29,23,10,10,3,0,94,Rosa Radom,Sezon 2011/2012
2012-02-29 18:00,AZS Radex Szczecin(w),76 : 80W,80,30,50,60.0,3,14,21.4,33,64,51.6,11,14,78.6,12,23,35,9,18,20,11,6,1,0,86,Rosa Radom,Sezon 2011/2012
2012-03-03 18:00,AZS WSGK POLFARMEX Kutno(d),72 : 71W,72,24,47,51.1,5,16,31.3,29,63,46.0,9,13,69.2,12,20,32,14,18,20,13,15,1,0,83,Rosa Radom,Sezon 2011/2012
2012-03-10 17:00,MKS Budimpex Polonia Przemyśl(w),87 : 88W,88,23,42,54.8,11,20,55.0,34,62,54.8,9,11,81.8,11,19,30,18,20,15,16,5,2,0,97,Rosa Radom,Sezon 2011/2012
2012-03-17 18:00,Delikatesy Centrum PBS Bank MOSiR Krosno(d),75 : 64W,75,18,45,40.0,9,17,52.9,27,62,43.5,12,17,70.6,7,21,28,16,23,22,13,10,2,0,78,Rosa Radom,Sezon 2011/2012
2012-03-28 18:30,Focus Mall Sudety Jelenia Góra(w),64 : 88W,88,27,44,61.4,8,19,42.1,35,63,55.6,10,16,62.5,10,25,35,22,19,18,15,11,2,0,109,Rosa Radom,Sezon 2011/2012
2012-03-31 18:00,Siedlecki Klub Koszykówki Siedlce(d),66 : 76P,66,12,43,27.9,11,27,40.7,23,70,32.9,9,13,69.2,12,24,36,16,21,18,11,5,2,0,63,Rosa Radom,Sezon 2011/2012
2012-04-14 18:00,NETO PTG Sokół Łańcut(d),81 : 64W,81,24,55,43.6,9,19,47.4,33,74,44.6,6,8,75.0,11,25,36,16,23,14,11,11,1,0,91,Rosa Radom,Sezon 2011/2012
2012-04-15 18:00,NETO PTG Sokół Łańcut(d),75 : 60W,75,20,40,50.0,7,16,43.8,27,56,48.2,14,20,70.0,7,22,29,13,18,21,13,8,2,0,79,Rosa Radom,Sezon 2011/2012
2012-04-21 17:30,NETO PTG Sokół Łańcut(w),82 : 72P,72,22,44,50.0,5,22,22.7,27,66,40.9,13,15,86.7,11,24,35,12,21,19,17,10,2,0,73,Rosa Radom,Sezon 2011/2012
2012-04-22 17:30,NETO PTG Sokół Łańcut(w),54 : 69W,69,22,48,45.8,5,10,50.0,27,58,46.6,10,14,71.4,10,27,37,8,14,23,14,5,2,0,72,Rosa Radom,Sezon 2011/2012
2012-04-28 18:00,MKS Dąbrowa Górnicza(d),80 : 79W,80,22,44,50.0,8,21,38.1,30,65,46.2,12,17,70.6,4,24,28,11,22,22,7,5,3,0,80,Rosa Radom,Sezon 2011/2012
2012-04-29 18:00,MKS Dąbrowa Górnicza(d),85 : 91P,85,23,46,50.0,4,17,23.5,27,63,42.9,27,38,71.1,7,29,36,13,24,31,16,8,5,0,84,Rosa Radom,Sezon 2011/2012
2012-05-05 18:00,MKS Dąbrowa Górnicza(w),61 : 65W,65,23,57,40.4,2,15,13.3,25,72,34.7,13,19,68.4,16,30,46,9,20,22,12,2,0,0,57,Rosa Radom,Sezon 2011/2012
2012-05-06 18:00,MKS Dąbrowa Górnicza(w),94 : 90P,90,28,56,50.0,4,20,20.0,32,76,42.1,22,29,75.9,14,25,39,7,29,27,14,7,3,0,81,Rosa Radom,Sezon 2011/2012
2012-05-09 18:00,MKS Dąbrowa Górnicza(d),94 : 87W,94,22,49,44.9,5,13,38.5,27,62,43.5,35,51,68.6,13,39,52,10,27,32,11,2,3,0,99,Rosa Radom,Sezon 2011/2012
2012-05-12 17:00,Start Gdynia(w),67 : 82W,82,19,44,43.2,9,18,50.0,28,62,45.2,17,19,89.5,6,27,33,13,19,22,10,3,1,0,86,Rosa Radom,Sezon 2011/2012
2012-05-13 17:00,Start Gdynia(w),73 : 56P,56,18,39,46.2,5,25,20.0,23,64,35.9,5,9,55.6,14,20,34,6,20,18,17,5,2,0,41,Rosa Radom,Sezon 2011/2012
2012-05-19 19:00,Start Gdynia(d),81 : 86P,81,22,51,43.1,6,19,31.6,28,70,40.0,19,33,57.6,17,30,47,6,28,27,12,5,3,0,74,Rosa Radom,Sezon 2011/2012
2012-05-20 18:00,Start Gdynia(d),56 : 75P,56,18,40,45.0,3,16,18.8,21,56,37.5,11,21,52.4,8,19,27,6,15,20,14,4,1,0,35,Rosa Radom,Sezon 2011/2012
2011-10-01 19:00,Focus Mall Sudety Jelenia Góra(w),52 : 64W,64,20,37,54.1,3,10,30.0,23,47,48.9,15,25,60.0,8,26,34,12,18,23,17,5,2,0,66,Siedlecki Klub Koszykówki Siedlce,Sezon 2011/2012
2011-10-15 18:00,POLOmarket Sportino Inowrocław(d),72 : 64W,72,19,39,48.7,3,13,23.1,22,52,42.3,25,43,58.1,16,28,44,15,23,34,15,2,3,0,73,Siedlecki Klub Koszykówki Siedlce,Sezon 2011/2012
2011-10-19 18:00,KS Spójnia Stargard Szczeciński(w),77 : 71P,71,18,39,46.2,6,25,24.0,24,64,37.5,17,23,73.9,16,25,41,15,24,25,14,4,3,0,74,Siedlecki Klub Koszykówki Siedlce,Sezon 2011/2012
2011-10-23 16:00,NETO PTG Sokół Łańcut(d),64 : 81P,64,21,47,44.7,3,12,25.0,24,59,40.7,13,16,81.3,10,23,33,11,27,20,15,2,4,0,61,Siedlecki Klub Koszykówki Siedlce,Sezon 2011/2012
2011-10-29 17:00,Start Gdynia(w),87 : 64P,64,20,43,46.5,4,15,26.7,24,58,41.4,12,18,66.7,12,21,33,14,18,19,20,3,3,0,57,Siedlecki Klub Koszykówki Siedlce,Sezon 2011/2012
2011-11-05 18:00,MKS Start Lublin(d),85 : 64W,85,27,51,52.9,3,12,25.0,30,63,47.6,22,29,75.9,11,28,39,24,22,23,15,12,7,0,112,Siedlecki Klub Koszykówki Siedlce,Sezon 2011/2012
2011-11-12 18:00,MKS Dąbrowa Górnicza(w),71 : 51P,51,15,41,36.6,5,16,31.3,20,57,35.1,6,10,60.0,12,18,30,12,22,14,17,5,3,0,43,Siedlecki Klub Koszykówki Siedlce,Sezon 2011/2012
2011-11-16 18:00,MKS Znicz Basket Pruszków(d),94 : 75W,94,26,51,51.0,7,12,58.3,33,63,52.4,21,26,80.8,13,26,39,23,22,25,12,5,4,0,118,Siedlecki Klub Koszykówki Siedlce,Sezon 2011/2012
2011-11-20 17:00,Polski Cukier SIDEn Toruń(w),70 : 81W,81,24,42,57.1,4,10,40.0,28,52,53.8,21,36,58.3,7,29,36,15,29,29,12,5,10,0,96,Siedlecki Klub Koszykówki Siedlce,Sezon 2011/2012
2011-11-27 16:00,AZS Radex Szczecin(d),60 : 59W,60,18,44,40.9,6,13,46.2,24,57,42.1,6,17,35.3,15,29,44,11,25,21,18,5,5,0,63,Siedlecki Klub Koszykówki Siedlce,Sezon 2011/2012
2011-12-03 17:30,AZS WSGK POLFARMEX Kutno(w),70 : 68P,68,18,35,51.4,4,12,33.3,22,47,46.8,20,30,66.7,6,27,33,7,22,27,15,5,3,0,66,Siedlecki Klub Koszykówki Siedlce,Sezon 2011/2012
2011-12-10 17:00,MKS Budimpex Polonia Przemyśl(d),59 : 70P,59,23,47,48.9,2,15,13.3,25,62,40.3,7,13,53.8,9,23,32,11,16,19,12,6,4,0,57,Siedlecki Klub Koszykówki Siedlce,Sezon 2011/2012
2011-12-14 18:00,Delikatesy Centrum PBS Bank MOSiR Krosno(w),62 : 69W,69,26,48,54.2,3,17,17.6,29,65,44.6,8,8,100.0,14,25,39,14,18,17,15,5,2,0,78,Siedlecki Klub Koszykówki Siedlce,Sezon 2011/2012
2011-12-18 18:00,Rosa Radom(d),69 : 55W,69,22,51,43.1,5,12,41.7,27,63,42.9,10,15,66.7,15,25,40,13,21,18,21,11,2,0,73,Siedlecki Klub Koszykówki Siedlce,Sezon 2011/2012
2011-12-21 20:00,Focus Mall Sudety Jelenia Góra(d),85 : 63W,85,25,40,62.5,9,18,50.0,34,58,58.6,8,10,80.0,5,26,31,24,10,14,9,7,5,0,117,Siedlecki Klub Koszykówki Siedlce,Sezon 2011/2012
2012-01-14 18:00,POLOmarket Sportino Inowrocław(w),61 : 66W,66,19,42,45.2,2,6,33.3,21,48,43.8,22,34,64.7,10,33,43,12,19,27,19,7,5,0,75,Siedlecki Klub Koszykówki Siedlce,Sezon 2011/2012
2012-01-18 18:00,KS Spójnia Stargard Szczeciński(d),72 : 62W,72,18,42,42.9,7,18,38.9,25,60,41.7,15,25,60.0,14,37,51,14,20,23,17,8,4,0,87,Siedlecki Klub Koszykówki Siedlce,Sezon 2011/2012
2012-01-28 17:30,NETO PTG Sokół Łańcut(w),67 : 63P,63,19,47,40.4,5,15,33.3,24,62,38.7,10,15,66.7,7,23,30,13,20,16,11,10,5,0,67,Siedlecki Klub Koszykówki Siedlce,Sezon 2011/2012
2012-02-04 18:00,Start Gdynia(d),76 : 71W,76,23,43,53.5,3,17,17.6,26,60,43.3,21,26,80.8,11,23,34,15,15,24,11,8,2,0,85,Siedlecki Klub Koszykówki Siedlce,Sezon 2011/2012
2012-02-11 19:00,MKS Start Lublin(w),65 : 70W,70,18,48,37.5,3,10,30.0,21,58,36.2,25,30,83.3,10,26,36,9,25,20,10,6,5,0,74,Siedlecki Klub Koszykówki Siedlce,Sezon 2011/2012
2012-02-25 18:00,MKS Dąbrowa Górnicza(d),66 : 58W,66,21,44,47.7,4,16,25.0,25,60,41.7,12,21,57.1,11,27,38,15,25,25,16,4,5,0,68,Siedlecki Klub Koszykówki Siedlce,Sezon 2011/2012
2012-02-29 19:00,MKS Znicz Basket Pruszków(w),42 : 62W,62,14,40,35.0,6,16,37.5,20,56,35.7,16,27,59.3,13,35,48,12,20,24,16,8,1,0,68,Siedlecki Klub Koszykówki Siedlce,Sezon 2011/2012
2012-03-04 17:00,Polski Cukier SIDEn Toruń(d),80 : 56W,80,25,45,55.6,4,11,36.4,29,56,51.8,18,22,81.8,10,34,44,21,17,20,22,6,2,0,100,Siedlecki Klub Koszykówki Siedlce,Sezon 2011/2012
2012-03-10 18:00,AZS Radex Szczecin(w),78 : 76P,76,19,35,54.3,8,18,44.4,27,53,50.9,14,21,66.7,3,31,34,14,24,21,13,2,2,0,82,Siedlecki Klub Koszykówki Siedlce,Sezon 2011/2012
2012-03-18 17:00,AZS WSGK POLFARMEX Kutno(d),78 : 54W,78,25,53,47.2,4,9,44.4,29,62,46.8,16,26,61.5,12,36,48,15,21,23,12,7,3,0,96,Siedlecki Klub Koszykówki Siedlce,Sezon 2011/2012
2012-03-24 18:00,MKS Budimpex Polonia Przemyśl(w),77 : 71P,71,19,39,48.7,6,15,40.0,25,54,46.3,15,19,78.9,8,20,28,10,14,18,12,5,6,0,75,Siedlecki Klub Koszykówki Siedlce,Sezon 2011/2012
2012-03-28 18:00,Delikatesy Centrum PBS Bank MOSiR Krosno(d),49 : 68P,49,17,47,36.2,2,13,15.4,19,60,31.7,9,15,60.0,15,25,40,4,16,21,17,4,3,0,36,Siedlecki Klub Koszykówki Siedlce,Sezon 2011/2012
2012-03-31 18:00,Rosa Radom(w),66 : 76W,76,23,47,48.9,6,16,37.5,29,63,46.0,12,14,85.7,9,31,40,16,18,21,15,6,3,0,90,Siedlecki Klub Koszykówki Siedlce,Sezon 2011/2012
2012-04-14 16:00,MKS Dąbrowa Górnicza(d),77 : 79P,77,19,40,47.5,8,18,44.4,27,58,46.6,15,23,65.2,7,27,34,18,23,24,16,5,2,0,81,Siedlecki Klub Koszykówki Siedlce,Sezon 2011/2012
2012-04-15 16:00,MKS Dąbrowa Górnicza(d),71 : 86P,71,24,49,49.0,4,17,23.5,28,66,42.4,11,14,78.6,12,22,34,14,25,17,12,4,2,0,72,Siedlecki Klub Koszykówki Siedlce,Sezon 2011/2012
2012-04-21 18:00,MKS Dąbrowa Górnicza(w),98 : 65P,65,17,39,43.6,7,21,33.3,24,60,40.0,10,16,62.5,6,24,30,9,22,13,15,4,3,0,54,Siedlecki Klub Koszykówki Siedlce,Sezon 2011/2012
2011-10-01 17:30,AZS WSGK POLFARMEX Kutno(w),65 : 73W,73,22,36,61.1,3,16,18.8,25,52,48.1,20,26,76.9,7,16,23,7,24,25,12,5,3,0,66,Start Gdynia,Sezon 2011/2012
2011-10-09 17:00,MKS Budimpex Polonia Przemyśl(d),86 : 78W,86,25,36,69.4,3,19,15.8,28,55,50.9,27,41,65.9,7,31,38,14,24,27,12,7,6,0,98,Start Gdynia,Sezon 2011/2012
2011-10-16 18:00,Delikatesy Centrum PBS Bank MOSiR Krosno(w),78 : 74P,74,28,52,53.8,4,16,25.0,32,68,47.1,6,10,60.0,12,29,41,10,24,15,17,4,1,0,73,Start Gdynia,Sezon 2011/2012
2011-10-19 16:00,Rosa Radom(d),90 : 76W,90,20,34,58.8,11,27,40.7,31,61,50.8,17,22,77.3,5,21,26,22,21,22,13,8,5,0,103,Start Gdynia,Sezon 2011/2012
2011-10-22 18:30,Focus Mall Sudety Jelenia Góra(w),39 : 67W,67,21,48,43.8,5,19,26.3,26,67,38.8,10,10,100.0,13,26,39,16,12,17,7,8,7,0,89,Start Gdynia,Sezon 2011/2012
2011-10-29 17:00,Siedlecki Klub Koszykówki Siedlce(d),87 : 64W,87,25,47,53.2,9,18,50.0,34,65,52.3,10,13,76.9,6,19,25,20,19,18,8,14,4,0,108,Start Gdynia,Sezon 2011/2012
2011-11-05 18:00,POLOmarket Sportino Inowrocław(w),58 : 82W,82,18,32,56.3,8,17,47.1,26,49,53.1,22,27,81.5,8,27,35,13,23,21,19,7,3,0,93,Start Gdynia,Sezon 2011/2012
2011-11-12 17:00,KS Spójnia Stargard Szczeciński(d),76 : 66W,76,19,38,50.0,8,17,47.1,27,55,49.1,14,17,82.4,3,23,26,13,22,18,13,9,4,0,84,Start Gdynia,Sezon 2011/2012
2011-11-16 18:00,NETO PTG Sokół Łańcut(w),78 : 69P,69,15,28,53.6,10,28,35.7,25,56,44.6,9,18,50.0,8,20,28,11,26,19,26,12,1,0,55,Start Gdynia,Sezon 2011/2012
2011-11-26 17:00,MKS Start Lublin(d),91 : 74W,91,24,44,54.5,9,23,39.1,33,67,49.3,16,21,76.2,10,28,38,19,23,18,14,8,2,0,105,Start Gdynia,Sezon 2011/2012
2011-12-03 18:00,MKS Dąbrowa Górnicza(w),107 : 100P,100,25,54,46.3,11,32,34.4,36,86,41.9,17,28,60.7,17,35,52,19,31,24,15,5,2,0,102,Start Gdynia,Sezon 2011/2012
2011-12-10 19:30,MKS Znicz Basket Pruszków(d),107 : 56W,107,37,50,74.0,6,18,33.3,43,68,63.2,15,18,83.3,10,22,32,24,19,21,10,16,6,0,147,Start Gdynia,Sezon 2011/2012
2011-12-14 18:30,Polski Cukier SIDEn Toruń(w),73 : 83W,83,23,43,53.5,6,18,33.3,29,61,47.5,19,24,79.2,6,21,27,10,28,23,8,10,0,0,85,Start Gdynia,Sezon 2011/2012
2011-12-17 17:00,AZS Radex Szczecin(d),67 : 74P,67,24,50,48.0,3,20,15.0,27,70,38.6,10,16,62.5,15,15,30,10,27,21,10,5,1,0,54,Start Gdynia,Sezon 2011/2012
2011-12-21 16:00,AZS WSGK POLFARMEX Kutno(d),92 : 74W,92,31,48,64.6,5,10,50.0,36,58,62.1,15,16,93.8,10,14,24,15,12,15,18,8,2,0,100,Start Gdynia,Sezon 2011/2012
2012-01-07 18:00,MKS Budimpex Polonia Przemyśl(w),79 : 76P,76,23,34,67.6,6,27,22.2,29,61,47.5,12,16,75.0,7,16,23,15,20,17,16,9,2,0,73,Start Gdynia,Sezon 2011/2012
2012-01-13 19:00,Delikatesy Centrum PBS Bank MOSiR Krosno(d),99 : 46W,99,22,35,62.9,12,24,50.0,34,59,57.6,19,21,90.5,7,26,33,22,14,23,13,9,4,0,127,Start Gdynia,Sezon 2011/2012
2012-01-18 18:00,Rosa Radom(w),72 : 80W,80,17,33,51.5,6,17,35.3,23,50,46.0,28,39,71.8,8,24,32,8,21,27,14,7,0,0,75,Start Gdynia,Sezon 2011/2012
2012-01-28 17:00,Focus Mall Sudety Jelenia Góra(d),82 : 59W,82,21,37,56.8,8,23,34.8,29,60,48.3,16,20,80.0,9,26,35,20,18,19,14,16,2,0,106,Start Gdynia,Sezon 2011/2012
2012-02-04 18:00,Siedlecki Klub Koszykówki Siedlce(w),76 : 71P,71,19,32,59.4,9,25,36.0,28,57,49.1,6,9,66.7,3,20,23,11,24,15,15,3,3,0,64,Start Gdynia,Sezon 2011/2012
2012-02-11 17:00,POLOmarket Sportino Inowrocław(d),84 : 69W,84,21,37,56.8,6,20,30.0,27,57,47.4,24,27,88.9,8,23,31,18,20,28,18,11,4,0,97,Start Gdynia,Sezon 2011/2012
2012-02-23 18:00,KS Spójnia Stargard Szczeciński(w),59 : 76W,76,24,38,63.2,8,25,32.0,32,63,50.8,4,11,36.4,11,23,34,13,19,16,13,11,2,0,85,Start Gdynia,Sezon 2011/2012
2012-02-29 15:00,NETO PTG Sokół Łańcut(d),93 : 54W,93,31,53,58.5,3,15,20.0,34,68,50.0,22,25,88.0,9,29,38,16,25,23,14,9,3,0,108,Start Gdynia,Sezon 2011/2012
2012-03-10 19:00,MKS Start Lublin(w),63 : 72W,72,21,45,46.7,5,17,29.4,26,62,41.9,15,24,62.5,8,25,33,12,19,20,7,8,1,0,74,Start Gdynia,Sezon 2011/2012
2012-03-20 17:00,MKS Dąbrowa Górnicza(d),93 : 92W,93,31,55,56.4,4,17,23.5,35,72,48.6,19,23,82.6,9,24,33,13,21,21,6,5,5,0,102,Start Gdynia,Sezon 2011/2012
2012-03-24 18:00,MKS Znicz Basket Pruszków(w),68 : 76W,76,17,42,40.5,4,15,26.7,21,57,36.8,30,41,73.2,11,26,37,5,15,25,11,9,4,0,73,Start Gdynia,Sezon 2011/2012
2012-03-28 17:00,Polski Cukier SIDEn Toruń(d),95 : 85W,95,15,37,40.5,15,27,55.6,30,64,46.9,20,23,87.0,14,22,36,20,33,21,17,4,4,0,105,Start Gdynia,Sezon 2011/2012
2012-03-31 16:00,AZS Radex Szczecin(w),76 : 70P,70,21,42,50.0,6,23,26.1,27,65,41.5,10,15,66.7,11,19,30,12,20,14,11,4,3,0,65,Start Gdynia,Sezon 2011/2012
2012-04-14 15:00,AZS WSGK POLFARMEX Kutno(d),82 : 61W,82,27,47,57.4,6,18,33.3,33,65,50.8,10,12,83.3,12,27,39,15,20,13,12,11,3,0,104,Start Gdynia,Sezon 2011/2012
2012-04-15 17:00,AZS WSGK POLFARMEX Kutno(d),95 : 73W,95,32,47,68.1,5,11,45.5,37,58,63.8,16,18,88.9,10,23,33,12,23,21,13,3,5,0,112,Start Gdynia,Sezon 2011/2012
2012-04-21 17:30,AZS WSGK POLFARMEX Kutno(w),69 : 72W,72,25,44,56.8,4,15,26.7,29,59,49.2,10,11,90.9,7,17,24,11,21,16,16,3,1,0,64,Start Gdynia,Sezon 2011/2012
2012-04-28 17:00,MKS Znicz Basket Pruszków(d),68 : 57W,68,23,49,46.9,2,12,16.7,25,61,41.0,16,20,80.0,8,26,34,13,20,19,16,9,4,0,72,Start Gdynia,Sezon 2011/2012
2012-04-29 17:00,MKS Znicz Basket Pruszków(d),78 : 75W,78,22,42,52.4,6,20,30.0,28,62,45.2,16,22,72.7,11,24,35,11,24,22,13,8,4,0,83,Start Gdynia,Sezon 2011/2012
2012-05-05 17:00,MKS Znicz Basket Pruszków(w),93 : 85P,85,20,40,50.0,11,24,45.8,31,64,48.4,12,19,63.2,8,22,30,16,24,19,13,5,4,0,87,Start Gdynia,Sezon 2011/2012
2012-05-06 17:00,MKS Znicz Basket Pruszków(w),76 : 77W,77,23,48,47.9,4,30,13.3,27,78,34.6,19,31,61.3,17,31,48,10,23,30,14,10,5,0,73,Start Gdynia,Sezon 2011/2012
2012-05-12 17:00,Rosa Radom(d),67 : 82P,67,21,41,51.2,6,29,20.7,27,70,38.6,7,11,63.6,11,25,36,12,22,19,12,4,1,0,61,Start Gdynia,Sezon 2011/2012
2012-05-13 17:00,Rosa Radom(d),73 : 56W,73,21,51,41.2,6,21,28.6,27,72,37.5,13,14,92.9,19,26,45,11,18,20,14,6,5,0,80,Start Gdynia,Sezon 2011/2012
2012-05-19 19:00,Rosa Radom(w),81 : 86W,86,22,51,43.1,7,22,31.8,29,73,39.7,21,33,63.6,12,28,40,14,28,28,9,4,0,0,79,Start Gdynia,Sezon 2011/2012
2012-05-20 18:00,Rosa Radom(w),56 : 75W,75,25,40,62.5,6,18,33.3,31,58,53.4,7,11,63.6,7,23,30,19,21,15,11,6,5,0,93,Start Gdynia,Sezon 2011/2012
2010-09-25 15:30,MKS Dąbrowa Górnicza(d),91 : 68W,91,27,46,58.7,6,19,31.6,33,65,50.8,19,23,82.6,8,24,32,15,16,23,9,11,2,2,106,Asseco Prokom 2 Gdynia,Sezon 2010/2011
2010-10-02 18:00,GKS Tychy(w),77 : 81W,81,23,44,52.3,5,14,35.7,28,58,48.3,20,23,87.0,10,24,34,6,20,21,16,5,2,2,79,Asseco Prokom 2 Gdynia,Sezon 2010/2011
2010-10-06 15:30,Victoria Górnik Wałbrzych(d),105 : 71W,105,34,56,60.7,8,20,40.0,42,76,55.3,13,19,68.4,18,25,43,21,16,19,11,13,3,2,134,Asseco Prokom 2 Gdynia,Sezon 2010/2011
2010-10-10 16:00,AZS Politechnika Warszawska(w),75 : 69P,69,18,48,37.5,6,16,37.5,24,64,37.5,15,20,75.0,9,25,34,14,23,22,13,10,3,3,72,Asseco Prokom 2 Gdynia,Sezon 2010/2011
2010-10-16 16:00,Rosa Radom(d),68 : 70P,68,16,36,44.4,7,25,28.0,23,61,37.7,15,17,88.2,7,15,22,12,21,21,10,10,1,5,63,Asseco Prokom 2 Gdynia,Sezon 2010/2011
2010-10-23 19:00,KPSW Astoria Bydgoszcz(w),48 : 68W,68,20,37,54.1,6,22,27.3,26,59,44.1,10,19,52.6,9,24,33,15,21,21,13,8,2,1,71,Asseco Prokom 2 Gdynia,Sezon 2010/2011
2010-10-27 15:30,MKS Start Lublin(d),107 : 53W,107,39,53,73.6,5,17,29.4,44,70,62.9,14,16,87.5,5,33,38,19,24,17,15,12,8,1,141,Asseco Prokom 2 Gdynia,Sezon 2010/2011
2010-11-07 19:00,SKK Siedlce(w),64 : 84W,84,17,39,43.6,10,23,43.5,27,62,43.5,20,29,69.0,7,25,32,16,18,21,11,11,2,3,90,Asseco Prokom 2 Gdynia,Sezon 2010/2011
2010-11-13 16:00,MKS Znicz Basket Pruszków(d),84 : 77W,84,20,34,58.8,8,27,29.6,28,61,45.9,20,29,69.0,10,37,47,15,25,22,18,10,1,4,97,Asseco Prokom 2 Gdynia,Sezon 2010/2011
2010-11-20 16:00,PTG Sokół Łańcut(d),66 : 70P,66,23,37,62.2,5,21,23.8,28,58,48.3,5,10,50.0,13,32,45,15,18,15,21,5,5,1,80,Asseco Prokom 2 Gdynia,Sezon 2010/2011
2010-11-27 17:00,KS Spójnia Stargard Szczeciński(w),72 : 63P,63,14,44,31.8,6,23,26.1,20,67,29.9,17,20,85.0,9,29,38,13,26,24,17,16,3,7,66,Asseco Prokom 2 Gdynia,Sezon 2010/2011
2010-12-04 16:00,Polonia 2011 Warszawa(d),78 : 71W,78,27,48,56.3,5,18,27.8,32,66,48.5,9,12,75.0,12,28,40,19,17,14,18,7,1,1,90,Asseco Prokom 2 Gdynia,Sezon 2010/2011
2010-12-11 18:00,ŁKS Sphinx Łódź(w),75 : 69P,69,18,35,51.4,8,22,36.4,26,57,45.6,9,16,56.3,9,14,23,16,17,21,14,11,3,0,70,Asseco Prokom 2 Gdynia,Sezon 2010/2011
2010-12-18 16:00,Sportino Inowrocław(w),78 : 80W,80,22,49,44.9,9,23,39.1,31,72,43.1,9,14,64.3,17,29,46,19,19,17,15,6,3,5,93,Asseco Prokom 2 Gdynia,Sezon 2010/2011
2011-01-19 18:00,Victoria Górnik Wałbrzych(w),53 : 83W,83,29,40,72.5,6,18,33.3,35,58,60.3,7,12,58.3,8,28,36,17,21,14,19,11,1,2,101,Asseco Prokom 2 Gdynia,Sezon 2010/2011
2011-01-23 16:00,AZS Politechnika Warszawska(d),70 : 64W,70,23,40,57.5,3,21,14.3,26,61,42.6,15,18,83.3,10,25,35,14,23,18,11,7,3,2,80,Asseco Prokom 2 Gdynia,Sezon 2010/2011
2011-01-29 13:30,Rosa Radom(w),83 : 94W,94,24,48,50.0,8,19,42.1,32,67,47.8,22,30,73.3,10,21,31,14,20,24,9,12,3,4,102,Asseco Prokom 2 Gdynia,Sezon 2010/2011
2011-02-02 17:00,AZS Radex Szczecin(d),69 : 90P,69,13,31,41.9,6,24,25.0,19,55,34.5,25,32,78.1,12,21,33,11,23,22,17,7,1,0,61,Asseco Prokom 2 Gdynia,Sezon 2010/2011
2011-02-05 15:30,KPSW Astoria Bydgoszcz(d),90 : 71W,90,23,48,47.9,6,14,42.9,29,62,46.8,26,31,83.9,5,21,26,20,19,22,11,13,3,4,103,Asseco Prokom 2 Gdynia,Sezon 2010/2011
2011-02-09 19:30,MKS Start Lublin(w),77 : 66P,66,17,38,44.7,7,18,38.9,24,56,42.9,11,13,84.6,5,23,28,10,17,17,17,8,4,3,65,Asseco Prokom 2 Gdynia,Sezon 2010/2011
2011-02-12 15:00,SKK Siedlce(d),82 : 70W,82,23,47,48.9,6,24,25.0,29,71,40.8,18,24,75.0,16,20,36,20,15,21,14,17,2,4,95,Asseco Prokom 2 Gdynia,Sezon 2010/2011
2011-02-15 15:00,GKS Tychy(d),80 : 75W,80,25,45,55.6,7,18,38.9,32,63,50.8,9,9,100.0,6,23,29,15,16,13,9,7,2,3,93,Asseco Prokom 2 Gdynia,Sezon 2010/2011
2011-02-20 18:00,MKS Znicz Basket Pruszków(w),75 : 46P,46,15,41,36.6,1,19,5.3,16,60,26.7,13,18,72.2,18,20,38,3,17,22,23,8,1,1,24,Asseco Prokom 2 Gdynia,Sezon 2010/2011
2011-02-23 18:00,PTG Sokół Łańcut(w),73 : 59P,59,14,29,48.3,5,20,25.0,19,49,38.8,16,24,66.7,7,23,30,9,24,24,12,11,1,0,60,Asseco Prokom 2 Gdynia,Sezon 2010/2011
2011-02-26 18:00,MKS Dąbrowa Górnicza(w),79 : 69P,69,21,44,47.7,8,25,32.0,29,69,42.0,3,8,37.5,11,26,37,11,21,14,15,7,1,6,65,Asseco Prokom 2 Gdynia,Sezon 2010/2011
2011-03-05 16:00,KS Spójnia Stargard Szczeciński(d),80 : 76W,80,20,34,58.8,8,22,36.4,28,56,50.0,16,19,84.2,4,21,25,12,23,23,15,7,2,3,80,Asseco Prokom 2 Gdynia,Sezon 2010/2011
2011-03-13 16:00,Polonia 2011 Warszawa(w),83 : 88W,88,29,53,54.7,6,15,40.0,35,68,51.5,12,15,80.0,14,27,41,12,17,23,15,8,2,3,100,Asseco Prokom 2 Gdynia,Sezon 2010/2011
2011-03-19 16:00,ŁKS Sphinx Łódź(d),74 : 77P,74,24,40,60.0,4,17,23.5,28,57,49.1,14,22,63.6,8,28,36,12,18,24,14,7,3,0,81,Asseco Prokom 2 Gdynia,Sezon 2010/2011
2011-03-23 18:00,AZS Radex Szczecin(w),82 : 105W,105,28,46,60.9,12,20,60.0,40,66,60.6,13,20,65.0,8,18,26,17,19,18,11,14,2,2,120,Asseco Prokom 2 Gdynia,Sezon 2010/2011
2011-03-26 16:00,Sportino Inowrocław(d),94 : 68W,94,31,48,64.6,6,16,37.5,37,64,57.8,14,19,73.7,3,26,29,20,18,22,9,8,4,2,114,Asseco Prokom 2 Gdynia,Sezon 2010/2011
2011-04-03 20:00,MKS Dąbrowa Górnicza(w),59 : 58P,58,15,43,34.9,5,18,27.8,20,61,32.8,13,20,65.0,10,24,34,5,16,21,11,14,1,5,53,Asseco Prokom 2 Gdynia,Sezon 2010/2011
2011-04-06 15:30,MKS Dąbrowa Górnicza(d),90 : 83W,90,28,45,62.2,4,15,26.7,32,60,53.3,22,27,81.5,8,19,27,18,27,28,14,8,4,3,100,Asseco Prokom 2 Gdynia,Sezon 2010/2011
2011-04-09 18:00,MKS Dąbrowa Górnicza(w),63 : 47P,47,12,39,30.8,5,17,29.4,17,56,30.4,8,15,53.3,6,26,32,9,23,22,11,7,3,5,41,Asseco Prokom 2 Gdynia,Sezon 2010/2011
2010-09-25 18:00,KPSW Astoria Bydgoszcz(w),65 : 75W,75,19,37,51.4,7,26,26.9,26,63,41.3,16,25,64.0,12,24,36,14,26,24,14,12,1,0,78,AZS Politechnika Warszawska,Sezon 2010/2011
2010-10-02 13:00,MKS Start Lublin(d),76 : 67W,76,20,36,55.6,6,25,24.0,26,61,42.6,18,27,66.7,10,22,32,12,22,6,12,11,1,0,76,AZS Politechnika Warszawska,Sezon 2010/2011
2010-10-06 20:00,SKK Siedlce(w),50 : 67W,67,16,34,47.1,6,23,26.1,22,57,38.6,17,27,63.0,9,25,34,14,24,23,16,14,4,0,72,AZS Politechnika Warszawska,Sezon 2010/2011
2010-10-10 16:00,Asseco Prokom 2 Gdynia(d),75 : 69W,75,18,36,50.0,8,26,30.8,26,62,41.9,15,23,65.2,8,28,36,17,22,23,14,8,3,3,81,AZS Politechnika Warszawska,Sezon 2010/2011
2010-10-16 17:30,PTG Sokół Łańcut(w),75 : 78W,78,16,28,57.1,8,23,34.8,24,51,47.1,22,30,73.3,9,19,28,15,28,23,15,11,1,2,83,AZS Politechnika Warszawska,Sezon 2010/2011
2010-10-23 15:00,KS Spójnia Stargard Szczeciński(d),77 : 68W,77,18,45,40.0,9,22,40.9,27,67,40.3,14,28,50.0,12,26,38,17,23,23,14,12,4,2,80,AZS Politechnika Warszawska,Sezon 2010/2011
2010-10-27 17:30,Polonia 2011 Warszawa(w),79 : 85W,85,17,34,50.0,10,23,43.5,27,57,47.4,21,36,58.3,10,33,43,17,23,28,19,12,2,3,95,AZS Politechnika Warszawska,Sezon 2010/2011
2010-11-06 14:30,ŁKS Sphinx Łódź(d),67 : 63W,67,20,31,64.5,4,18,22.2,24,49,49.0,15,22,68.2,5,32,37,20,18,21,19,9,1,1,83,AZS Politechnika Warszawska,Sezon 2010/2011
2010-11-13 18:30,AZS Radex Szczecin(w),79 : 89W,89,22,34,64.7,9,27,33.3,31,61,50.8,18,28,64.3,11,21,32,18,21,23,18,8,2,2,91,AZS Politechnika Warszawska,Sezon 2010/2011
2010-11-20 14:00,Sportino Inowrocław(d),71 : 69W,71,18,43,41.9,8,26,30.8,26,69,37.7,11,21,52.4,12,22,34,14,20,19,15,8,3,3,62,AZS Politechnika Warszawska,Sezon 2010/2011
2010-11-27 18:00,MKS Dąbrowa Górnicza(w),83 : 69P,69,13,31,41.9,7,19,36.8,20,50,40.0,22,38,57.9,9,16,25,11,17,25,15,6,5,3,55,AZS Politechnika Warszawska,Sezon 2010/2011
2010-12-11 17:00,Victoria Górnik Wałbrzych(w),99 : 108W,108,33,57,57.9,9,29,31.0,42,86,48.8,15,17,88.2,18,27,45,14,15,19,14,16,3,0,126,AZS Politechnika Warszawska,Sezon 2010/2011
2010-12-15 18:00,MKS Znicz Basket Pruszków(w),91 : 88P,88,22,38,57.9,7,27,25.9,29,65,44.6,23,31,74.2,8,39,47,19,27,26,22,8,5,2,101,AZS Politechnika Warszawska,Sezon 2010/2011
2010-12-19 16:00,Rosa Radom(d),72 : 62W,72,16,29,55.2,11,34,32.4,27,63,42.9,7,12,58.3,11,22,33,22,18,16,17,14,4,0,87,AZS Politechnika Warszawska,Sezon 2010/2011
2011-01-12 16:30,GKS Tychy(d),79 : 70W,79,22,40,55.0,7,26,26.9,29,66,43.9,14,19,73.7,11,25,36,18,22,18,15,14,3,1,93,AZS Politechnika Warszawska,Sezon 2010/2011
2011-01-15 18:00,MKS Start Lublin(w),63 : 92W,92,23,37,62.2,11,24,45.8,34,61,55.7,13,16,81.3,6,27,33,22,18,17,13,10,1,1,115,AZS Politechnika Warszawska,Sezon 2010/2011
2011-01-19 17:00,SKK Siedlce(d),81 : 78W,81,27,51,52.9,5,19,26.3,32,70,45.7,12,14,85.7,10,23,33,15,20,17,15,15,3,0,92,AZS Politechnika Warszawska,Sezon 2010/2011
2011-01-23 16:00,Asseco Prokom 2 Gdynia(w),70 : 64P,64,22,50,44.0,4,14,28.6,26,64,40.6,8,18,44.4,9,20,29,11,18,23,10,4,2,3,52,AZS Politechnika Warszawska,Sezon 2010/2011
2011-01-29 15:00,PTG Sokół Łańcut(d),80 : 76W,80,18,37,48.6,8,20,40.0,26,57,45.6,20,27,74.1,6,20,26,16,20,22,15,14,5,2,88,AZS Politechnika Warszawska,Sezon 2010/2011
2011-02-05 17:00,KS Spójnia Stargard Szczeciński(w),57 : 58W,58,17,46,37.0,5,17,29.4,22,63,34.9,9,15,60.0,11,30,41,16,19,21,17,7,2,7,60,AZS Politechnika Warszawska,Sezon 2010/2011
2011-02-09 18:00,Polonia 2011 Warszawa(d),86 : 66W,86,25,37,67.6,8,20,40.0,33,57,57.9,12,17,70.6,8,20,28,22,20,21,26,15,3,2,99,AZS Politechnika Warszawska,Sezon 2010/2011
2011-02-13 17:00,ŁKS Sphinx Łódź(w),81 : 74P,74,20,39,51.3,9,26,34.6,29,65,44.6,7,10,70.0,6,23,29,18,16,19,11,9,1,1,81,AZS Politechnika Warszawska,Sezon 2010/2011
2011-02-19 15:00,AZS Radex Szczecin(d),85 : 70W,85,26,46,56.5,8,21,38.1,34,67,50.7,9,11,81.8,12,23,35,14,17,18,12,7,3,0,97,AZS Politechnika Warszawska,Sezon 2010/2011
2011-02-23 18:00,Sportino Inowrocław(w),60 : 65W,65,18,39,46.2,4,16,25.0,22,55,40.0,17,21,81.0,13,24,37,11,18,22,18,12,4,1,74,AZS Politechnika Warszawska,Sezon 2010/2011
2011-02-26 15:00,KPSW Astoria Bydgoszcz(d),85 : 69W,85,28,46,60.9,5,16,31.3,33,62,53.2,14,20,70.0,9,23,32,26,17,20,12,9,3,0,108,AZS Politechnika Warszawska,Sezon 2010/2011
2011-03-05 15:00,MKS Dąbrowa Górnicza(d),66 : 70P,66,22,44,50.0,6,20,30.0,28,64,43.8,4,6,66.7,6,26,32,15,19,18,19,11,4,5,71,AZS Politechnika Warszawska,Sezon 2010/2011
2011-03-12 18:00,GKS Tychy(w),76 : 88W,88,22,34,64.7,11,26,42.3,33,60,55.0,11,14,78.6,10,24,34,27,23,11,14,6,5,4,116,AZS Politechnika Warszawska,Sezon 2010/2011
2011-03-23 17:00,MKS Znicz Basket Pruszków(d),80 : 69W,80,24,44,54.5,7,21,33.3,31,65,47.7,11,24,45.8,14,21,35,19,20,28,17,15,3,1,88,AZS Politechnika Warszawska,Sezon 2010/2011
2011-03-26 18:00,Rosa Radom(w),80 : 65P,65,16,40,40.0,6,30,20.0,22,70,31.4,15,25,60.0,14,22,36,15,17,25,10,14,2,1,64,AZS Politechnika Warszawska,Sezon 2010/2011
2011-04-02 15:00,KS Spójnia Stargard Szczeciński(d),71 : 56W,71,15,31,48.4,9,25,36.0,24,56,42.9,14,22,63.6,8,20,28,13,20,24,16,9,5,1,70,AZS Politechnika Warszawska,Sezon 2010/2011
2011-04-06 18:00,KS Spójnia Stargard Szczeciński(w),61 : 67W,67,18,30,60.0,8,22,36.4,26,52,50.0,7,11,63.6,8,24,32,16,21,16,16,11,5,2,85,AZS Politechnika Warszawska,Sezon 2010/2011
2011-04-16 15:00,PTG Sokół Łańcut(d),71 : 64W,71,18,37,48.6,6,24,25.0,24,61,39.3,17,21,81.0,14,18,32,18,28,19,13,11,2,0,80,AZS Politechnika Warszawska,Sezon 2010/2011
2011-04-17 15:00,PTG Sokół Łańcut(d),74 : 65W,74,12,27,44.4,8,19,42.1,20,46,43.5,26,36,72.2,8,28,36,14,25,27,17,4,2,1,77,AZS Politechnika Warszawska,Sezon 2010/2011
2011-05-01 18:00,PTG Sokół Łańcut(w),64 : 90W,90,20,38,52.6,14,26,53.8,34,64,53.1,8,12,66.7,9,21,30,18,24,20,9,10,3,4,108,AZS Politechnika Warszawska,Sezon 2010/2011
2011-05-07 18:00,ŁKS Sphinx Łódź(w),69 : 87W,87,32,52,61.5,3,17,17.6,35,69,50.7,14,18,77.8,7,29,36,18,17,21,6,9,1,2,107,AZS Politechnika Warszawska,Sezon 2010/2011
2011-05-11 17:00,ŁKS Sphinx Łódź(d),79 : 64W,79,18,42,42.9,11,23,47.8,29,65,44.6,10,13,76.9,6,28,34,15,13,14,12,12,3,1,92,AZS Politechnika Warszawska,Sezon 2010/2011
2010-09-25 17:00,KS Spójnia Stargard Szczeciński(w),76 : 87W,87,24,44,54.5,7,16,43.8,31,60,51.7,18,21,85.7,7,23,30,17,27,20,14,8,4,2,100,AZS Radex Szczecin,Sezon 2010/2011
2010-10-02 18:00,Polonia 2011 Warszawa(d),107 : 108P,107,29,59,49.2,8,20,40.0,37,79,46.8,25,37,67.6,17,32,49,16,21,24,22,12,7,6,115,AZS Radex Szczecin,Sezon 2010/2011
2010-10-06 18:00,ŁKS Sphinx Łódź(d),88 : 76W,88,31,46,67.4,3,16,18.8,34,62,54.8,17,19,89.5,6,22,28,14,27,23,12,15,1,1,104,AZS Radex Szczecin,Sezon 2010/2011
2010-10-10 19:00,MKS Znicz Basket Pruszków(w),70 : 62P,62,21,45,46.7,3,19,15.8,24,64,37.5,11,17,64.7,13,25,38,10,20,15,19,9,4,7,58,AZS Radex Szczecin,Sezon 2010/2011
2010-10-16 18:00,Sportino Inowrocław(d),82 : 83P,82,22,46,47.8,5,17,29.4,27,63,42.9,23,23,100.0,8,21,29,17,21,27,12,8,2,2,90,AZS Radex Szczecin,Sezon 2010/2011
2010-10-23 18:00,MKS Dąbrowa Górnicza(w),77 : 71P,71,18,43,41.9,9,23,39.1,27,66,40.9,8,10,80.0,11,27,38,22,19,17,19,5,3,4,79,AZS Radex Szczecin,Sezon 2010/2011
2010-10-27 18:00,GKS Tychy(d),83 : 75W,83,30,57,52.6,6,15,40.0,36,72,50.0,5,5,100.0,8,26,34,16,17,13,11,14,2,4,102,AZS Radex Szczecin,Sezon 2010/2011
2010-11-06 16:00,Victoria Górnik Wałbrzych(w),69 : 76W,76,27,47,57.4,5,13,38.5,32,60,53.3,7,12,58.3,11,26,37,10,17,17,14,8,2,1,86,AZS Radex Szczecin,Sezon 2010/2011
2010-11-13 18:30,AZS Politechnika Warszawska(d),79 : 89P,79,25,44,56.8,3,18,16.7,28,62,45.2,20,26,76.9,9,17,26,12,23,21,12,14,2,2,81,AZS Radex Szczecin,Sezon 2010/2011
2010-11-20 18:00,Rosa Radom(w),87 : 77P,77,21,41,51.2,8,19,42.1,29,60,48.3,11,15,73.3,7,14,21,21,19,19,9,11,2,0,88,AZS Radex Szczecin,Sezon 2010/2011
2010-11-27 19:00,KPSW Astoria Bydgoszcz(d),88 : 101P,88,23,38,60.5,6,14,42.9,29,52,55.8,24,34,70.6,8,16,24,14,25,24,19,10,2,1,86,AZS Radex Szczecin,Sezon 2010/2011
2010-12-04 17:00,MKS Start Lublin(w),69 : 67P,67,21,48,43.8,5,12,41.7,26,60,43.3,10,18,55.6,9,26,35,7,23,22,16,10,4,4,65,AZS Radex Szczecin,Sezon 2010/2011
2010-12-12 20:00,SKK Siedlce(d),79 : 76W,79,16,36,44.4,10,23,43.5,26,59,44.1,17,20,85.0,6,27,33,12,23,21,14,12,4,3,90,AZS Radex Szczecin,Sezon 2010/2011
2010-12-18 18:00,PTG Sokół Łańcut(d),71 : 77P,71,22,36,61.1,7,22,31.8,29,58,50.0,6,12,50.0,6,23,29,19,20,15,15,14,5,2,88,AZS Radex Szczecin,Sezon 2010/2011
2011-01-16 18:00,Polonia 2011 Warszawa(w),84 : 76P,76,24,44,54.5,4,16,25.0,28,60,46.7,16,25,64.0,14,21,35,11,25,21,24,13,1,1,71,AZS Radex Szczecin,Sezon 2010/2011
2011-01-19 19:00,ŁKS Sphinx Łódź(w),97 : 60P,60,16,37,43.2,5,20,25.0,21,57,36.8,13,22,59.1,10,16,26,12,26,23,18,8,2,1,45,AZS Radex Szczecin,Sezon 2010/2011
2011-01-22 19:00,MKS Znicz Basket Pruszków(d),87 : 86W,87,27,43,62.8,5,14,35.7,32,57,56.1,18,26,69.2,8,26,34,17,21,25,14,11,6,3,108,AZS Radex Szczecin,Sezon 2010/2011
2011-01-29 18:00,Sportino Inowrocław(w),82 : 75P,75,17,41,41.5,10,24,41.7,27,65,41.5,11,16,68.8,14,20,34,17,28,20,15,11,4,5,83,AZS Radex Szczecin,Sezon 2010/2011
2011-02-02 17:00,Asseco Prokom 2 Gdynia(w),69 : 90W,90,22,39,56.4,10,23,43.5,32,62,51.6,16,18,88.9,8,24,32,17,23,22,13,9,0,1,103,AZS Radex Szczecin,Sezon 2010/2011
2011-02-05 19:00,MKS Dąbrowa Górnicza(d),74 : 72W,74,25,46,54.3,3,15,20.0,28,61,45.9,15,19,78.9,9,26,35,10,19,19,12,10,1,3,81,AZS Radex Szczecin,Sezon 2010/2011
2011-02-09 19:00,GKS Tychy(w),87 : 70P,70,25,46,54.3,2,14,14.3,27,60,45.0,14,16,87.5,5,20,25,20,26,18,13,3,2,6,72,AZS Radex Szczecin,Sezon 2010/2011
2011-02-12 19:00,Victoria Górnik Wałbrzych(d),61 : 57W,61,16,39,41.0,6,20,30.0,22,59,37.3,11,18,61.1,9,28,37,17,16,18,18,22,2,4,77,AZS Radex Szczecin,Sezon 2010/2011
2011-02-19 15:00,AZS Politechnika Warszawska(w),85 : 70P,70,15,33,45.5,11,23,47.8,26,56,46.4,7,13,53.8,5,18,23,14,18,17,11,6,0,3,66,AZS Radex Szczecin,Sezon 2010/2011
2011-02-23 18:00,Rosa Radom(d),61 : 68P,61,16,37,43.2,6,25,24.0,22,62,35.5,11,13,84.6,8,31,39,14,20,14,11,7,1,2,69,AZS Radex Szczecin,Sezon 2010/2011
2011-02-26 18:00,KS Spójnia Stargard Szczeciński(d),73 : 81P,73,21,42,50.0,4,13,30.8,25,55,45.5,19,22,86.4,5,22,27,12,29,23,17,13,3,3,78,AZS Radex Szczecin,Sezon 2010/2011
2011-03-05 18:00,KPSW Astoria Bydgoszcz(w),53 : 74W,74,27,46,58.7,4,18,22.2,31,64,48.4,8,14,57.1,11,31,42,17,22,18,13,12,10,2,103,AZS Radex Szczecin,Sezon 2010/2011
2011-03-13 19:00,MKS Start Lublin(d),83 : 62W,83,27,51,52.9,6,24,25.0,33,75,44.0,11,12,91.7,20,26,46,21,15,19,14,14,1,3,108,AZS Radex Szczecin,Sezon 2010/2011
2011-03-19 18:00,SKK Siedlce(w),82 : 72P,72,19,37,51.4,8,22,36.4,27,59,45.8,10,15,66.7,8,18,26,15,20,17,13,6,0,1,69,AZS Radex Szczecin,Sezon 2010/2011
2011-03-23 18:00,Asseco Prokom 2 Gdynia(d),82 : 105P,82,22,43,51.2,9,22,40.9,31,65,47.7,11,14,78.6,13,16,29,15,18,19,18,11,2,2,84,AZS Radex Szczecin,Sezon 2010/2011
2011-03-26 16:00,PTG Sokół Łańcut(w),79 : 74P,74,18,33,54.5,8,25,32.0,26,58,44.8,14,25,56.0,10,26,36,14,25,19,21,6,2,1,68,AZS Radex Szczecin,Sezon 2010/2011
2011-04-02 18:00,GKS Tychy(d),76 : 69W,76,23,33,69.7,4,15,26.7,27,48,56.3,18,21,85.7,5,26,31,17,16,23,17,13,2,0,98,AZS Radex Szczecin,Sezon 2010/2011
2011-04-03 18:00,GKS Tychy(d),61 : 63P,61,25,39,64.1,0,16,0.0,25,55,45.5,11,12,91.7,5,28,33,11,18,21,12,6,2,1,70,AZS Radex Szczecin,Sezon 2010/2011
2011-04-09 18:00,GKS Tychy(w),68 : 79W,79,22,46,47.8,5,14,35.7,27,60,45.0,20,22,90.9,12,27,39,12,17,19,15,6,3,5,89,AZS Radex Szczecin,Sezon 2010/2011
2011-04-10 18:00,GKS Tychy(w),78 : 51P,51,16,37,43.2,3,19,15.8,19,56,33.9,10,16,62.5,11,18,29,13,23,15,15,10,1,3,46,AZS Radex Szczecin,Sezon 2010/2011
2011-04-16 18:00,GKS Tychy(d),78 : 56W,78,21,36,58.3,9,21,42.9,30,57,52.6,9,12,75.0,4,28,32,20,26,18,15,15,1,5,101,AZS Radex Szczecin,Sezon 2010/2011
2010-09-25 18:00,SKK Siedlce(w),45 : 68W,68,21,47,44.7,3,15,20.0,24,62,38.7,17,21,81.0,7,34,41,12,17,15,13,11,3,3,80,GKS Tychy,Sezon 2010/2011
2010-10-02 18:00,Asseco Prokom 2 Gdynia(d),77 : 81P,77,21,42,50.0,7,20,35.0,28,62,45.2,14,19,73.7,5,21,26,19,21,20,11,12,2,3,86,GKS Tychy,Sezon 2010/2011
2010-10-06 18:00,PTG Sokół Łańcut(w),70 : 59P,59,14,32,43.8,9,24,37.5,23,56,41.1,4,6,66.7,10,26,36,13,25,19,21,8,3,1,63,GKS Tychy,Sezon 2010/2011
2010-10-09 18:00,KS Spójnia Stargard Szczeciński(d),79 : 61W,79,21,39,53.8,7,18,38.9,28,57,49.1,16,22,72.7,7,27,34,15,17,13,9,12,3,2,99,GKS Tychy,Sezon 2010/2011
2010-10-16 15:00,Polonia 2011 Warszawa(w),35 : 80W,80,22,40,55.0,9,18,50.0,31,58,53.4,9,17,52.9,10,35,45,19,19,14,20,12,0,2,101,GKS Tychy,Sezon 2010/2011
2010-10-23 18:00,ŁKS Sphinx Łódź(d),64 : 75P,64,16,35,45.7,4,16,25.0,20,51,39.2,20,27,74.1,6,24,30,9,24,20,15,9,2,3,61,GKS Tychy,Sezon 2010/2011
2010-10-27 18:00,AZS Radex Szczecin(w),83 : 75P,75,24,47,51.1,4,16,25.0,28,63,44.4,15,18,83.3,6,26,32,9,13,17,14,10,4,2,78,GKS Tychy,Sezon 2010/2011
2010-11-06 18:00,Sportino Inowrocław(d),60 : 73P,60,19,39,48.7,3,15,20.0,22,54,40.7,13,25,52.0,7,19,26,10,15,15,14,13,3,2,54,GKS Tychy,Sezon 2010/2011
2010-11-13 18:00,MKS Dąbrowa Górnicza(w),62 : 60P,60,18,44,40.9,6,17,35.3,24,61,39.3,6,13,46.2,3,20,23,12,18,21,3,10,1,6,59,GKS Tychy,Sezon 2010/2011
2010-12-11 18:00,Rosa Radom(d),56 : 64P,56,20,42,47.6,3,22,13.6,23,64,35.9,7,13,53.8,8,25,33,10,16,15,8,10,2,0,56,GKS Tychy,Sezon 2010/2011
2010-12-15 18:00,KPSW Astoria Bydgoszcz(w),76 : 66P,66,25,47,53.2,3,19,15.8,28,66,42.4,7,22,31.8,10,24,34,13,20,23,7,5,7,2,65,GKS Tychy,Sezon 2010/2011
2010-12-18 18:00,MKS Start Lublin(d),80 : 71W,80,25,41,61.0,7,21,33.3,32,62,51.6,9,12,75.0,7,24,31,13,12,18,12,13,2,1,94,GKS Tychy,Sezon 2010/2011
2011-01-12 16:30,AZS Politechnika Warszawska(w),79 : 70P,70,21,43,48.8,6,17,35.3,27,60,45.0,10,17,58.8,6,23,29,18,18,22,16,14,1,3,76,GKS Tychy,Sezon 2010/2011
2011-01-18 18:00,PTG Sokół Łańcut(d),68 : 76P,68,20,39,51.3,3,13,23.1,23,52,44.2,19,26,73.1,9,22,31,17,25,23,17,9,4,4,76,GKS Tychy,Sezon 2010/2011
2011-01-22 17:00,KS Spójnia Stargard Szczeciński(w),78 : 65P,65,19,40,47.5,3,12,25.0,22,52,42.3,18,22,81.8,5,23,28,15,18,21,18,9,3,0,68,GKS Tychy,Sezon 2010/2011
2011-01-29 18:00,Polonia 2011 Warszawa(d),75 : 66W,75,25,51,49.0,3,14,21.4,28,65,43.1,16,23,69.6,12,25,37,20,14,26,19,18,9,4,96,GKS Tychy,Sezon 2010/2011
2011-02-05 18:00,ŁKS Sphinx Łódź(w),73 : 68P,68,21,43,48.8,3,12,25.0,24,55,43.6,17,30,56.7,6,21,27,10,20,27,10,8,4,0,63,GKS Tychy,Sezon 2010/2011
2011-02-09 19:00,AZS Radex Szczecin(d),87 : 70W,87,23,40,57.5,4,15,26.7,27,55,49.1,29,32,90.6,7,25,32,13,18,26,10,7,6,2,104,GKS Tychy,Sezon 2010/2011
2011-02-12 18:00,Sportino Inowrocław(w),73 : 67P,67,15,29,51.7,8,17,47.1,23,46,50.0,13,22,59.1,5,34,39,7,17,23,19,6,3,2,71,GKS Tychy,Sezon 2010/2011
2011-02-15 15:00,Asseco Prokom 2 Gdynia(w),80 : 75P,75,27,51,52.9,5,13,38.5,32,64,50.0,6,11,54.5,11,24,35,11,13,16,9,4,3,2,82,GKS Tychy,Sezon 2010/2011
2011-02-19 18:00,MKS Dąbrowa Górnicza(d),67 : 83P,67,20,45,44.4,3,14,21.4,23,59,39.0,18,25,72.0,8,20,28,7,21,26,12,11,3,3,61,GKS Tychy,Sezon 2010/2011
2011-02-23 18:00,MKS Znicz Basket Pruszków(w),83 : 60P,60,19,45,42.2,2,8,25.0,21,53,39.6,16,21,76.2,7,18,25,10,20,22,18,7,1,2,48,GKS Tychy,Sezon 2010/2011
2011-02-26 18:00,SKK Siedlce(d),73 : 75P,73,22,40,55.0,1,13,7.7,23,53,43.4,26,30,86.7,4,23,27,10,21,16,11,13,1,1,79,GKS Tychy,Sezon 2010/2011
2011-03-04 18:00,Victoria Górnik Wałbrzych(w),52 : 79W,79,21,39,53.8,8,21,38.1,29,60,48.3,13,15,86.7,8,30,38,22,18,16,14,10,4,3,106,GKS Tychy,Sezon 2010/2011
2011-03-12 18:00,AZS Politechnika Warszawska(d),76 : 88P,76,25,44,56.8,5,16,31.3,30,60,50.0,11,17,64.7,9,16,25,10,18,17,13,9,4,5,75,GKS Tychy,Sezon 2010/2011
2011-03-19 19:00,Rosa Radom(w),86 : 72P,72,14,36,38.9,13,24,54.2,27,60,45.0,5,8,62.5,5,13,18,13,17,14,14,9,3,3,65,GKS Tychy,Sezon 2010/2011
2011-03-23 18:00,KPSW Astoria Bydgoszcz(d),90 : 68W,90,31,54,57.4,6,12,50.0,37,66,56.1,10,14,71.4,8,18,26,25,18,18,4,11,5,3,120,GKS Tychy,Sezon 2010/2011
2011-03-26 19:00,MKS Start Lublin(w),87 : 73P,73,25,46,54.3,4,20,20.0,29,66,43.9,11,17,64.7,11,22,33,12,17,17,9,7,1,2,74,GKS Tychy,Sezon 2010/2011
2011-04-02 18:00,AZS Radex Szczecin(w),76 : 69P,69,18,32,56.3,6,21,28.6,24,53,45.3,15,15,100.0,3,16,19,4,23,16,14,16,0,2,65,GKS Tychy,Sezon 2010/2011
2011-04-03 18:00,AZS Radex Szczecin(w),61 : 63W,63,25,56,44.6,1,7,14.3,26,63,41.3,10,17,58.8,10,20,30,12,21,18,6,12,1,2,68,GKS Tychy,Sezon 2010/2011
2011-04-09 18:00,AZS Radex Szczecin(d),68 : 79P,68,23,45,51.1,4,16,25.0,27,61,44.3,10,15,66.7,7,20,27,12,19,17,7,12,5,3,78,GKS Tychy,Sezon 2010/2011
2011-04-10 18:00,AZS Radex Szczecin(d),78 : 51W,78,20,34,58.8,8,21,38.1,28,55,50.9,14,24,58.3,9,27,36,15,22,14,12,10,3,1,93,GKS Tychy,Sezon 2010/2011
2011-04-16 18:00,AZS Radex Szczecin(w),78 : 56P,56,15,38,39.5,2,12,16.7,17,50,34.0,20,27,74.1,8,19,27,5,18,26,18,13,5,1,48,GKS Tychy,Sezon 2010/2011
2010-09-25 18:00,AZS Politechnika Warszawska(d),65 : 75P,65,21,44,47.7,3,15,20.0,24,59,40.7,14,29,48.3,12,24,36,9,24,26,16,9,0,0,53,KPSW Astoria Bydgoszcz,Sezon 2010/2011
2010-10-02 19:00,Rosa Radom(w),80 : 71P,71,17,41,41.5,6,19,31.6,23,60,38.3,19,29,65.5,8,17,25,8,25,22,7,4,0,3,54,KPSW Astoria Bydgoszcz,Sezon 2010/2011
2010-10-06 19:00,MKS Znicz Basket Pruszków(d),62 : 69P,62,19,36,52.8,7,23,30.4,26,59,44.1,3,10,30.0,6,30,36,11,27,17,18,7,3,3,61,KPSW Astoria Bydgoszcz,Sezon 2010/2011
2010-10-10 18:00,MKS Start Lublin(d),66 : 67P,66,24,40,60.0,3,24,12.5,27,64,42.2,9,18,50.0,11,25,36,10,22,21,13,7,2,2,62,KPSW Astoria Bydgoszcz,Sezon 2010/2011
2010-10-16 18:00,SKK Siedlce(w),60 : 59P,59,21,50,42.0,2,20,10.0,23,70,32.9,11,21,52.4,13,28,41,6,26,25,15,9,3,6,46,KPSW Astoria Bydgoszcz,Sezon 2010/2011
2010-10-23 19:00,Asseco Prokom 2 Gdynia(d),48 : 68P,48,11,40,27.5,6,22,27.3,17,62,27.4,8,18,44.4,13,23,36,7,21,21,14,8,1,2,31,KPSW Astoria Bydgoszcz,Sezon 2010/2011
2010-10-27 18:00,PTG Sokół Łańcut(w),94 : 65P,65,20,43,46.5,3,17,17.6,23,60,38.3,16,27,59.3,8,13,21,13,30,24,17,12,2,2,48,KPSW Astoria Bydgoszcz,Sezon 2010/2011
2010-11-06 16:30,KS Spójnia Stargard Szczeciński(d),59 : 67P,59,16,40,40.0,6,20,30.0,22,60,36.7,9,16,56.3,12,18,30,8,22,20,18,12,4,1,50,KPSW Astoria Bydgoszcz,Sezon 2010/2011
2010-11-14 17:00,Polonia 2011 Warszawa(w),82 : 76P,76,19,43,44.2,7,21,33.3,26,64,40.6,17,33,51.5,15,20,35,10,27,30,20,14,1,3,62,KPSW Astoria Bydgoszcz,Sezon 2010/2011
2010-11-20 17:00,ŁKS Sphinx Łódź(d),80 : 79W,80,22,45,48.9,7,22,31.8,29,67,43.3,15,22,68.2,14,13,27,9,23,21,12,9,1,1,69,KPSW Astoria Bydgoszcz,Sezon 2010/2011
2010-11-27 19:00,AZS Radex Szczecin(w),88 : 101W,101,36,58,62.1,3,13,23.1,39,71,54.9,20,28,71.4,11,19,30,11,24,25,10,17,1,2,110,KPSW Astoria Bydgoszcz,Sezon 2010/2011
2010-12-04 16:30,Sportino Inowrocław(d),76 : 96P,76,25,58,43.1,6,19,31.6,31,77,40.3,8,18,44.4,16,22,38,12,17,18,14,7,2,5,65,KPSW Astoria Bydgoszcz,Sezon 2010/2011
2010-12-11 18:00,MKS Dąbrowa Górnicza(w),94 : 72P,72,20,47,42.6,6,17,35.3,26,64,40.6,14,24,58.3,8,18,26,9,30,20,13,4,2,7,52,KPSW Astoria Bydgoszcz,Sezon 2010/2011
2010-12-15 18:00,GKS Tychy(d),76 : 66W,76,16,42,38.1,11,22,50.0,27,64,42.2,11,15,73.3,8,26,34,16,23,20,12,5,2,7,80,KPSW Astoria Bydgoszcz,Sezon 2010/2011
2010-12-18 17:00,Victoria Górnik Wałbrzych(w),75 : 80W,80,20,36,55.6,6,18,33.3,26,54,48.1,22,29,75.9,3,24,27,9,22,24,18,12,2,0,77,KPSW Astoria Bydgoszcz,Sezon 2010/2011
2011-01-15 17:00,Rosa Radom(d),69 : 81P,69,17,37,45.9,9,26,34.6,26,63,41.3,8,18,44.4,12,22,34,17,23,20,17,7,3,3,66,KPSW Astoria Bydgoszcz,Sezon 2010/2011
2011-01-19 18:00,MKS Znicz Basket Pruszków(w),80 : 78P,78,25,54,46.3,2,15,13.3,27,69,39.1,22,38,57.9,21,26,47,12,31,29,12,9,0,2,76,KPSW Astoria Bydgoszcz,Sezon 2010/2011
2011-01-22 19:00,MKS Start Lublin(w),72 : 63P,63,20,49,40.8,5,18,27.8,25,67,37.3,8,20,40.0,16,17,33,8,18,19,15,12,2,6,49,KPSW Astoria Bydgoszcz,Sezon 2010/2011
2011-01-29 18:00,SKK Siedlce(d),85 : 76W,85,25,46,54.3,6,22,27.3,31,68,45.6,17,22,77.3,15,26,41,12,23,19,6,6,2,1,98,KPSW Astoria Bydgoszcz,Sezon 2010/2011
2011-02-05 15:30,Asseco Prokom 2 Gdynia(w),90 : 71P,71,21,40,52.5,6,21,28.6,27,61,44.3,11,12,91.7,10,25,35,9,22,19,22,8,4,3,70,KPSW Astoria Bydgoszcz,Sezon 2010/2011
2011-02-09 18:30,PTG Sokół Łańcut(d),52 : 71P,52,14,36,38.9,3,15,20.0,17,51,33.3,15,31,48.4,11,19,30,7,18,27,23,11,1,2,28,KPSW Astoria Bydgoszcz,Sezon 2010/2011
2011-02-12 17:00,KS Spójnia Stargard Szczeciński(w),81 : 60P,60,16,29,55.2,8,22,36.4,24,51,47.1,4,12,33.3,5,22,27,11,21,19,21,4,3,2,49,KPSW Astoria Bydgoszcz,Sezon 2010/2011
2011-02-19 18:00,Polonia 2011 Warszawa(d),88 : 84W,88,24,40,60.0,8,21,38.1,32,61,52.5,16,26,61.5,13,22,35,17,26,23,20,11,6,6,98,KPSW Astoria Bydgoszcz,Sezon 2010/2011
2011-02-23 19:00,ŁKS Sphinx Łódź(w),91 : 55P,55,16,37,43.2,3,14,21.4,19,51,37.3,14,18,77.8,5,16,21,8,21,23,19,14,1,1,44,KPSW Astoria Bydgoszcz,Sezon 2010/2011
2011-02-26 15:00,AZS Politechnika Warszawska(w),85 : 69P,69,20,47,42.6,7,23,30.4,27,70,38.6,8,13,61.5,16,18,34,9,20,17,15,5,0,3,54,KPSW Astoria Bydgoszcz,Sezon 2010/2011
2011-03-05 18:00,AZS Radex Szczecin(d),53 : 74P,53,17,39,43.6,3,16,18.8,20,55,36.4,10,26,38.5,6,17,23,11,18,22,15,8,2,10,31,KPSW Astoria Bydgoszcz,Sezon 2010/2011
2011-03-12 18:00,Sportino Inowrocław(w),78 : 72P,72,27,54,50.0,4,20,20.0,31,74,41.9,6,12,50.0,17,22,39,15,29,21,17,14,2,2,76,KPSW Astoria Bydgoszcz,Sezon 2010/2011
2011-03-19 19:00,MKS Dąbrowa Górnicza(d),69 : 80P,69,23,47,48.9,6,18,33.3,29,65,44.6,5,10,50.0,7,15,22,23,26,14,6,7,0,1,74,KPSW Astoria Bydgoszcz,Sezon 2010/2011
2011-03-23 18:00,GKS Tychy(w),90 : 68P,68,18,35,51.4,9,26,34.6,27,61,44.3,5,9,55.6,14,19,33,15,18,18,20,4,3,5,65,KPSW Astoria Bydgoszcz,Sezon 2010/2011
2011-04-02 19:00,MKS Start Lublin(w),73 : 63P,63,14,32,43.8,10,30,33.3,24,62,38.7,5,9,55.6,9,20,29,12,24,15,14,12,3,2,63,KPSW Astoria Bydgoszcz,Sezon 2010/2011
2011-04-03 18:00,MKS Start Lublin(w),72 : 56P,56,12,34,35.3,5,27,18.5,17,61,27.9,17,28,60.7,14,21,35,8,29,24,12,11,2,3,45,KPSW Astoria Bydgoszcz,Sezon 2010/2011
2011-04-09 19:00,MKS Start Lublin(d),92 : 71W,92,31,45,68.9,5,18,27.8,36,63,57.1,15,30,50.0,9,25,34,16,19,26,5,8,0,3,103,KPSW Astoria Bydgoszcz,Sezon 2010/2011
2011-04-10 19:00,MKS Start Lublin(d),79 : 71W,79,26,44,59.1,3,14,21.4,29,58,50.0,18,26,69.2,13,28,41,13,19,23,13,10,2,1,95,KPSW Astoria Bydgoszcz,Sezon 2010/2011
2011-04-17 18:00,MKS Start Lublin(w),68 : 60P,60,21,48,43.8,3,20,15.0,24,68,35.3,9,20,45.0,15,25,40,10,32,25,13,5,2,3,49,KPSW Astoria Bydgoszcz,Sezon 2010/2011
2010-09-25 17:00,AZS Radex Szczecin(d),76 : 87P,76,15,32,46.9,9,25,36.0,24,57,42.1,19,30,63.3,10,21,31,15,21,27,18,8,2,4,70,KS Spójnia Stargard Szczeciński,Sezon 2010/2011
2010-10-02 18:00,Sportino Inowrocław(w),58 : 56P,56,19,36,52.8,4,20,20.0,23,56,41.1,6,12,50.0,10,18,28,17,28,19,13,13,3,1,65,KS Spójnia Stargard Szczeciński,Sezon 2010/2011
2010-10-06 18:00,MKS Dąbrowa Górnicza(d),52 : 61P,52,13,32,40.6,4,18,22.2,17,50,34.0,14,22,63.6,7,22,29,11,27,21,16,11,0,3,46,KS Spójnia Stargard Szczeciński,Sezon 2010/2011
2010-10-09 18:00,GKS Tychy(w),79 : 61P,61,18,35,51.4,5,31,16.1,23,66,34.8,10,16,62.5,12,20,32,10,17,7,12,3,5,0,50,KS Spójnia Stargard Szczeciński,Sezon 2010/2011
2010-10-16 17:00,Victoria Górnik Wałbrzych(d),99 : 62W,99,21,37,56.8,14,27,51.9,35,64,54.7,15,22,68.2,11,30,41,26,25,21,20,14,3,2,127,KS Spójnia Stargard Szczeciński,Sezon 2010/2011
2010-10-23 15:00,AZS Politechnika Warszawska(w),77 : 68P,68,12,29,41.4,10,26,38.5,22,55,40.0,14,23,60.9,7,29,36,13,23,23,19,11,2,4,69,KS Spójnia Stargard Szczeciński,Sezon 2010/2011
2010-10-27 18:00,Rosa Radom(d),57 : 71P,57,16,47,34.0,4,24,16.7,20,71,28.2,13,19,68.4,22,22,44,13,18,24,15,7,1,4,50,KS Spójnia Stargard Szczeciński,Sezon 2010/2011
2010-11-06 16:30,KPSW Astoria Bydgoszcz(w),59 : 67W,67,24,41,58.5,3,17,17.6,27,58,46.6,10,15,66.7,12,24,36,10,20,22,18,12,1,4,72,KS Spójnia Stargard Szczeciński,Sezon 2010/2011
2010-11-13 17:00,MKS Start Lublin(d),66 : 56W,66,12,36,33.3,8,23,34.8,20,59,33.9,18,22,81.8,10,27,37,11,18,15,16,13,4,2,72,KS Spójnia Stargard Szczeciński,Sezon 2010/2011
2010-11-21 19:00,SKK Siedlce(w),62 : 55P,55,17,33,51.5,5,31,16.1,22,64,34.4,6,10,60.0,16,19,35,13,23,14,14,12,0,1,55,KS Spójnia Stargard Szczeciński,Sezon 2010/2011
2010-11-27 17:00,Asseco Prokom 2 Gdynia(d),72 : 63W,72,18,38,47.4,6,28,21.4,24,66,36.4,18,25,72.0,8,34,42,14,24,25,17,11,7,3,80,KS Spójnia Stargard Szczeciński,Sezon 2010/2011
2010-12-04 17:30,PTG Sokół Łańcut(w),49 : 51W,51,8,23,34.8,9,30,30.0,17,53,32.1,8,12,66.7,8,24,32,14,20,18,14,8,1,2,52,KS Spójnia Stargard Szczeciński,Sezon 2010/2011
2010-12-12 16:00,MKS Znicz Basket Pruszków(d),63 : 57W,63,15,35,42.9,9,22,40.9,24,57,42.1,6,7,85.7,8,24,32,18,23,17,23,14,7,1,77,KS Spójnia Stargard Szczeciński,Sezon 2010/2011
2010-12-15 18:00,Polonia 2011 Warszawa(d),90 : 59W,90,23,39,59.0,8,22,36.4,31,61,50.8,20,30,66.7,10,28,38,23,19,22,12,11,5,2,115,KS Spójnia Stargard Szczeciński,Sezon 2010/2011
2010-12-19 17:00,ŁKS Sphinx Łódź(w),81 : 68P,68,11,38,28.9,10,25,40.0,21,63,33.3,16,22,72.7,9,17,26,10,22,23,12,9,0,2,53,KS Spójnia Stargard Szczeciński,Sezon 2010/2011
2011-01-15 17:00,Sportino Inowrocław(d),80 : 76W,80,16,43,37.2,11,24,45.8,27,67,40.3,15,19,78.9,14,16,30,15,30,26,17,9,3,5,76,KS Spójnia Stargard Szczeciński,Sezon 2010/2011
2011-01-19 18:00,MKS Dąbrowa Górnicza(w),84 : 61P,61,11,33,33.3,8,23,34.8,19,56,33.9,15,24,62.5,9,17,26,12,19,21,10,5,1,4,49,KS Spójnia Stargard Szczeciński,Sezon 2010/2011
2011-01-22 17:00,GKS Tychy(d),78 : 65W,78,24,51,47.1,8,24,33.3,32,75,42.7,6,11,54.5,16,26,42,20,21,18,14,12,0,3,90,KS Spójnia Stargard Szczeciński,Sezon 2010/2011
2011-01-29 16:30,Victoria Górnik Wałbrzych(w),65 : 54P,54,16,33,48.5,2,23,8.7,18,56,32.1,16,20,80.0,7,25,32,12,23,22,20,14,3,2,53,KS Spójnia Stargard Szczeciński,Sezon 2010/2011
2011-02-05 17:00,AZS Politechnika Warszawska(d),57 : 58P,57,12,34,35.3,7,27,25.9,19,61,31.1,12,18,66.7,13,24,37,11,21,19,14,10,7,2,60,KS Spójnia Stargard Szczeciński,Sezon 2010/2011
2011-02-09 18:00,Rosa Radom(w),52 : 51P,51,9,30,30.0,10,32,31.3,19,62,30.6,3,8,37.5,10,19,29,9,21,16,13,9,1,2,38,KS Spójnia Stargard Szczeciński,Sezon 2010/2011
2011-02-12 17:00,KPSW Astoria Bydgoszcz(d),81 : 60W,81,23,50,46.0,9,24,37.5,32,74,43.2,8,16,50.0,19,21,40,17,19,21,14,13,2,3,89,KS Spójnia Stargard Szczeciński,Sezon 2010/2011
2011-02-19 19:00,MKS Start Lublin(w),43 : 66W,66,22,42,52.4,5,15,33.3,27,57,47.4,7,17,41.2,11,29,40,10,16,19,13,11,2,1,76,KS Spójnia Stargard Szczeciński,Sezon 2010/2011
2011-02-23 18:00,SKK Siedlce(d),81 : 58W,81,21,46,45.7,9,24,37.5,30,70,42.9,12,15,80.0,17,29,46,17,18,17,13,11,1,3,100,KS Spójnia Stargard Szczeciński,Sezon 2010/2011
2011-02-26 18:00,AZS Radex Szczecin(w),73 : 81W,81,19,42,45.2,6,15,40.0,25,57,43.9,25,35,71.4,10,22,32,11,23,29,13,17,3,3,89,KS Spójnia Stargard Szczeciński,Sezon 2010/2011
2011-03-05 16:00,Asseco Prokom 2 Gdynia(w),80 : 76P,76,24,45,53.3,4,17,23.5,28,62,45.2,16,21,76.2,8,21,29,14,23,23,14,10,3,2,79,KS Spójnia Stargard Szczeciński,Sezon 2010/2011
2011-03-09 19:00,MKS Znicz Basket Pruszków(w),52 : 76W,76,24,51,47.1,5,12,41.7,29,63,46.0,13,24,54.2,13,28,41,12,28,26,19,13,3,4,81,KS Spójnia Stargard Szczeciński,Sezon 2010/2011
2011-03-13 17:00,PTG Sokół Łańcut(d),68 : 74P,68,12,26,46.2,10,19,52.6,22,45,48.9,14,20,70.0,2,18,20,18,28,22,21,15,8,2,79,KS Spójnia Stargard Szczeciński,Sezon 2010/2011
2011-03-23 14:30,Polonia 2011 Warszawa(w),55 : 79W,79,24,45,53.3,6,18,33.3,30,63,47.6,13,19,68.4,13,30,43,18,15,18,17,8,5,2,97,KS Spójnia Stargard Szczeciński,Sezon 2010/2011
2011-03-26 17:00,ŁKS Sphinx Łódź(d),67 : 76P,67,13,42,31.0,10,27,37.0,23,69,33.3,11,15,73.3,15,16,31,16,21,18,10,13,1,2,68,KS Spójnia Stargard Szczeciński,Sezon 2010/2011
2011-04-02 15:00,AZS Politechnika Warszawska(w),71 : 56P,56,16,32,50.0,5,20,25.0,21,52,40.4,9,17,52.9,9,23,32,6,24,20,16,8,1,5,48,KS Spójnia Stargard Szczeciński,Sezon 2010/2011
2011-04-06 18:00,AZS Politechnika Warszawska(d),61 : 67P,61,12,36,33.3,9,20,45.0,21,56,37.5,10,18,55.6,10,18,28,13,16,21,13,11,2,5,59,KS Spójnia Stargard Szczeciński,Sezon 2010/2011
2010-09-26 16:00,Polonia 2011 Warszawa(w),56 : 87W,87,26,45,57.8,6,19,31.6,32,64,50.0,17,24,70.8,12,23,35,17,18,22,9,13,0,2,104,ŁKS Sphinx Łódź,Sezon 2010/2011
2010-10-02 16:00,MKS Znicz Basket Pruszków(w),75 : 65P,65,17,40,42.5,5,19,26.3,22,59,37.3,16,22,72.7,11,13,24,8,22,24,16,13,3,1,54,ŁKS Sphinx Łódź,Sezon 2010/2011
2010-10-06 18:00,AZS Radex Szczecin(w),88 : 76P,76,25,40,62.5,1,17,5.9,26,57,45.6,23,32,71.9,10,20,30,5,23,27,15,11,1,1,68,ŁKS Sphinx Łódź,Sezon 2010/2011
2010-10-11 19:00,Sportino Inowrocław(w),60 : 53P,53,13,37,35.1,5,29,17.2,18,66,27.3,12,26,46.2,17,24,41,9,23,27,11,9,4,1,43,ŁKS Sphinx Łódź,Sezon 2010/2011
2010-10-16 18:00,MKS Dąbrowa Górnicza(d),69 : 73P,69,15,31,48.4,9,29,31.0,24,60,40.0,12,27,44.4,15,21,36,15,23,23,18,10,2,2,63,ŁKS Sphinx Łódź,Sezon 2010/2011
2010-10-23 18:00,GKS Tychy(w),64 : 75W,75,18,35,51.4,9,27,33.3,27,62,43.5,12,19,63.2,8,23,31,15,22,16,13,7,4,1,77,ŁKS Sphinx Łódź,Sezon 2010/2011
2010-10-27 19:00,Victoria Górnik Wałbrzych(d),70 : 61W,70,16,37,43.2,7,22,31.8,23,59,39.0,17,18,94.4,10,27,37,17,19,20,17,9,1,1,80,ŁKS Sphinx Łódź,Sezon 2010/2011
2010-11-06 14:30,AZS Politechnika Warszawska(w),67 : 63P,63,18,42,42.9,7,24,29.2,25,66,37.9,6,11,54.5,8,19,27,15,22,18,13,16,1,1,63,ŁKS Sphinx Łódź,Sezon 2010/2011
2010-11-12 19:00,Rosa Radom(d),79 : 72W,79,16,34,47.1,9,32,28.1,25,66,37.9,20,30,66.7,12,24,36,20,22,30,13,14,1,1,86,ŁKS Sphinx Łódź,Sezon 2010/2011
2010-11-20 17:00,KPSW Astoria Bydgoszcz(w),80 : 79P,79,23,36,63.9,7,15,46.7,30,51,58.8,12,22,54.5,10,23,33,15,21,23,18,9,1,1,88,ŁKS Sphinx Łódź,Sezon 2010/2011
2010-11-28 17:00,MKS Start Lublin(d),75 : 59W,75,22,52,42.3,8,24,33.3,30,76,39.5,7,12,58.3,17,25,42,18,21,17,11,15,2,4,90,ŁKS Sphinx Łódź,Sezon 2010/2011
2010-12-04 18:00,SKK Siedlce(w),66 : 69W,69,16,36,44.4,6,26,23.1,22,62,35.5,19,22,86.4,11,21,32,17,17,23,13,15,2,3,79,ŁKS Sphinx Łódź,Sezon 2010/2011
2010-12-11 18:00,Asseco Prokom 2 Gdynia(d),75 : 69W,75,14,34,41.2,12,27,44.4,26,61,42.6,11,13,84.6,14,19,33,16,21,17,16,12,0,3,83,ŁKS Sphinx Łódź,Sezon 2010/2011
2010-12-15 18:00,PTG Sokół Łańcut(w),70 : 76W,76,18,31,58.1,10,24,41.7,28,55,50.9,10,15,66.7,9,25,34,16,22,18,14,7,0,1,87,ŁKS Sphinx Łódź,Sezon 2010/2011
2010-12-19 17:00,KS Spójnia Stargard Szczeciński(d),81 : 68W,81,18,35,51.4,9,18,50.0,27,53,50.9,18,28,64.3,7,30,37,16,23,22,15,7,2,0,92,ŁKS Sphinx Łódź,Sezon 2010/2011
2011-01-15 18:00,MKS Znicz Basket Pruszków(d),84 : 65W,84,22,44,50.0,9,28,32.1,31,72,43.1,13,19,68.4,12,25,37,22,21,18,8,13,2,3,103,ŁKS Sphinx Łódź,Sezon 2010/2011
2011-01-19 19:00,AZS Radex Szczecin(d),97 : 60W,97,29,46,63.0,6,12,50.0,35,58,60.3,21,33,63.6,7,25,32,19,23,26,10,11,1,2,115,ŁKS Sphinx Łódź,Sezon 2010/2011
2011-01-23 17:00,Sportino Inowrocław(d),78 : 83P,78,19,45,42.2,7,27,25.9,26,72,36.1,19,22,86.4,13,26,39,10,20,18,13,9,2,7,76,ŁKS Sphinx Łódź,Sezon 2010/2011
2011-01-29 18:00,MKS Dąbrowa Górnicza(w),79 : 77P,77,22,45,48.9,7,16,43.8,29,61,47.5,12,12,100.0,10,18,28,13,26,18,14,9,2,3,83,ŁKS Sphinx Łódź,Sezon 2010/2011
2011-02-05 18:00,GKS Tychy(d),73 : 68W,73,22,36,61.1,6,23,26.1,28,59,47.5,11,22,50.0,7,27,34,20,27,21,13,4,0,4,76,ŁKS Sphinx Łódź,Sezon 2010/2011
2011-02-09 18:00,Victoria Górnik Wałbrzych(w),72 : 84W,84,21,34,61.8,12,30,40.0,33,64,51.6,6,10,60.0,8,26,34,24,20,9,16,13,2,4,106,ŁKS Sphinx Łódź,Sezon 2010/2011
2011-02-13 17:00,AZS Politechnika Warszawska(d),81 : 74W,81,17,31,54.8,11,27,40.7,28,58,48.3,14,20,70.0,6,27,33,17,19,16,14,9,1,1,91,ŁKS Sphinx Łódź,Sezon 2010/2011
2011-02-19 19:00,Rosa Radom(w),69 : 62P,62,16,36,44.4,5,25,20.0,21,61,34.4,15,22,68.2,8,20,28,14,18,22,12,11,0,2,56,ŁKS Sphinx Łódź,Sezon 2010/2011
2011-02-23 19:00,KPSW Astoria Bydgoszcz(d),91 : 55W,91,24,37,64.9,11,22,50.0,35,59,59.3,10,15,66.7,9,24,33,22,23,21,17,13,1,1,114,ŁKS Sphinx Łódź,Sezon 2010/2011
2011-02-26 17:30,Polonia 2011 Warszawa(d),78 : 56W,78,22,43,51.2,6,18,33.3,28,61,45.9,16,23,69.6,14,34,48,15,18,20,24,16,3,0,96,ŁKS Sphinx Łódź,Sezon 2010/2011
2011-03-05 19:00,MKS Start Lublin(w),55 : 69W,69,24,40,60.0,5,22,22.7,29,62,46.8,6,13,46.2,10,27,37,14,21,15,9,7,2,2,80,ŁKS Sphinx Łódź,Sezon 2010/2011
2011-03-13 17:00,SKK Siedlce(d),60 : 66P,60,18,38,47.4,5,28,17.9,23,66,34.8,9,16,56.3,8,26,34,13,19,24,12,9,2,2,56,ŁKS Sphinx Łódź,Sezon 2010/2011
2011-03-19 16:00,Asseco Prokom 2 Gdynia(w),74 : 77W,77,22,46,47.8,8,23,34.8,30,69,43.5,9,14,64.3,9,22,31,17,24,18,11,8,0,3,78,ŁKS Sphinx Łódź,Sezon 2010/2011
2011-03-23 19:00,PTG Sokół Łańcut(d),73 : 54W,73,15,25,60.0,8,24,33.3,23,49,46.9,19,30,63.3,4,27,31,18,25,26,15,9,1,1,80,ŁKS Sphinx Łódź,Sezon 2010/2011
2011-03-26 17:00,KS Spójnia Stargard Szczeciński(w),67 : 76W,76,22,37,59.5,6,17,35.3,28,54,51.9,14,22,63.6,10,23,33,12,18,21,14,5,2,1,80,ŁKS Sphinx Łódź,Sezon 2010/2011
2011-04-03 18:30,Rosa Radom(w),59 : 74W,74,20,37,54.1,7,23,30.4,27,60,45.0,13,16,81.3,4,24,28,18,20,18,7,12,2,3,91,ŁKS Sphinx Łódź,Sezon 2010/2011
2011-04-06 20:00,Rosa Radom(d),65 : 59W,65,11,25,44.0,8,33,24.2,19,58,32.8,19,26,73.1,12,26,38,14,24,26,10,12,1,1,74,ŁKS Sphinx Łódź,Sezon 2010/2011
2011-04-17 20:00,MKS Dąbrowa Górnicza(w),73 : 62P,62,14,38,36.8,7,21,33.3,21,59,35.6,13,25,52.0,8,22,30,11,26,26,14,7,1,1,47,ŁKS Sphinx Łódź,Sezon 2010/2011
2011-04-18 18:00,MKS Dąbrowa Górnicza(w),89 : 82P,82,21,41,51.2,6,21,28.6,27,62,43.5,22,32,68.8,7,31,38,14,33,28,13,6,0,3,82,ŁKS Sphinx Łódź,Sezon 2010/2011
2011-04-30 18:00,MKS Dąbrowa Górnicza(d),76 : 63W,76,17,39,43.6,9,21,42.9,26,60,43.3,15,30,50.0,18,22,40,14,22,28,10,8,6,1,85,ŁKS Sphinx Łódź,Sezon 2010/2011
2011-05-01 17:00,MKS Dąbrowa Górnicza(d),79 : 53W,79,14,31,45.2,11,26,42.3,25,57,43.9,18,23,78.3,11,27,38,18,24,23,13,4,1,3,90,ŁKS Sphinx Łódź,Sezon 2010/2011
2011-05-04 18:00,MKS Dąbrowa Górnicza(w),63 : 76W,76,16,33,48.5,7,16,43.8,23,49,46.9,23,30,76.7,7,16,23,10,23,28,12,10,1,2,75,ŁKS Sphinx Łódź,Sezon 2010/2011
2011-05-07 18:00,AZS Politechnika Warszawska(d),69 : 87P,69,16,31,51.6,11,33,33.3,27,64,42.2,4,10,40.0,11,23,34,22,21,17,16,4,2,1,72,ŁKS Sphinx Łódź,Sezon 2010/2011
2011-05-11 17:00,AZS Politechnika Warszawska(w),79 : 64P,64,18,35,51.4,6,24,25.0,24,59,40.7,10,14,71.4,4,28,32,15,14,13,17,5,1,3,61,ŁKS Sphinx Łódź,Sezon 2010/2011
2010-09-25 15:30,Asseco Prokom 2 Gdynia(w),91 : 68P,68,22,40,55.0,4,26,15.4,26,66,39.4,12,13,92.3,9,14,23,15,23,16,16,5,2,2,56,MKS Dąbrowa Górnicza,Sezon 2010/2011
2010-10-03 18:00,PTG Sokół Łańcut(d),58 : 76P,58,18,33,54.5,3,22,13.6,21,55,38.2,13,19,68.4,11,17,28,9,27,22,17,10,5,1,53,MKS Dąbrowa Górnicza,Sezon 2010/2011
2010-10-06 18:00,KS Spójnia Stargard Szczeciński(w),52 : 61W,61,17,34,50.0,4,19,21.1,21,53,39.6,15,26,57.7,11,22,33,14,21,27,18,11,3,0,61,MKS Dąbrowa Górnicza,Sezon 2010/2011
2010-10-09 18:00,Polonia 2011 Warszawa(d),91 : 57W,91,33,51,64.7,6,23,26.1,39,74,52.7,7,12,58.3,10,29,39,23,18,18,14,12,5,3,116,MKS Dąbrowa Górnicza,Sezon 2010/2011
2010-10-16 18:00,ŁKS Sphinx Łódź(w),69 : 73W,73,18,33,54.5,7,17,41.2,25,50,50.0,16,26,61.5,6,25,31,10,24,21,15,8,2,2,74,MKS Dąbrowa Górnicza,Sezon 2010/2011
2010-10-23 18:00,AZS Radex Szczecin(d),77 : 71W,77,26,49,53.1,3,19,15.8,29,68,42.6,16,20,80.0,10,25,35,18,17,19,8,11,4,3,94,MKS Dąbrowa Górnicza,Sezon 2010/2011
2010-10-27 18:00,Sportino Inowrocław(w),65 : 57P,57,17,42,40.5,7,21,33.3,24,63,38.1,2,8,25.0,9,21,30,18,19,16,15,14,3,7,62,MKS Dąbrowa Górnicza,Sezon 2010/2011
2010-11-07 18:00,MKS Znicz Basket Pruszków(w),73 : 83W,83,21,34,61.8,9,18,50.0,30,52,57.7,14,20,70.0,6,23,29,15,22,18,18,7,3,1,91,MKS Dąbrowa Górnicza,Sezon 2010/2011
2010-11-13 18:00,GKS Tychy(d),62 : 60W,62,19,38,50.0,5,20,25.0,24,58,41.4,9,13,69.2,10,33,43,14,21,18,12,2,6,1,77,MKS Dąbrowa Górnicza,Sezon 2010/2011
2010-11-22 17:00,Victoria Górnik Wałbrzych(w),99 : 90P,90,20,43,46.5,5,17,29.4,25,60,41.7,35,46,76.1,13,29,42,16,22,33,22,10,2,2,92,MKS Dąbrowa Górnicza,Sezon 2010/2011
2010-11-27 18:00,AZS Politechnika Warszawska(d),83 : 69W,83,26,52,50.0,5,16,31.3,31,68,45.6,16,25,64.0,19,26,45,14,26,17,8,11,3,5,102,MKS Dąbrowa Górnicza,Sezon 2010/2011
2010-12-05 17:00,Rosa Radom(w),81 : 64P,64,16,38,42.1,7,25,28.0,23,63,36.5,11,15,73.3,8,24,32,11,25,16,17,2,3,0,51,MKS Dąbrowa Górnicza,Sezon 2010/2011
2010-12-11 18:00,KPSW Astoria Bydgoszcz(d),94 : 72W,94,29,48,60.4,4,12,33.3,33,60,55.0,24,36,66.7,11,29,40,26,20,30,10,9,7,2,127,MKS Dąbrowa Górnicza,Sezon 2010/2011
2010-12-15 19:30,MKS Start Lublin(w),62 : 69W,69,21,39,53.8,5,19,26.3,26,58,44.8,12,18,66.7,8,26,34,16,20,18,13,11,5,1,84,MKS Dąbrowa Górnicza,Sezon 2010/2011
2010-12-18 18:00,SKK Siedlce(d),73 : 50W,73,17,37,45.9,9,25,36.0,26,62,41.9,12,16,75.0,13,29,42,15,17,18,11,4,1,2,84,MKS Dąbrowa Górnicza,Sezon 2010/2011
2011-01-15 17:30,PTG Sokół Łańcut(w),75 : 52P,52,19,41,46.3,3,15,20.0,22,56,39.3,5,10,50.0,9,17,26,9,25,17,15,7,1,3,41,MKS Dąbrowa Górnicza,Sezon 2010/2011
2011-01-19 18:00,KS Spójnia Stargard Szczeciński(d),84 : 61W,84,26,45,57.8,7,15,46.7,33,60,55.0,11,16,68.8,10,27,37,23,21,19,9,6,4,1,113,MKS Dąbrowa Górnicza,Sezon 2010/2011
2011-01-22 14:30,Polonia 2011 Warszawa(w),73 : 75W,75,19,42,45.2,7,17,41.2,26,59,44.1,16,26,61.5,7,28,35,17,25,26,16,12,3,3,83,MKS Dąbrowa Górnicza,Sezon 2010/2011
2011-01-29 18:00,ŁKS Sphinx Łódź(d),79 : 77W,79,25,45,55.6,5,14,35.7,30,59,50.8,14,22,63.6,9,20,29,15,18,25,15,9,3,2,83,MKS Dąbrowa Górnicza,Sezon 2010/2011
2011-02-05 19:00,AZS Radex Szczecin(w),74 : 72P,72,22,45,48.9,4,18,22.2,26,63,41.3,16,20,80.0,7,23,30,12,19,19,11,11,3,1,76,MKS Dąbrowa Górnicza,Sezon 2010/2011
2011-02-12 18:00,MKS Znicz Basket Pruszków(d),78 : 64W,78,25,46,54.3,5,17,29.4,30,63,47.6,13,22,59.1,14,24,38,18,19,23,13,4,8,4,91,MKS Dąbrowa Górnicza,Sezon 2010/2011
2011-02-19 18:00,GKS Tychy(w),67 : 83W,83,28,49,57.1,6,15,40.0,34,64,53.1,9,13,69.2,5,28,33,19,26,20,11,6,3,3,99,MKS Dąbrowa Górnicza,Sezon 2010/2011
2011-02-23 18:00,Victoria Górnik Wałbrzych(d),65 : 57W,65,21,40,52.5,5,20,25.0,26,60,43.3,8,13,61.5,8,22,30,21,16,17,15,9,3,3,74,MKS Dąbrowa Górnicza,Sezon 2010/2011
2011-02-26 18:00,Asseco Prokom 2 Gdynia(d),79 : 69W,79,22,41,53.7,7,19,36.8,29,60,48.3,14,20,70.0,7,31,38,16,15,21,12,9,6,1,99,MKS Dąbrowa Górnicza,Sezon 2010/2011
2011-03-05 15:00,AZS Politechnika Warszawska(w),66 : 70W,70,20,42,47.6,8,18,44.4,28,60,46.7,6,11,54.5,4,28,32,17,18,18,16,9,5,4,80,MKS Dąbrowa Górnicza,Sezon 2010/2011
2011-03-12 18:00,Rosa Radom(d),81 : 76W,81,18,32,56.3,11,30,36.7,29,62,46.8,12,21,57.1,8,24,32,22,18,21,12,4,4,0,89,MKS Dąbrowa Górnicza,Sezon 2010/2011
2011-03-16 18:00,Sportino Inowrocław(d),76 : 75W,76,21,31,67.7,6,17,35.3,27,48,56.3,16,27,59.3,6,20,26,16,21,26,17,4,4,2,77,MKS Dąbrowa Górnicza,Sezon 2010/2011
2011-03-19 19:00,KPSW Astoria Bydgoszcz(w),69 : 80W,80,21,35,60.0,6,20,30.0,27,55,49.1,20,27,74.1,10,28,38,17,14,25,16,6,1,0,91,MKS Dąbrowa Górnicza,Sezon 2010/2011
2011-03-23 18:00,MKS Start Lublin(d),88 : 81W,88,25,46,54.3,5,24,20.8,30,70,42.9,23,32,71.9,10,29,39,17,20,26,12,11,2,1,96,MKS Dąbrowa Górnicza,Sezon 2010/2011
2011-03-27 19:00,SKK Siedlce(w),63 : 87W,87,25,46,54.3,9,18,50.0,34,64,53.1,10,15,66.7,9,18,27,25,18,18,9,15,0,7,110,MKS Dąbrowa Górnicza,Sezon 2010/2011
2011-04-03 20:00,Asseco Prokom 2 Gdynia(d),59 : 58W,59,14,33,42.4,8,28,28.6,22,61,36.1,7,8,87.5,12,31,43,17,21,16,19,5,5,1,70,MKS Dąbrowa Górnicza,Sezon 2010/2011
2011-04-06 15:30,Asseco Prokom 2 Gdynia(w),90 : 83P,83,25,42,59.5,4,20,20.0,29,62,46.8,21,27,77.8,11,22,33,17,28,27,16,6,3,4,87,MKS Dąbrowa Górnicza,Sezon 2010/2011
2011-04-09 18:00,Asseco Prokom 2 Gdynia(d),63 : 47W,63,17,34,50.0,6,26,23.1,23,60,38.3,11,22,50.0,14,32,46,12,22,22,11,10,5,3,77,MKS Dąbrowa Górnicza,Sezon 2010/2011
2011-04-17 20:00,ŁKS Sphinx Łódź(d),73 : 62W,73,19,38,50.0,7,24,29.2,26,62,41.9,14,21,66.7,9,28,37,14,26,25,12,5,1,1,75,MKS Dąbrowa Górnicza,Sezon 2010/2011
2011-04-18 18:00,ŁKS Sphinx Łódź(d),89 : 82W,89,21,42,50.0,8,21,38.1,29,63,46.0,23,39,59.0,5,25,30,13,28,33,11,9,3,0,83,MKS Dąbrowa Górnicza,Sezon 2010/2011
2011-04-30 18:00,ŁKS Sphinx Łódź(w),76 : 63P,63,15,34,44.1,5,17,29.4,20,51,39.2,18,24,75.0,9,16,25,9,28,22,10,6,1,6,57,MKS Dąbrowa Górnicza,Sezon 2010/2011
2011-05-01 17:00,ŁKS Sphinx Łódź(w),79 : 53P,53,12,30,40.0,6,26,23.1,18,56,32.1,11,18,61.1,6,21,27,11,23,24,12,10,3,1,47,MKS Dąbrowa Górnicza,Sezon 2010/2011
2011-05-04 18:00,ŁKS Sphinx Łódź(d),63 : 76P,63,16,28,57.1,6,20,30.0,22,48,45.8,13,19,68.4,6,18,24,9,27,22,16,3,2,1,53,MKS Dąbrowa Górnicza,Sezon 2010/2011
2011-05-07 18:00,PTG Sokół Łańcut(w),82 : 69P,69,20,40,50.0,8,19,42.1,28,59,47.5,5,11,45.5,11,19,30,16,25,19,20,9,2,7,69,MKS Dąbrowa Górnicza,Sezon 2010/2011
2011-05-11 18:00,PTG Sokół Łańcut(d),71 : 74P,71,11,26,42.3,12,25,48.0,23,51,45.1,13,20,65.0,5,17,22,18,23,26,16,5,3,3,68,MKS Dąbrowa Górnicza,Sezon 2010/2011
2010-09-25 19:00,Victoria Górnik Wałbrzych(d),75 : 74W,75,20,42,47.6,8,20,40.0,28,62,45.2,11,17,64.7,10,26,36,15,17,22,19,13,3,3,83,MKS Start Lublin,Sezon 2010/2011
2010-10-02 13:00,AZS Politechnika Warszawska(w),76 : 67P,67,16,38,42.1,5,17,29.4,21,55,38.2,20,27,74.1,9,25,34,9,24,7,17,9,1,0,62,MKS Start Lublin,Sezon 2010/2011
2010-10-06 19:00,Rosa Radom(d),51 : 59P,51,12,39,30.8,3,23,13.0,15,62,24.2,18,23,78.3,9,25,34,6,22,22,12,7,0,5,34,MKS Start Lublin,Sezon 2010/2011
2010-10-10 18:00,KPSW Astoria Bydgoszcz(w),66 : 67W,67,13,36,36.1,9,23,39.1,22,59,37.3,14,28,50.0,10,30,40,15,21,22,11,7,2,2,69,MKS Start Lublin,Sezon 2010/2011
2010-10-16 19:00,MKS Znicz Basket Pruszków(d),79 : 88P,79,21,38,55.3,6,18,33.3,27,56,48.2,19,29,65.5,3,26,29,13,25,21,19,14,3,1,80,MKS Start Lublin,Sezon 2010/2011
2010-10-23 19:00,SKK Siedlce(d),61 : 63P,61,15,35,42.9,8,28,28.6,23,63,36.5,7,11,63.6,7,25,32,14,17,20,14,5,8,2,62,MKS Start Lublin,Sezon 2010/2011
2010-10-27 15:30,Asseco Prokom 2 Gdynia(w),107 : 53P,53,15,40,37.5,2,19,10.5,17,59,28.8,17,24,70.8,6,16,22,9,17,24,19,8,1,8,25,MKS Start Lublin,Sezon 2010/2011
2010-11-06 19:00,PTG Sokół Łańcut(d),70 : 67W,70,16,41,39.0,6,15,40.0,22,56,39.3,20,26,76.9,9,23,32,11,18,24,14,6,0,1,65,MKS Start Lublin,Sezon 2010/2011
2010-11-13 17:00,KS Spójnia Stargard Szczeciński(w),66 : 56P,56,19,42,45.2,1,13,7.7,20,55,36.4,15,21,71.4,5,23,28,14,15,18,17,10,2,4,52,MKS Start Lublin,Sezon 2010/2011
2010-11-21 17:00,Polonia 2011 Warszawa(w),90 : 82P,82,21,46,45.7,10,24,41.7,31,70,44.3,10,13,76.9,9,24,33,14,23,17,15,9,0,4,81,MKS Start Lublin,Sezon 2010/2011
2010-11-28 17:00,ŁKS Sphinx Łódź(w),75 : 59P,59,12,29,41.4,6,17,35.3,18,46,39.1,17,24,70.8,5,25,30,7,17,21,19,6,4,2,52,MKS Start Lublin,Sezon 2010/2011
2010-12-04 17:00,AZS Radex Szczecin(d),69 : 67W,69,17,39,43.6,2,16,12.5,19,55,34.5,29,36,80.6,9,25,34,11,22,23,13,11,4,4,73,MKS Start Lublin,Sezon 2010/2011
2010-12-11 18:00,Sportino Inowrocław(w),82 : 68P,68,21,38,55.3,6,23,26.1,27,61,44.3,8,13,61.5,8,26,34,16,15,18,16,7,2,4,72,MKS Start Lublin,Sezon 2010/2011
2010-12-15 19:30,MKS Dąbrowa Górnicza(d),62 : 69P,62,17,42,40.5,6,16,37.5,23,58,39.7,10,15,66.7,7,21,28,10,18,20,17,9,1,5,53,MKS Start Lublin,Sezon 2010/2011
2010-12-18 18:00,GKS Tychy(w),80 : 71P,71,17,31,54.8,11,29,37.9,28,60,46.7,4,4,100.0,5,19,24,15,19,12,16,2,1,2,65,MKS Start Lublin,Sezon 2010/2011
2011-01-15 18:00,AZS Politechnika Warszawska(d),63 : 92P,63,20,33,60.6,3,17,17.6,23,50,46.0,14,23,60.9,5,15,20,12,17,18,16,5,1,1,49,MKS Start Lublin,Sezon 2010/2011
2011-01-19 18:00,Rosa Radom(w),73 : 66P,66,19,37,51.4,7,25,28.0,26,62,41.9,7,9,77.8,6,21,27,16,13,14,6,5,1,3,71,MKS Start Lublin,Sezon 2010/2011
2011-01-22 19:00,KPSW Astoria Bydgoszcz(d),72 : 63W,72,21,45,46.7,6,16,37.5,27,61,44.3,12,12,100.0,14,25,39,15,19,18,20,10,6,2,88,MKS Start Lublin,Sezon 2010/2011
2011-01-29 18:00,MKS Znicz Basket Pruszków(w),52 : 69W,69,16,31,51.6,5,18,27.8,21,49,42.9,22,25,88.0,6,30,36,10,15,24,15,9,3,2,81,MKS Start Lublin,Sezon 2010/2011
2011-02-06 18:00,SKK Siedlce(w),82 : 58P,58,11,28,39.3,4,20,20.0,15,48,31.3,24,28,85.7,8,19,27,7,15,19,14,7,0,3,48,MKS Start Lublin,Sezon 2010/2011
2011-02-09 19:30,Asseco Prokom 2 Gdynia(d),77 : 66W,77,20,44,45.5,8,20,40.0,28,64,43.8,13,14,92.9,6,24,30,16,17,17,11,10,3,4,88,MKS Start Lublin,Sezon 2010/2011
2011-02-12 17:30,PTG Sokół Łańcut(w),71 : 72W,72,11,26,42.3,6,17,35.3,17,43,39.5,32,48,66.7,8,28,36,12,26,34,18,11,0,4,71,MKS Start Lublin,Sezon 2010/2011
2011-02-19 19:00,KS Spójnia Stargard Szczeciński(d),43 : 66P,43,7,29,24.1,6,23,26.1,13,52,25.0,11,18,61.1,8,16,24,9,19,16,14,5,1,2,22,MKS Start Lublin,Sezon 2010/2011
2011-02-26 17:00,Victoria Górnik Wałbrzych(w),61 : 57P,57,12,35,34.3,5,17,29.4,17,52,32.7,18,26,69.2,5,26,31,9,22,21,16,14,1,3,53,MKS Start Lublin,Sezon 2010/2011
2011-03-02 19:30,Polonia 2011 Warszawa(d),90 : 82W,90,28,50,56.0,6,19,31.6,34,69,49.3,16,21,76.2,15,26,41,14,14,21,20,12,5,2,102,MKS Start Lublin,Sezon 2010/2011
2011-03-05 19:00,ŁKS Sphinx Łódź(d),55 : 69P,55,16,40,40.0,3,17,17.6,19,57,33.3,14,21,66.7,10,22,32,7,15,21,7,8,2,2,52,MKS Start Lublin,Sezon 2010/2011
2011-03-13 19:00,AZS Radex Szczecin(w),83 : 62P,62,19,38,50.0,2,22,9.1,21,60,35.0,18,21,85.7,11,21,32,6,19,15,14,12,3,1,59,MKS Start Lublin,Sezon 2010/2011
2011-03-19 19:00,Sportino Inowrocław(d),61 : 69P,61,20,43,46.5,3,14,21.4,23,57,40.4,12,14,85.7,10,23,33,13,25,22,15,4,1,2,61,MKS Start Lublin,Sezon 2010/2011
2011-03-23 18:00,MKS Dąbrowa Górnicza(w),88 : 81P,81,23,40,57.5,7,22,31.8,30,62,48.4,14,21,66.7,5,28,33,17,27,20,16,4,1,2,81,MKS Start Lublin,Sezon 2010/2011
2011-03-26 19:00,GKS Tychy(d),87 : 73W,87,20,39,51.3,11,21,52.4,31,60,51.7,14,16,87.5,6,23,29,18,17,17,11,9,2,1,103,MKS Start Lublin,Sezon 2010/2011
2011-04-02 19:00,KPSW Astoria Bydgoszcz(d),73 : 63W,73,11,30,36.7,11,22,50.0,22,52,42.3,18,24,75.0,7,26,33,14,15,24,15,9,2,3,80,MKS Start Lublin,Sezon 2010/2011
2011-04-03 18:00,KPSW Astoria Bydgoszcz(d),72 : 56W,72,13,31,41.9,8,21,38.1,21,52,40.4,22,30,73.3,8,31,39,11,24,28,16,5,3,2,75,MKS Start Lublin,Sezon 2010/2011
2011-04-09 19:00,KPSW Astoria Bydgoszcz(w),92 : 71P,71,18,30,60.0,7,23,30.4,25,53,47.2,14,18,77.8,5,21,26,12,26,19,12,2,3,0,70,MKS Start Lublin,Sezon 2010/2011
2011-04-10 19:00,KPSW Astoria Bydgoszcz(w),79 : 71P,71,17,36,47.2,8,22,36.4,25,58,43.1,13,20,65.0,6,15,21,10,23,19,13,7,1,2,57,MKS Start Lublin,Sezon 2010/2011
2011-04-17 18:00,KPSW Astoria Bydgoszcz(d),68 : 60W,68,16,32,50.0,5,18,27.8,21,50,42.0,21,38,55.3,6,24,30,11,25,32,8,7,3,2,65,MKS Start Lublin,Sezon 2010/2011
2010-09-26 19:00,Rosa Radom(w),98 : 55P,55,11,23,47.8,7,26,26.9,18,49,36.7,12,20,60.0,10,12,22,8,25,22,11,8,2,0,45,MKS Znicz Basket Pruszków,Sezon 2010/2011
2010-10-02 16:00,ŁKS Sphinx Łódź(d),75 : 65W,75,15,32,46.9,12,17,70.6,27,49,55.1,9,13,69.2,9,20,29,16,24,22,24,13,1,3,84,MKS Znicz Basket Pruszków,Sezon 2010/2011
2010-10-06 19:00,KPSW Astoria Bydgoszcz(w),62 : 69W,69,21,44,47.7,2,13,15.4,23,57,40.4,21,27,77.8,7,24,31,8,17,26,14,16,3,3,73,MKS Znicz Basket Pruszków,Sezon 2010/2011
2010-10-10 19:00,AZS Radex Szczecin(d),70 : 62W,70,21,41,51.2,4,16,25.0,25,57,43.9,16,19,84.2,7,25,32,13,15,19,12,10,7,4,85,MKS Znicz Basket Pruszków,Sezon 2010/2011
2010-10-16 19:00,MKS Start Lublin(w),79 : 88W,88,19,36,52.8,10,27,37.0,29,63,46.0,20,28,71.4,9,25,34,20,21,25,17,10,1,3,94,MKS Znicz Basket Pruszków,Sezon 2010/2011
2010-10-24 18:00,Sportino Inowrocław(d),69 : 76P,69,22,42,52.4,6,21,28.6,28,63,44.4,7,11,63.6,10,21,31,14,25,18,22,9,5,1,67,MKS Znicz Basket Pruszków,Sezon 2010/2011
2010-10-27 20:00,SKK Siedlce(w),69 : 52P,52,13,31,41.9,4,21,19.0,17,52,32.7,14,15,93.3,8,14,22,10,15,15,21,11,1,5,39,MKS Znicz Basket Pruszków,Sezon 2010/2011
2010-11-07 18:00,MKS Dąbrowa Górnicza(d),73 : 83P,73,17,37,45.9,7,17,41.2,24,54,44.4,18,25,72.0,6,17,23,19,18,22,17,14,1,3,76,MKS Znicz Basket Pruszków,Sezon 2010/2011
2010-11-13 16:00,Asseco Prokom 2 Gdynia(w),84 : 77P,77,23,42,54.8,7,29,24.1,30,71,42.3,10,19,52.6,9,24,33,14,22,25,15,6,4,1,69,MKS Znicz Basket Pruszków,Sezon 2010/2011
2010-11-28 19:00,PTG Sokół Łańcut(d),51 : 61P,51,17,31,54.8,4,22,18.2,21,53,39.6,5,10,50.0,6,20,26,14,18,16,17,12,4,2,53,MKS Znicz Basket Pruszków,Sezon 2010/2011
2010-12-04 18:00,Victoria Górnik Wałbrzych(d),69 : 47W,69,20,38,52.6,3,13,23.1,23,51,45.1,20,29,69.0,8,41,49,11,14,25,17,10,10,0,95,MKS Znicz Basket Pruszków,Sezon 2010/2011
2010-12-12 16:00,KS Spójnia Stargard Szczeciński(w),63 : 57P,57,18,38,47.4,3,16,18.8,21,54,38.9,12,17,70.6,6,19,25,12,17,23,18,18,1,7,57,MKS Znicz Basket Pruszków,Sezon 2010/2011
2010-12-15 18:00,AZS Politechnika Warszawska(d),91 : 88W,91,24,53,45.3,6,22,27.3,30,75,40.0,25,33,75.8,6,26,32,12,26,27,8,12,2,5,88,MKS Znicz Basket Pruszków,Sezon 2010/2011
2010-12-19 18:30,Polonia 2011 Warszawa(w),86 : 94W,94,29,48,60.4,5,17,29.4,34,65,52.3,21,28,75.0,13,24,37,24,19,24,15,9,2,2,113,MKS Znicz Basket Pruszków,Sezon 2010/2011
2011-01-15 18:00,ŁKS Sphinx Łódź(w),84 : 65P,65,17,40,42.5,6,16,37.5,23,56,41.1,13,19,68.4,12,24,36,14,19,21,19,6,3,2,66,MKS Znicz Basket Pruszków,Sezon 2010/2011
2011-01-19 18:00,KPSW Astoria Bydgoszcz(d),80 : 78W,80,17,41,41.5,7,18,38.9,24,59,40.7,25,39,64.1,12,25,37,17,29,31,12,7,2,0,82,MKS Znicz Basket Pruszków,Sezon 2010/2011
2011-01-22 19:00,AZS Radex Szczecin(w),87 : 86P,86,33,56,58.9,4,11,36.4,37,67,55.2,8,17,47.1,7,18,25,14,25,21,12,14,3,6,91,MKS Znicz Basket Pruszków,Sezon 2010/2011
2011-01-29 18:00,MKS Start Lublin(d),52 : 69P,52,14,44,31.8,5,23,21.7,19,67,28.4,9,11,81.8,13,21,34,13,25,15,13,11,2,3,49,MKS Znicz Basket Pruszków,Sezon 2010/2011
2011-02-05 18:00,Sportino Inowrocław(w),73 : 71P,71,23,51,45.1,4,15,26.7,27,66,40.9,13,23,56.5,8,27,35,13,24,25,14,14,2,3,72,MKS Znicz Basket Pruszków,Sezon 2010/2011
2011-02-09 18:00,SKK Siedlce(d),81 : 62W,81,25,43,58.1,6,19,31.6,31,62,50.0,13,20,65.0,10,26,36,19,18,17,15,9,4,2,96,MKS Znicz Basket Pruszków,Sezon 2010/2011
2011-02-12 18:00,MKS Dąbrowa Górnicza(w),78 : 64P,64,23,53,43.4,3,10,30.0,26,63,41.3,9,12,75.0,12,16,28,14,23,19,14,7,4,8,63,MKS Znicz Basket Pruszków,Sezon 2010/2011
2011-02-20 18:00,Asseco Prokom 2 Gdynia(d),75 : 46W,75,23,41,56.1,6,15,40.0,29,56,51.8,11,15,73.3,4,23,27,21,22,17,13,16,1,1,96,MKS Znicz Basket Pruszków,Sezon 2010/2011
2011-02-23 18:00,GKS Tychy(d),83 : 60W,83,29,47,61.7,4,13,30.8,33,60,55.0,13,20,65.0,4,22,26,14,22,20,11,7,2,1,87,MKS Znicz Basket Pruszków,Sezon 2010/2011
2011-02-27 18:00,Rosa Radom(d),71 : 76P,71,14,31,45.2,8,25,32.0,22,56,39.3,19,22,86.4,7,19,26,15,20,21,14,11,2,1,74,MKS Znicz Basket Pruszków,Sezon 2010/2011
2011-03-02 18:00,PTG Sokół Łańcut(w),72 : 88W,88,25,41,61.0,7,15,46.7,32,56,57.1,17,21,81.0,7,21,28,22,29,19,18,10,3,2,105,MKS Znicz Basket Pruszków,Sezon 2010/2011
2011-03-09 19:00,KS Spójnia Stargard Szczeciński(d),52 : 76P,52,11,35,31.4,3,18,16.7,14,53,26.4,21,31,67.7,6,20,26,12,26,28,19,8,4,3,34,MKS Znicz Basket Pruszków,Sezon 2010/2011
2011-03-12 16:30,Victoria Górnik Wałbrzych(w),71 : 117W,117,32,59,54.2,13,24,54.2,45,83,54.2,14,20,70.0,15,31,46,21,20,20,12,16,4,9,148,MKS Znicz Basket Pruszków,Sezon 2010/2011
2011-03-23 17:00,AZS Politechnika Warszawska(w),80 : 69P,69,20,43,46.5,7,20,35.0,27,63,42.9,8,14,57.1,14,22,36,19,28,20,21,12,1,3,74,MKS Znicz Basket Pruszków,Sezon 2010/2011
2011-03-26 18:00,Polonia 2011 Warszawa(d),63 : 65P,63,23,44,52.3,3,19,15.8,26,63,41.3,8,16,50.0,16,29,45,14,19,21,16,8,4,2,73,MKS Znicz Basket Pruszków,Sezon 2010/2011
2010-09-26 16:00,ŁKS Sphinx Łódź(d),56 : 87P,56,20,37,54.1,4,15,26.7,24,52,46.2,4,7,57.1,6,17,23,9,24,18,17,5,2,0,47,Polonia 2011 Warszawa,Sezon 2010/2011
2010-10-02 18:00,AZS Radex Szczecin(w),107 : 108W,108,34,62,54.8,8,26,30.8,42,88,47.7,16,26,61.5,10,27,37,12,24,21,13,20,6,7,114,Polonia 2011 Warszawa,Sezon 2010/2011
2010-10-06 15:00,Sportino Inowrocław(d),60 : 77P,60,20,46,43.5,4,19,21.1,24,65,36.9,8,14,57.1,9,21,30,14,18,17,14,7,4,4,54,Polonia 2011 Warszawa,Sezon 2010/2011
2010-10-09 18:00,MKS Dąbrowa Górnicza(w),91 : 57P,57,18,44,40.9,4,14,28.6,22,58,37.9,9,14,64.3,5,24,29,7,18,18,22,8,3,5,41,Polonia 2011 Warszawa,Sezon 2010/2011
2010-10-16 15:00,GKS Tychy(d),35 : 80P,35,10,40,25.0,2,16,12.5,12,56,21.4,9,12,75.0,4,18,22,7,14,19,22,13,2,0,10,Polonia 2011 Warszawa,Sezon 2010/2011
2010-10-24 17:00,Victoria Górnik Wałbrzych(w),78 : 70P,70,23,41,56.1,3,18,16.7,26,59,44.1,15,26,57.7,11,18,29,13,29,21,18,14,1,2,65,Polonia 2011 Warszawa,Sezon 2010/2011
2010-10-27 17:30,AZS Politechnika Warszawska(d),79 : 85P,79,21,45,46.7,7,23,30.4,28,68,41.2,16,28,57.1,11,20,31,17,28,23,15,9,3,2,72,Polonia 2011 Warszawa,Sezon 2010/2011
2010-11-06 16:00,Rosa Radom(w),85 : 65P,65,17,37,45.9,7,17,41.2,24,54,44.4,10,20,50.0,3,16,19,11,22,20,14,12,4,3,57,Polonia 2011 Warszawa,Sezon 2010/2011
2010-11-14 17:00,KPSW Astoria Bydgoszcz(d),82 : 76W,82,24,41,58.5,5,15,33.3,29,56,51.8,19,28,67.9,7,23,30,12,30,26,21,12,3,1,82,Polonia 2011 Warszawa,Sezon 2010/2011
2010-11-21 17:00,MKS Start Lublin(d),90 : 82W,90,15,36,41.7,12,27,44.4,27,63,42.9,24,27,88.9,10,24,34,15,17,22,17,6,4,0,93,Polonia 2011 Warszawa,Sezon 2010/2011
2010-11-27 18:00,SKK Siedlce(d),73 : 82P,73,18,40,45.0,8,25,32.0,26,65,40.0,13,17,76.5,9,15,24,15,21,17,15,16,1,5,71,Polonia 2011 Warszawa,Sezon 2010/2011
2010-12-04 16:00,Asseco Prokom 2 Gdynia(w),78 : 71P,71,23,44,52.3,3,21,14.3,26,65,40.0,16,21,76.2,8,22,30,14,15,17,14,13,1,1,71,Polonia 2011 Warszawa,Sezon 2010/2011
2010-12-11 15:00,PTG Sokół Łańcut(d),54 : 68P,54,15,38,39.5,6,21,28.6,21,59,35.6,6,8,75.0,6,25,31,15,23,12,22,9,1,5,48,Polonia 2011 Warszawa,Sezon 2010/2011
2010-12-15 18:00,KS Spójnia Stargard Szczeciński(w),90 : 59P,59,11,34,32.4,7,22,31.8,18,56,32.1,16,22,72.7,9,23,32,12,23,19,23,7,2,5,45,Polonia 2011 Warszawa,Sezon 2010/2011
2010-12-19 18:30,MKS Znicz Basket Pruszków(d),86 : 94P,86,23,42,54.8,8,24,33.3,31,66,47.0,16,18,88.9,6,22,28,17,24,19,13,10,2,2,93,Polonia 2011 Warszawa,Sezon 2010/2011
2011-01-16 18:00,AZS Radex Szczecin(d),84 : 76W,84,20,36,55.6,7,18,38.9,27,54,50.0,23,30,76.7,8,19,27,12,21,25,21,19,1,1,88,Polonia 2011 Warszawa,Sezon 2010/2011
2011-01-19 18:00,Sportino Inowrocław(w),97 : 75P,75,19,34,55.9,7,21,33.3,26,55,47.3,16,24,66.7,8,22,30,16,17,21,21,8,3,1,74,Polonia 2011 Warszawa,Sezon 2010/2011
2011-01-22 14:30,MKS Dąbrowa Górnicza(d),73 : 75P,73,16,31,51.6,7,20,35.0,23,51,45.1,20,28,71.4,3,21,24,10,26,24,19,12,3,3,67,Polonia 2011 Warszawa,Sezon 2010/2011
2011-01-29 18:00,GKS Tychy(w),75 : 66P,66,16,37,43.2,9,19,47.4,25,56,44.6,7,10,70.0,5,25,30,14,26,14,28,13,4,10,65,Polonia 2011 Warszawa,Sezon 2010/2011
2011-02-05 15:00,Victoria Górnik Wałbrzych(d),90 : 65W,90,20,39,51.3,12,27,44.4,32,66,48.5,14,20,70.0,13,23,36,19,23,17,19,12,6,1,104,Polonia 2011 Warszawa,Sezon 2010/2011
2011-02-09 18:00,AZS Politechnika Warszawska(w),86 : 66P,66,20,38,52.6,3,15,20.0,23,53,43.4,17,23,73.9,3,16,19,8,21,19,27,12,2,3,44,Polonia 2011 Warszawa,Sezon 2010/2011
2011-02-13 16:00,Rosa Radom(d),51 : 69P,51,14,38,36.8,6,27,22.2,20,65,30.8,5,9,55.6,10,22,32,10,17,11,19,10,0,2,35,Polonia 2011 Warszawa,Sezon 2010/2011
2011-02-19 18:00,KPSW Astoria Bydgoszcz(w),88 : 84P,84,21,40,52.5,8,19,42.1,29,59,49.2,18,28,64.3,8,15,23,17,23,25,18,10,6,6,82,Polonia 2011 Warszawa,Sezon 2010/2011
2011-02-26 17:30,ŁKS Sphinx Łódź(w),78 : 56P,56,10,39,25.6,9,28,32.1,19,67,28.4,9,13,69.2,8,19,27,8,20,18,19,14,0,3,34,Polonia 2011 Warszawa,Sezon 2010/2011
2011-03-02 19:30,MKS Start Lublin(w),90 : 82P,82,16,37,43.2,14,33,42.4,30,70,42.9,8,17,47.1,10,17,27,16,21,13,19,9,2,5,68,Polonia 2011 Warszawa,Sezon 2010/2011
2011-03-06 18:00,SKK Siedlce(w),73 : 64P,64,13,28,46.4,6,26,23.1,19,54,35.2,20,26,76.9,10,13,23,7,14,23,15,11,0,2,49,Polonia 2011 Warszawa,Sezon 2010/2011
2011-03-13 16:00,Asseco Prokom 2 Gdynia(d),83 : 88P,83,15,34,44.1,13,33,39.4,28,67,41.8,14,17,82.4,8,19,27,13,23,17,11,5,3,2,78,Polonia 2011 Warszawa,Sezon 2010/2011
2011-03-19 17:30,PTG Sokół Łańcut(w),70 : 57P,57,13,35,37.1,7,26,26.9,20,61,32.8,10,12,83.3,6,19,25,10,20,12,21,6,2,5,36,Polonia 2011 Warszawa,Sezon 2010/2011
2011-03-23 14:30,KS Spójnia Stargard Szczeciński(d),55 : 79P,55,16,47,34.0,5,20,25.0,21,67,31.3,8,9,88.9,10,20,30,11,18,15,14,7,2,5,44,Polonia 2011 Warszawa,Sezon 2010/2011
2011-03-26 18:00,MKS Znicz Basket Pruszków(w),63 : 65W,65,16,43,37.2,7,20,35.0,23,63,36.5,12,16,75.0,6,20,26,11,21,19,12,8,2,4,56,Polonia 2011 Warszawa,Sezon 2010/2011
2011-04-02 19:00,SKK Siedlce(w),72 : 74W,74,23,48,47.9,6,16,37.5,29,64,45.3,10,12,83.3,6,12,18,10,17,18,13,27,0,7,79,Polonia 2011 Warszawa,Sezon 2010/2011
2011-04-03 19:00,SKK Siedlce(w),79 : 55P,55,14,39,35.9,6,24,25.0,20,63,31.7,9,12,75.0,10,20,30,9,22,18,20,12,1,5,41,Polonia 2011 Warszawa,Sezon 2010/2011
2011-04-09 15:00,SKK Siedlce(d),86 : 75W,86,20,39,51.3,6,15,40.0,26,54,48.1,28,38,73.7,4,22,26,13,22,26,10,13,0,3,90,Polonia 2011 Warszawa,Sezon 2010/2011
2011-04-10 18:30,SKK Siedlce(d),67 : 70P,67,12,32,37.5,7,21,33.3,19,53,35.8,22,28,78.6,8,19,27,9,21,22,12,12,1,1,64,Polonia 2011 Warszawa,Sezon 2010/2011
2011-04-16 19:00,SKK Siedlce(w),57 : 54P,54,14,28,50.0,5,18,27.8,19,46,41.3,11,13,84.6,4,24,28,12,16,20,14,8,2,0,61,Polonia 2011 Warszawa,Sezon 2010/2011
2010-09-25 17:30,Sportino Inowrocław(d),69 : 64W,69,18,35,51.4,6,21,28.6,24,56,42.9,15,19,78.9,10,26,36,21,20,21,12,10,3,0,91,PTG Sokół Łańcut,Sezon 2010/2011
2010-10-03 18:00,MKS Dąbrowa Górnicza(w),58 : 76W,76,10,30,33.3,10,22,45.5,20,52,38.5,26,32,81.3,15,21,36,5,22,27,17,8,1,5,71,PTG Sokół Łańcut,Sezon 2010/2011
2010-10-06 18:00,GKS Tychy(d),70 : 59W,70,15,32,46.9,6,20,30.0,21,52,40.4,22,30,73.3,5,23,28,15,19,25,11,17,1,3,81,PTG Sokół Łańcut,Sezon 2010/2011
2010-10-10 17:00,Victoria Górnik Wałbrzych(w),68 : 75W,75,23,35,65.7,3,17,17.6,26,52,50.0,20,32,62.5,10,26,36,12,19,26,10,7,4,2,86,PTG Sokół Łańcut,Sezon 2010/2011
2010-10-16 17:30,AZS Politechnika Warszawska(d),75 : 78P,75,18,34,52.9,7,22,31.8,25,56,44.6,18,27,66.7,11,19,30,13,23,28,13,14,2,1,81,PTG Sokół Łańcut,Sezon 2010/2011
2010-10-24 18:00,Rosa Radom(w),62 : 74W,74,16,32,50.0,9,22,40.9,25,54,46.3,15,17,88.2,7,22,29,12,20,19,11,10,1,2,84,PTG Sokół Łańcut,Sezon 2010/2011
2010-10-27 18:00,KPSW Astoria Bydgoszcz(d),94 : 65W,94,17,29,58.6,11,23,47.8,28,52,53.8,27,33,81.8,4,27,31,20,24,30,16,16,2,2,117,PTG Sokół Łańcut,Sezon 2010/2011
2010-11-06 19:00,MKS Start Lublin(w),70 : 67P,67,17,31,54.8,6,24,25.0,23,55,41.8,15,19,78.9,8,24,32,8,24,18,10,11,1,0,73,PTG Sokół Łańcut,Sezon 2010/2011
2010-11-13 17:30,SKK Siedlce(d),80 : 71W,80,14,34,41.2,8,27,29.6,22,61,36.1,28,34,82.4,12,25,37,11,17,26,13,16,3,1,89,PTG Sokół Łańcut,Sezon 2010/2011
2010-11-20 16:00,Asseco Prokom 2 Gdynia(w),66 : 70W,70,12,44,27.3,11,33,33.3,23,77,29.9,13,16,81.3,19,18,37,10,15,18,7,11,1,5,65,PTG Sokół Łańcut,Sezon 2010/2011
2010-11-28 19:00,MKS Znicz Basket Pruszków(w),51 : 61W,61,11,34,32.4,9,17,52.9,20,51,39.2,12,17,70.6,8,23,31,7,16,18,16,11,2,4,60,PTG Sokół Łańcut,Sezon 2010/2011
2010-12-04 17:30,KS Spójnia Stargard Szczeciński(d),49 : 51P,49,12,27,44.4,4,25,16.0,16,52,30.8,13,17,76.5,9,25,34,11,18,20,15,10,2,1,51,PTG Sokół Łańcut,Sezon 2010/2011
2010-12-11 15:00,Polonia 2011 Warszawa(w),54 : 68W,68,24,44,54.5,2,20,10.0,26,64,40.6,14,21,66.7,9,30,39,8,12,23,14,14,5,1,75,PTG Sokół Łańcut,Sezon 2010/2011
2010-12-15 18:00,ŁKS Sphinx Łódź(d),70 : 76P,70,15,30,50.0,7,25,28.0,22,55,40.0,19,22,86.4,8,16,24,8,18,22,8,11,1,0,70,PTG Sokół Łańcut,Sezon 2010/2011
2010-12-18 18:00,AZS Radex Szczecin(w),71 : 77W,77,17,30,56.7,10,30,33.3,27,60,45.0,13,20,65.0,8,24,32,10,15,20,14,12,2,5,79,PTG Sokół Łańcut,Sezon 2010/2011
2011-01-15 17:30,MKS Dąbrowa Górnicza(d),75 : 52W,75,20,36,55.6,5,22,22.7,25,58,43.1,20,27,74.1,15,27,42,9,17,25,10,13,3,1,92,PTG Sokół Łańcut,Sezon 2010/2011
2011-01-18 18:00,GKS Tychy(w),68 : 76W,76,22,36,61.1,4,22,18.2,26,58,44.8,20,30,66.7,10,21,31,18,23,24,15,13,4,4,85,PTG Sokół Łańcut,Sezon 2010/2011
2011-01-22 17:30,Victoria Górnik Wałbrzych(d),87 : 55W,87,24,37,64.9,9,25,36.0,33,62,53.2,12,17,70.6,12,20,32,15,11,15,11,12,5,2,106,PTG Sokół Łańcut,Sezon 2010/2011
2011-01-29 15:00,AZS Politechnika Warszawska(w),80 : 76P,76,23,43,53.5,5,25,20.0,28,68,41.2,15,17,88.2,14,26,40,12,22,20,18,9,2,5,79,PTG Sokół Łańcut,Sezon 2010/2011
2011-02-05 17:30,Rosa Radom(d),66 : 54W,66,13,27,48.1,9,29,31.0,22,56,39.3,13,21,61.9,9,23,32,14,22,25,15,17,3,4,75,PTG Sokół Łańcut,Sezon 2010/2011
2011-02-09 18:30,KPSW Astoria Bydgoszcz(w),52 : 71W,71,21,40,52.5,7,16,43.8,28,56,50.0,8,15,53.3,10,25,35,16,27,18,21,10,2,1,78,PTG Sokół Łańcut,Sezon 2010/2011
2011-02-12 17:30,MKS Start Lublin(d),71 : 72P,71,19,46,41.3,4,27,14.8,23,73,31.5,21,27,77.8,15,22,37,7,36,26,14,15,4,0,64,PTG Sokół Łańcut,Sezon 2010/2011
2011-02-19 18:00,SKK Siedlce(w),63 : 62P,62,12,34,35.3,8,28,28.6,20,62,32.3,14,21,66.7,11,19,30,16,17,24,11,14,2,2,64,PTG Sokół Łańcut,Sezon 2010/2011
2011-02-23 18:00,Asseco Prokom 2 Gdynia(d),73 : 59W,73,16,34,47.1,7,20,35.0,23,54,42.6,20,23,87.0,8,21,29,12,24,23,13,8,0,1,75,PTG Sokół Łańcut,Sezon 2010/2011
2011-02-26 18:00,Sportino Inowrocław(w),66 : 82W,82,12,36,33.3,13,31,41.9,25,67,37.3,19,25,76.0,14,31,45,12,19,24,11,7,3,6,90,PTG Sokół Łańcut,Sezon 2010/2011
2011-03-02 18:00,MKS Znicz Basket Pruszków(d),72 : 88P,72,19,39,48.7,3,14,21.4,22,53,41.5,25,35,71.4,7,14,21,8,20,29,13,16,2,3,65,PTG Sokół Łańcut,Sezon 2010/2011
2011-03-13 17:00,KS Spójnia Stargard Szczeciński(w),68 : 74W,74,16,38,42.1,7,22,31.8,23,60,38.3,21,28,75.0,19,17,36,13,22,28,20,15,2,8,76,PTG Sokół Łańcut,Sezon 2010/2011
2011-03-19 17:30,Polonia 2011 Warszawa(d),70 : 57W,70,22,40,55.0,3,20,15.0,25,60,41.7,17,25,68.0,13,28,41,15,13,20,17,19,5,2,90,PTG Sokół Łańcut,Sezon 2010/2011
2011-03-23 19:00,ŁKS Sphinx Łódź(w),73 : 54P,54,16,38,42.1,3,18,16.7,19,56,33.9,13,22,59.1,10,17,27,4,26,26,16,11,1,1,35,PTG Sokół Łańcut,Sezon 2010/2011
2011-03-26 16:00,AZS Radex Szczecin(d),79 : 74W,79,21,42,50.0,5,29,17.2,26,71,36.6,22,32,68.8,17,23,40,12,20,25,12,11,1,2,76,PTG Sokół Łańcut,Sezon 2010/2011
2011-04-02 17:30,Sportino Inowrocław(d),70 : 48W,70,23,32,71.9,4,27,14.8,27,59,45.8,12,19,63.2,8,24,32,12,26,20,14,17,1,1,79,PTG Sokół Łańcut,Sezon 2010/2011
2011-04-06 18:00,Sportino Inowrocław(w),74 : 67P,67,18,30,60.0,4,28,14.3,22,58,37.9,19,25,76.0,8,18,26,9,26,25,13,14,1,1,62,PTG Sokół Łańcut,Sezon 2010/2011
2011-04-09 17:30,Sportino Inowrocław(d),81 : 57W,81,18,31,58.1,10,23,43.5,28,54,51.9,15,21,71.4,9,22,31,14,27,27,12,16,0,2,98,PTG Sokół Łańcut,Sezon 2010/2011
2011-04-16 15:00,AZS Politechnika Warszawska(w),71 : 64P,64,17,35,48.6,3,22,13.6,20,57,35.1,21,27,77.8,19,20,39,8,19,28,15,8,0,2,61,PTG Sokół Łańcut,Sezon 2010/2011
2011-04-17 15:00,AZS Politechnika Warszawska(w),74 : 65P,65,16,36,44.4,4,23,17.4,20,59,33.9,21,30,70.0,9,17,26,11,29,24,10,10,1,2,55,PTG Sokół Łańcut,Sezon 2010/2011
2011-05-01 18:00,AZS Politechnika Warszawska(d),64 : 90P,64,17,34,50.0,4,26,15.4,21,60,35.0,18,27,66.7,19,19,38,11,21,23,14,9,4,3,64,PTG Sokół Łańcut,Sezon 2010/2011
2011-05-07 18:00,MKS Dąbrowa Górnicza(d),82 : 69W,82,23,41,56.1,6,14,42.9,29,55,52.7,18,31,58.1,11,20,31,13,19,24,14,17,7,2,97,PTG Sokół Łańcut,Sezon 2010/2011
2011-05-11 18:00,MKS Dąbrowa Górnicza(w),71 : 74W,74,17,35,48.6,7,18,38.9,24,53,45.3,19,26,73.1,6,24,30,15,26,23,13,8,3,3,81,PTG Sokół Łańcut,Sezon 2010/2011
2010-09-26 19:00,MKS Znicz Basket Pruszków(d),98 : 55W,98,23,32,71.9,8,17,47.1,31,49,63.3,28,34,82.4,7,21,28,16,21,30,14,9,5,0,118,Rosa Radom,Sezon 2010/2011
2010-10-02 19:00,KPSW Astoria Bydgoszcz(d),80 : 71W,80,21,40,52.5,5,13,38.5,26,53,49.1,23,30,76.7,9,26,35,12,22,25,10,3,4,0,90,Rosa Radom,Sezon 2010/2011
2010-10-06 19:00,MKS Start Lublin(w),51 : 59W,59,19,40,47.5,2,19,10.5,21,59,35.6,15,20,75.0,7,30,37,6,22,22,12,9,5,0,61,Rosa Radom,Sezon 2010/2011
2010-10-10 18:00,SKK Siedlce(d),68 : 60W,68,20,41,48.8,5,20,25.0,25,61,41.0,13,19,68.4,17,23,40,12,13,19,12,9,5,3,80,Rosa Radom,Sezon 2010/2011
2010-10-16 16:00,Asseco Prokom 2 Gdynia(w),68 : 70W,70,25,42,59.5,3,15,20.0,28,57,49.1,11,19,57.9,10,25,35,14,21,21,17,7,5,1,77,Rosa Radom,Sezon 2010/2011
2010-10-24 18:00,PTG Sokół Łańcut(d),62 : 74P,62,15,32,46.9,5,20,25.0,20,52,38.5,17,23,73.9,7,22,29,18,21,20,13,5,2,1,65,Rosa Radom,Sezon 2010/2011
2010-10-27 18:00,KS Spójnia Stargard Szczeciński(w),57 : 71W,71,21,36,58.3,5,15,33.3,26,51,51.0,14,20,70.0,4,24,28,11,24,17,16,12,4,1,79,Rosa Radom,Sezon 2010/2011
2010-11-06 16:00,Polonia 2011 Warszawa(d),85 : 65W,85,24,46,52.2,8,18,44.4,32,64,50.0,13,19,68.4,13,28,41,16,21,22,15,9,3,4,101,Rosa Radom,Sezon 2010/2011
2010-11-12 19:00,ŁKS Sphinx Łódź(w),79 : 72P,72,15,31,48.4,8,26,30.8,23,57,40.4,18,22,81.8,4,24,28,11,29,22,16,11,1,1,69,Rosa Radom,Sezon 2010/2011
2010-11-20 18:00,AZS Radex Szczecin(d),87 : 77W,87,25,44,56.8,7,16,43.8,32,60,53.3,16,22,72.7,14,24,38,17,19,19,14,5,0,2,99,Rosa Radom,Sezon 2010/2011
2010-11-27 18:00,Sportino Inowrocław(w),82 : 79P,79,17,40,42.5,8,17,47.1,25,57,43.9,21,32,65.6,11,19,30,14,22,25,19,10,2,2,73,Rosa Radom,Sezon 2010/2011
2010-12-05 17:00,MKS Dąbrowa Górnicza(d),81 : 64W,81,25,47,53.2,2,11,18.2,27,58,46.6,25,33,75.8,6,25,31,6,16,25,4,9,2,0,86,Rosa Radom,Sezon 2010/2011
2010-12-11 18:00,GKS Tychy(w),56 : 64W,64,16,34,47.1,8,24,33.3,24,58,41.4,8,12,66.7,7,30,37,14,15,14,16,3,0,2,64,Rosa Radom,Sezon 2010/2011
2010-12-15 18:00,Victoria Górnik Wałbrzych(d),66 : 60W,66,20,41,48.8,4,17,23.5,24,58,41.4,14,19,73.7,12,34,46,13,16,21,19,9,2,3,78,Rosa Radom,Sezon 2010/2011
2010-12-19 16:00,AZS Politechnika Warszawska(w),72 : 62P,62,22,44,50.0,2,14,14.3,24,58,41.4,12,17,70.6,10,26,36,7,16,18,18,10,0,4,58,Rosa Radom,Sezon 2010/2011
2011-01-15 17:00,KPSW Astoria Bydgoszcz(w),69 : 81W,81,24,42,57.1,5,14,35.7,29,56,51.8,18,24,75.0,7,25,32,16,20,23,10,13,3,3,102,Rosa Radom,Sezon 2010/2011
2011-01-19 18:00,MKS Start Lublin(d),73 : 66W,73,25,45,55.6,5,17,29.4,30,62,48.4,8,14,57.1,11,30,41,11,14,12,10,5,3,1,85,Rosa Radom,Sezon 2010/2011
2011-01-23 18:00,SKK Siedlce(w),66 : 70W,70,24,56,42.9,5,15,33.3,29,71,40.8,7,17,41.2,15,37,52,11,24,19,19,8,4,3,74,Rosa Radom,Sezon 2010/2011
2011-01-29 13:30,Asseco Prokom 2 Gdynia(d),83 : 94P,83,21,42,50.0,10,25,40.0,31,67,46.3,11,15,73.3,12,22,34,16,24,20,16,7,4,3,88,Rosa Radom,Sezon 2010/2011
2011-02-05 17:30,PTG Sokół Łańcut(w),66 : 54P,54,12,33,36.4,5,24,20.8,17,57,29.8,15,20,75.0,14,21,35,9,25,22,20,9,4,3,46,Rosa Radom,Sezon 2010/2011
2011-02-09 18:00,KS Spójnia Stargard Szczeciński(d),52 : 51W,52,12,31,38.7,5,20,25.0,17,51,33.3,13,18,72.2,12,26,38,10,16,21,15,10,2,1,58,Rosa Radom,Sezon 2010/2011
2011-02-13 16:00,Polonia 2011 Warszawa(w),51 : 69W,69,22,41,53.7,4,17,23.5,26,58,44.8,13,14,92.9,6,30,36,16,11,17,19,12,2,0,83,Rosa Radom,Sezon 2010/2011
2011-02-19 19:00,ŁKS Sphinx Łódź(d),69 : 62W,69,18,37,48.6,6,15,40.0,24,52,46.2,15,16,93.8,6,31,37,12,22,18,18,10,2,0,83,Rosa Radom,Sezon 2010/2011
2011-02-23 18:00,AZS Radex Szczecin(w),61 : 68W,68,25,49,51.0,2,15,13.3,27,64,42.2,12,21,57.1,9,29,38,5,14,19,7,7,2,1,67,Rosa Radom,Sezon 2010/2011
2011-02-27 18:00,MKS Znicz Basket Pruszków(w),71 : 76W,76,22,40,55.0,4,13,30.8,26,53,49.1,20,25,80.0,6,27,33,6,21,20,16,11,1,2,79,Rosa Radom,Sezon 2010/2011
2011-03-05 18:00,Sportino Inowrocław(d),64 : 84P,64,19,45,42.2,3,14,21.4,22,59,37.3,17,27,63.0,8,20,28,6,20,21,13,10,1,0,49,Rosa Radom,Sezon 2010/2011
2011-03-12 18:00,MKS Dąbrowa Górnicza(w),81 : 76P,76,26,51,51.0,4,15,26.7,30,66,45.5,12,15,80.0,9,22,31,14,21,18,12,5,0,4,75,Rosa Radom,Sezon 2010/2011
2011-03-19 19:00,GKS Tychy(d),86 : 72W,86,23,38,60.5,8,15,53.3,31,53,58.5,16,24,66.7,8,26,34,25,14,17,15,9,3,3,112,Rosa Radom,Sezon 2010/2011
2011-03-26 18:00,AZS Politechnika Warszawska(d),80 : 65W,80,23,45,51.1,6,12,50.0,29,57,50.9,16,21,76.2,6,27,33,23,25,17,18,9,1,2,95,Rosa Radom,Sezon 2010/2011
2011-04-03 18:30,ŁKS Sphinx Łódź(d),59 : 74P,59,10,30,33.3,7,19,36.8,17,49,34.7,18,23,78.3,8,26,34,10,18,20,16,7,3,2,60,Rosa Radom,Sezon 2010/2011
2011-04-06 20:00,ŁKS Sphinx Łódź(w),65 : 59P,59,13,32,40.6,6,20,30.0,19,52,36.5,15,22,68.2,7,28,35,9,26,24,14,8,1,1,58,Rosa Radom,Sezon 2010/2011
2010-09-25 18:00,GKS Tychy(d),45 : 68P,45,15,36,41.7,2,21,9.5,17,57,29.8,9,18,50.0,8,27,35,11,15,16,15,7,3,3,37,SKK Siedlce,Sezon 2010/2011
2010-10-02 17:30,Victoria Górnik Wałbrzych(w),82 : 73P,73,25,44,56.8,4,19,21.1,29,63,46.0,11,19,57.9,12,26,38,11,28,21,21,12,3,3,74,SKK Siedlce,Sezon 2010/2011
2010-10-06 20:00,AZS Politechnika Warszawska(d),50 : 67P,50,12,40,30.0,5,17,29.4,17,57,29.8,11,33,33.3,14,25,39,11,24,24,22,10,0,4,26,SKK Siedlce,Sezon 2010/2011
2010-10-10 18:00,Rosa Radom(w),68 : 60P,60,12,33,36.4,10,26,38.5,22,59,37.3,6,10,60.0,7,18,25,15,19,13,15,9,3,5,56,SKK Siedlce,Sezon 2010/2011
2010-10-16 18:00,KPSW Astoria Bydgoszcz(d),60 : 59W,60,17,42,40.5,3,18,16.7,20,60,33.3,17,31,54.8,11,26,37,10,26,26,16,7,6,3,50,SKK Siedlce,Sezon 2010/2011
2010-10-23 19:00,MKS Start Lublin(w),61 : 63W,63,19,47,40.4,5,14,35.7,24,61,39.3,10,17,58.8,8,26,34,19,20,17,10,11,2,7,75,SKK Siedlce,Sezon 2010/2011
2010-10-27 20:00,MKS Znicz Basket Pruszków(d),69 : 52W,69,26,51,51.0,3,16,18.8,29,67,43.3,8,13,61.5,20,23,43,19,15,15,18,15,5,1,90,SKK Siedlce,Sezon 2010/2011
2010-11-07 19:00,Asseco Prokom 2 Gdynia(d),64 : 84P,64,20,43,46.5,5,27,18.5,25,70,35.7,9,12,75.0,14,26,40,14,21,18,17,10,3,2,66,SKK Siedlce,Sezon 2010/2011
2010-11-13 17:30,PTG Sokół Łańcut(w),80 : 71P,71,18,38,47.4,6,22,27.3,24,60,40.0,17,24,70.8,13,27,40,14,28,17,19,11,1,3,75,SKK Siedlce,Sezon 2010/2011
2010-11-21 19:00,KS Spójnia Stargard Szczeciński(d),62 : 55W,62,17,35,48.6,5,19,26.3,22,54,40.7,13,19,68.4,10,24,34,16,14,23,14,8,1,0,69,SKK Siedlce,Sezon 2010/2011
2010-11-27 18:00,Polonia 2011 Warszawa(w),73 : 82W,82,22,36,61.1,10,18,55.6,32,54,59.3,8,15,53.3,7,29,36,24,17,21,23,9,5,1,104,SKK Siedlce,Sezon 2010/2011
2010-12-04 18:00,ŁKS Sphinx Łódź(d),66 : 69P,66,20,39,51.3,6,22,27.3,26,61,42.6,8,12,66.7,14,26,40,17,23,16,22,9,3,2,74,SKK Siedlce,Sezon 2010/2011
2010-12-12 20:00,AZS Radex Szczecin(w),79 : 76P,76,22,43,51.2,5,25,20.0,27,68,39.7,17,22,77.3,12,24,36,7,21,23,12,12,3,4,76,SKK Siedlce,Sezon 2010/2011
2010-12-15 20:00,Sportino Inowrocław(d),81 : 65W,81,15,37,40.5,13,24,54.2,28,61,45.9,12,16,75.0,9,28,37,22,18,21,16,7,3,2,97,SKK Siedlce,Sezon 2010/2011
2010-12-18 18:00,MKS Dąbrowa Górnicza(w),73 : 50P,50,12,33,36.4,7,22,31.8,19,55,34.5,5,13,38.5,6,23,29,12,18,17,11,6,2,1,44,SKK Siedlce,Sezon 2010/2011
2011-01-15 19:00,Victoria Górnik Wałbrzych(d),58 : 59P,58,16,44,36.4,4,20,20.0,20,64,31.3,14,26,53.8,18,30,48,15,26,26,20,11,4,7,60,SKK Siedlce,Sezon 2010/2011
2011-01-19 17:00,AZS Politechnika Warszawska(w),81 : 78P,78,19,37,51.4,9,22,40.9,28,59,47.5,13,20,65.0,7,23,30,17,18,20,18,9,0,3,78,SKK Siedlce,Sezon 2010/2011
2011-01-23 18:00,Rosa Radom(d),66 : 70P,66,18,47,38.3,8,31,25.8,26,78,33.3,6,19,31.6,17,25,42,15,19,24,12,15,3,4,64,SKK Siedlce,Sezon 2010/2011
2011-01-29 18:00,KPSW Astoria Bydgoszcz(w),85 : 76P,76,17,36,47.2,7,26,26.9,24,62,38.7,21,26,80.8,9,19,28,17,19,23,7,3,1,2,75,SKK Siedlce,Sezon 2010/2011
2011-02-06 18:00,MKS Start Lublin(d),82 : 58W,82,22,36,61.1,10,23,43.5,32,59,54.2,8,10,80.0,8,25,33,19,19,13,14,12,3,0,106,SKK Siedlce,Sezon 2010/2011
2011-02-09 18:00,MKS Znicz Basket Pruszków(w),81 : 62P,62,17,35,48.6,5,19,26.3,22,54,40.7,13,20,65.0,6,18,24,11,18,18,15,11,2,4,56,SKK Siedlce,Sezon 2010/2011
2011-02-12 15:00,Asseco Prokom 2 Gdynia(w),82 : 70P,70,18,34,52.9,9,28,32.1,27,62,43.5,7,14,50.0,11,20,31,15,21,15,26,9,4,2,61,SKK Siedlce,Sezon 2010/2011
2011-02-19 18:00,PTG Sokół Łańcut(d),63 : 62W,63,15,26,57.7,9,25,36.0,24,51,47.1,6,9,66.7,6,29,35,17,24,17,23,5,2,2,69,SKK Siedlce,Sezon 2010/2011
2011-02-23 18:00,KS Spójnia Stargard Szczeciński(w),81 : 58P,58,8,27,29.6,11,27,40.7,19,54,35.2,9,18,50.0,7,21,28,13,17,18,15,11,3,1,54,SKK Siedlce,Sezon 2010/2011
2011-02-26 18:00,GKS Tychy(w),73 : 75W,75,12,28,42.9,13,28,46.4,25,56,44.6,12,14,85.7,9,25,34,20,24,11,19,4,2,1,83,SKK Siedlce,Sezon 2010/2011
2011-03-06 18:00,Polonia 2011 Warszawa(d),73 : 64W,73,20,33,60.6,8,32,25.0,28,65,43.1,9,15,60.0,17,23,40,16,24,14,18,6,2,0,76,SKK Siedlce,Sezon 2010/2011
2011-03-13 17:00,ŁKS Sphinx Łódź(w),60 : 66W,66,15,36,41.7,8,25,32.0,23,61,37.7,12,14,85.7,8,28,36,14,24,19,14,7,2,2,71,SKK Siedlce,Sezon 2010/2011
2011-03-19 18:00,AZS Radex Szczecin(d),82 : 72W,82,22,37,59.5,9,25,36.0,31,62,50.0,11,22,50.0,12,21,33,14,18,20,8,10,1,0,90,SKK Siedlce,Sezon 2010/2011
2011-03-23 18:00,Sportino Inowrocław(w),75 : 62P,62,15,39,38.5,9,27,33.3,24,66,36.4,5,9,55.6,13,26,39,14,21,15,12,6,2,1,65,SKK Siedlce,Sezon 2010/2011
2011-03-27 19:00,MKS Dąbrowa Górnicza(d),63 : 87P,63,16,36,44.4,8,20,40.0,24,56,42.9,7,12,58.3,11,19,30,18,18,18,20,9,7,0,70,SKK Siedlce,Sezon 2010/2011
2011-04-02 19:00,Polonia 2011 Warszawa(d),72 : 74P,72,23,35,65.7,7,16,43.8,30,51,58.8,5,9,55.6,7,25,32,23,18,17,32,7,7,0,84,SKK Siedlce,Sezon 2010/2011
2011-04-03 19:00,Polonia 2011 Warszawa(d),79 : 55W,79,22,32,68.8,7,24,29.2,29,56,51.8,14,21,66.7,3,31,34,22,18,21,14,15,5,1,107,SKK Siedlce,Sezon 2010/2011
2011-04-09 15:00,Polonia 2011 Warszawa(w),86 : 75P,75,15,32,46.9,10,28,35.7,25,60,41.7,15,19,78.9,12,28,40,14,27,22,19,5,3,0,79,SKK Siedlce,Sezon 2010/2011
2011-04-10 18:30,Polonia 2011 Warszawa(w),67 : 70W,70,16,35,45.7,8,23,34.8,24,58,41.4,14,19,73.7,17,21,38,15,22,21,19,3,1,1,69,SKK Siedlce,Sezon 2010/2011
2011-04-16 19:00,Polonia 2011 Warszawa(d),57 : 54W,57,18,41,43.9,5,24,20.8,23,65,35.4,6,8,75.0,16,20,36,16,20,16,10,11,0,2,66,SKK Siedlce,Sezon 2010/2011
2010-09-25 17:30,PTG Sokół Łańcut(w),69 : 64P,64,15,36,41.7,6,20,30.0,21,56,37.5,16,25,64.0,13,24,37,14,21,19,13,10,0,3,68,Sportino Inowrocław,Sezon 2010/2011
2010-10-02 18:00,KS Spójnia Stargard Szczeciński(d),58 : 56W,58,13,26,50.0,4,18,22.2,17,44,38.6,20,31,64.5,10,24,34,9,19,28,17,7,1,3,54,Sportino Inowrocław,Sezon 2010/2011
2010-10-06 15:00,Polonia 2011 Warszawa(w),60 : 77W,77,27,44,61.4,4,16,25.0,31,60,51.7,11,13,84.6,6,28,34,15,17,18,15,7,4,4,91,Sportino Inowrocław,Sezon 2010/2011
2010-10-11 19:00,ŁKS Sphinx Łódź(d),60 : 53W,60,12,32,37.5,8,22,36.4,20,54,37.0,12,20,60.0,7,36,43,11,27,23,14,8,1,4,67,Sportino Inowrocław,Sezon 2010/2011
2010-10-16 18:00,AZS Radex Szczecin(w),82 : 83W,83,25,46,54.3,6,19,31.6,31,65,47.7,15,24,62.5,9,19,28,15,27,21,10,11,2,2,86,Sportino Inowrocław,Sezon 2010/2011
2010-10-24 18:00,MKS Znicz Basket Pruszków(w),69 : 76W,76,16,38,42.1,6,19,31.6,22,57,38.6,26,40,65.0,13,23,36,10,18,24,13,12,1,5,73,Sportino Inowrocław,Sezon 2010/2011
2010-10-27 18:00,MKS Dąbrowa Górnicza(d),65 : 57W,65,17,36,47.2,7,25,28.0,24,61,39.3,10,15,66.7,13,29,42,15,16,19,19,12,7,3,80,Sportino Inowrocław,Sezon 2010/2011
2010-11-06 18:00,GKS Tychy(w),60 : 73W,73,22,39,56.4,7,19,36.8,29,58,50.0,8,10,80.0,5,21,26,12,21,10,11,9,2,3,80,Sportino Inowrocław,Sezon 2010/2011
2010-11-13 18:00,Victoria Górnik Wałbrzych(d),61 : 46W,61,23,35,65.7,0,20,0.0,23,55,41.8,15,22,68.2,13,31,44,11,12,20,17,11,9,2,80,Sportino Inowrocław,Sezon 2010/2011
2010-11-20 14:00,AZS Politechnika Warszawska(w),71 : 69P,69,21,38,55.3,5,20,25.0,26,58,44.8,12,19,63.2,7,30,37,8,19,20,16,8,3,3,70,Sportino Inowrocław,Sezon 2010/2011
2010-11-27 18:00,Rosa Radom(d),82 : 79W,82,17,33,51.5,10,30,33.3,27,63,42.9,18,22,81.8,13,21,34,6,26,22,16,15,2,2,83,Sportino Inowrocław,Sezon 2010/2011
2010-12-04 16:30,KPSW Astoria Bydgoszcz(w),76 : 96W,96,24,43,55.8,12,24,50.0,36,67,53.7,12,20,60.0,10,26,36,20,18,17,11,11,5,2,118,Sportino Inowrocław,Sezon 2010/2011
2010-12-11 18:00,MKS Start Lublin(d),82 : 68W,82,24,47,51.1,9,23,39.1,33,70,47.1,7,18,38.9,14,22,36,16,18,15,10,15,4,2,95,Sportino Inowrocław,Sezon 2010/2011
2010-12-15 20:00,SKK Siedlce(w),81 : 65P,65,18,37,48.6,5,24,20.8,23,61,37.7,14,20,70.0,6,20,26,7,21,18,12,7,2,3,51,Sportino Inowrocław,Sezon 2010/2011
2010-12-18 16:00,Asseco Prokom 2 Gdynia(d),78 : 80P,78,22,40,55.0,9,29,31.0,31,69,44.9,7,9,77.8,8,19,27,14,17,19,11,13,5,3,86,Sportino Inowrocław,Sezon 2010/2011
2011-01-15 17:00,KS Spójnia Stargard Szczeciński(w),80 : 76P,76,16,31,51.6,6,18,33.3,22,49,44.9,26,32,81.3,7,21,28,10,26,30,19,10,5,3,77,Sportino Inowrocław,Sezon 2010/2011
2011-01-19 18:00,Polonia 2011 Warszawa(d),97 : 75W,97,18,40,45.0,17,27,63.0,35,67,52.2,10,13,76.9,10,22,32,19,21,17,14,16,1,3,116,Sportino Inowrocław,Sezon 2010/2011
2011-01-23 17:00,ŁKS Sphinx Łódź(w),78 : 83W,83,18,42,42.9,10,26,38.5,28,68,41.2,17,23,73.9,8,26,34,18,18,20,10,10,7,2,96,Sportino Inowrocław,Sezon 2010/2011
2011-01-29 18:00,AZS Radex Szczecin(d),82 : 75W,82,16,42,38.1,6,18,33.3,22,60,36.7,32,38,84.2,17,21,38,10,20,28,12,13,5,4,92,Sportino Inowrocław,Sezon 2010/2011
2011-02-05 18:00,MKS Znicz Basket Pruszków(d),73 : 71W,73,17,42,40.5,6,22,27.3,23,64,35.9,21,32,65.6,11,31,42,20,25,24,15,11,3,2,82,Sportino Inowrocław,Sezon 2010/2011
2011-02-12 18:00,GKS Tychy(d),73 : 67W,73,21,45,46.7,8,25,32.0,29,70,41.4,7,11,63.6,7,21,28,15,23,17,7,13,2,3,79,Sportino Inowrocław,Sezon 2010/2011
2011-02-19 17:00,Victoria Górnik Wałbrzych(w),71 : 98W,98,30,45,66.7,8,19,42.1,38,64,59.4,14,23,60.9,14,25,39,16,20,21,13,13,2,4,120,Sportino Inowrocław,Sezon 2010/2011
2011-02-23 18:00,AZS Politechnika Warszawska(d),60 : 65P,60,24,50,48.0,3,12,25.0,27,62,43.5,3,11,27.3,13,21,34,12,22,18,17,15,1,4,62,Sportino Inowrocław,Sezon 2010/2011
2011-02-26 18:00,PTG Sokół Łańcut(d),66 : 82P,66,16,36,44.4,9,32,28.1,25,68,36.8,7,10,70.0,11,25,36,12,24,19,10,11,6,3,75,Sportino Inowrocław,Sezon 2010/2011
2011-03-05 18:00,Rosa Radom(w),64 : 84W,84,23,38,60.5,7,23,30.4,30,61,49.2,17,26,65.4,8,25,33,14,21,21,12,9,1,0,89,Sportino Inowrocław,Sezon 2010/2011
2011-03-12 18:00,KPSW Astoria Bydgoszcz(d),78 : 72W,78,18,36,50.0,8,19,42.1,26,55,47.3,18,25,72.0,9,25,34,19,21,29,17,11,2,2,91,Sportino Inowrocław,Sezon 2010/2011
2011-03-16 18:00,MKS Dąbrowa Górnicza(w),76 : 75P,75,25,43,58.1,5,18,27.8,30,61,49.2,10,21,47.6,10,16,26,13,26,21,12,11,2,4,73,Sportino Inowrocław,Sezon 2010/2011
2011-03-19 19:00,MKS Start Lublin(w),61 : 69W,69,12,32,37.5,9,26,34.6,21,58,36.2,18,25,72.0,11,21,32,13,22,24,10,9,2,1,71,Sportino Inowrocław,Sezon 2010/2011
2011-03-23 18:00,SKK Siedlce(d),75 : 62W,75,17,46,37.0,8,26,30.8,25,72,34.7,17,23,73.9,22,25,47,11,15,20,8,10,1,2,83,Sportino Inowrocław,Sezon 2010/2011
2011-03-26 16:00,Asseco Prokom 2 Gdynia(w),94 : 68P,68,18,33,54.5,7,30,23.3,25,63,39.7,11,15,73.3,9,23,32,11,22,18,17,5,2,4,59,Sportino Inowrocław,Sezon 2010/2011
2011-04-02 17:30,PTG Sokół Łańcut(w),70 : 48P,48,11,23,47.8,5,19,26.3,16,42,38.1,11,24,45.8,5,21,26,6,21,26,22,9,1,1,29,Sportino Inowrocław,Sezon 2010/2011
2011-04-06 18:00,PTG Sokół Łańcut(d),74 : 67W,74,16,29,55.2,9,25,36.0,25,54,46.3,15,26,57.7,14,27,41,12,25,26,18,7,1,1,77,Sportino Inowrocław,Sezon 2010/2011
2011-04-09 17:30,PTG Sokół Łańcut(w),81 : 57P,57,14,34,41.2,5,21,23.8,19,55,34.5,14,19,73.7,15,11,26,9,28,27,18,10,2,0,45,Sportino Inowrocław,Sezon 2010/2011
2010-09-25 19:00,MKS Start Lublin(w),75 : 74P,74,22,49,44.9,6,26,23.1,28,75,37.3,12,13,92.3,13,22,35,10,22,17,15,17,3,3,76,Victoria Górnik Wałbrzych,Sezon 2010/2011
2010-10-02 17:30,SKK Siedlce(d),82 : 73W,82,19,40,47.5,4,20,20.0,23,60,38.3,32,33,97.0,11,26,37,7,21,27,14,20,3,2,97,Victoria Górnik Wałbrzych,Sezon 2010/2011
2010-10-06 15:30,Asseco Prokom 2 Gdynia(w),105 : 71P,71,22,38,57.9,5,20,25.0,27,58,46.6,12,19,63.2,5,15,20,16,19,16,17,5,2,3,59,Victoria Górnik Wałbrzych,Sezon 2010/2011
2010-10-10 17:00,PTG Sokół Łańcut(d),68 : 75P,68,19,42,45.2,7,24,29.2,26,66,39.4,9,16,56.3,13,23,36,14,27,18,8,8,2,4,73,Victoria Górnik Wałbrzych,Sezon 2010/2011
2010-10-16 17:00,KS Spójnia Stargard Szczeciński(w),99 : 62P,62,20,52,38.5,1,9,11.1,21,61,34.4,19,28,67.9,10,16,26,7,21,25,19,12,2,3,41,Victoria Górnik Wałbrzych,Sezon 2010/2011
2010-10-24 17:00,Polonia 2011 Warszawa(d),78 : 70W,78,19,37,51.4,4,16,25.0,23,53,43.4,28,39,71.8,12,27,39,14,21,29,16,14,2,1,90,Victoria Górnik Wałbrzych,Sezon 2010/2011
2010-10-27 19:00,ŁKS Sphinx Łódź(w),70 : 61P,61,16,36,44.4,7,22,31.8,23,58,39.7,8,14,57.1,8,22,30,12,22,19,13,11,1,1,61,Victoria Górnik Wałbrzych,Sezon 2010/2011
2010-11-06 16:00,AZS Radex Szczecin(d),69 : 76P,69,19,42,45.2,7,18,38.9,26,60,43.3,10,17,58.8,8,21,29,15,17,17,9,10,1,2,74,Victoria Górnik Wałbrzych,Sezon 2010/2011
2010-11-13 18:00,Sportino Inowrocław(w),61 : 46P,46,13,35,37.1,5,24,20.8,18,59,30.5,5,7,71.4,7,19,26,13,20,12,15,13,2,9,42,Victoria Górnik Wałbrzych,Sezon 2010/2011
2010-11-22 17:00,MKS Dąbrowa Górnicza(d),99 : 90W,99,28,50,56.0,8,23,34.8,36,73,49.3,19,30,63.3,11,25,36,21,34,22,13,21,2,2,118,Victoria Górnik Wałbrzych,Sezon 2010/2011
2010-12-04 18:00,MKS Znicz Basket Pruszków(w),69 : 47P,47,14,49,28.6,5,24,20.8,19,73,26.0,4,8,50.0,10,21,31,7,25,14,12,9,0,10,24,Victoria Górnik Wałbrzych,Sezon 2010/2011
2010-12-11 17:00,AZS Politechnika Warszawska(d),99 : 108P,99,25,40,62.5,14,30,46.7,39,70,55.7,7,13,53.8,5,26,31,23,20,15,18,12,0,3,110,Victoria Górnik Wałbrzych,Sezon 2010/2011
2010-12-15 18:00,Rosa Radom(w),66 : 60P,60,12,28,42.9,8,32,25.0,20,60,33.3,12,18,66.7,6,18,24,15,21,16,14,14,3,2,56,Victoria Górnik Wałbrzych,Sezon 2010/2011
2010-12-18 17:00,KPSW Astoria Bydgoszcz(d),75 : 80P,75,19,39,48.7,8,28,28.6,27,67,40.3,13,17,76.5,11,25,36,16,24,21,17,18,0,2,84,Victoria Górnik Wałbrzych,Sezon 2010/2011
2011-01-15 19:00,SKK Siedlce(w),58 : 59W,59,12,44,27.3,6,16,37.5,18,60,30.0,17,24,70.8,14,25,39,11,26,26,15,14,7,4,66,Victoria Górnik Wałbrzych,Sezon 2010/2011
2011-01-19 18:00,Asseco Prokom 2 Gdynia(d),53 : 83P,53,20,46,43.5,2,14,14.3,22,60,36.7,7,11,63.6,9,19,28,11,14,21,13,19,2,1,58,Victoria Górnik Wałbrzych,Sezon 2010/2011
2011-01-22 17:30,PTG Sokół Łańcut(w),87 : 55P,55,19,30,63.3,4,26,15.4,23,56,41.1,5,6,83.3,8,16,24,9,15,11,19,8,2,5,45,Victoria Górnik Wałbrzych,Sezon 2010/2011
2011-01-29 16:30,KS Spójnia Stargard Szczeciński(d),65 : 54W,65,12,33,36.4,9,19,47.4,21,52,40.4,14,23,60.9,5,30,35,14,22,23,17,19,2,3,78,Victoria Górnik Wałbrzych,Sezon 2010/2011
2011-02-05 15:00,Polonia 2011 Warszawa(w),90 : 65P,65,22,36,61.1,3,19,15.8,25,55,45.5,12,19,63.2,7,20,27,12,17,23,20,12,1,6,60,Victoria Górnik Wałbrzych,Sezon 2010/2011
2011-02-09 18:00,ŁKS Sphinx Łódź(d),72 : 84P,72,20,45,44.4,4,16,25.0,24,61,39.3,20,22,90.9,9,25,34,12,9,20,15,14,4,2,82,Victoria Górnik Wałbrzych,Sezon 2010/2011
2011-02-12 19:00,AZS Radex Szczecin(w),61 : 57P,57,19,39,48.7,4,18,22.2,23,57,40.4,7,11,63.6,5,30,35,9,18,16,22,15,4,2,60,Victoria Górnik Wałbrzych,Sezon 2010/2011
2011-02-19 17:00,Sportino Inowrocław(d),71 : 98P,71,21,48,43.8,4,15,26.7,25,63,39.7,17,22,77.3,14,17,31,17,21,20,15,13,4,2,78,Victoria Górnik Wałbrzych,Sezon 2010/2011
2011-02-23 18:00,MKS Dąbrowa Górnicza(w),65 : 57P,57,20,43,46.5,3,13,23.1,23,56,41.1,8,10,80.0,9,27,36,8,17,16,17,12,3,3,64,Victoria Górnik Wałbrzych,Sezon 2010/2011
2011-02-26 17:00,MKS Start Lublin(d),61 : 57W,61,18,42,42.9,4,20,20.0,22,62,35.5,13,17,76.5,13,32,45,14,21,22,19,16,3,1,76,Victoria Górnik Wałbrzych,Sezon 2010/2011
2011-03-04 18:00,GKS Tychy(d),52 : 79P,52,14,38,36.8,6,24,25.0,20,62,32.3,6,10,60.0,9,23,32,14,16,18,14,13,3,4,54,Victoria Górnik Wałbrzych,Sezon 2010/2011
2011-03-12 16:30,MKS Znicz Basket Pruszków(d),71 : 117P,71,22,42,52.4,5,21,23.8,27,63,42.9,12,16,75.0,5,21,26,18,20,20,18,9,9,4,75,Victoria Górnik Wałbrzych,Sezon 2010/2011
2009-10-03 18:00,Asseco Prokom 2 Gdynia(d),76 : 73W,76,20,40,50.0,8,19,42.1,28,59,47.5,12,22,54.5,6,21,27,12,27,20,18,13,4,3,73,KS AZS AWF Katowice,Sezon 2009/2010
2009-10-10 18:00,Spójnia Stargard Szcz.(d),78 : 87P,78,14,30,46.7,10,24,41.7,24,54,44.4,20,34,58.8,13,19,32,13,29,24,19,7,4,3,71,KS AZS AWF Katowice,Sezon 2009/2010
2009-10-14 18:00,Intermarche Zastal Zielona Góra(w),75 : 58P,58,19,36,52.8,2,16,12.5,21,52,40.4,14,18,77.8,5,23,28,7,24,23,17,7,2,3,50,KS AZS AWF Katowice,Sezon 2009/2010
2009-10-21 18:30,ŁKS Łódź(d),74 : 85P,74,16,29,55.2,9,22,40.9,25,51,49.0,15,30,50.0,6,20,26,14,20,22,15,7,5,3,70,KS AZS AWF Katowice,Sezon 2009/2010
2009-10-25 18:00,MKS Dąbrowa Górnicza(d),85 : 88P,85,18,34,52.9,11,18,61.1,29,52,55.8,16,33,48.5,8,18,26,12,25,26,19,16,1,5,81,KS AZS AWF Katowice,Sezon 2009/2010
2009-10-28 18:30,AZS Politechnika Warszawska(d),81 : 89P,81,23,42,54.8,6,17,35.3,29,59,49.2,17,23,73.9,3,17,20,10,16,20,7,13,2,2,83,KS AZS AWF Katowice,Sezon 2009/2010
2009-11-07 18:30,MKS Start Lublin(w),87 : 82P,82,20,41,48.8,7,19,36.8,27,60,45.0,21,28,75.0,6,21,27,14,20,26,16,14,5,3,86,KS AZS AWF Katowice,Sezon 2009/2010
2009-11-11 18:30,Siarka Tarnobrzeg(d),65 : 69P,65,15,34,44.1,9,23,39.1,24,57,42.1,8,11,72.7,10,19,29,17,23,21,18,10,4,3,71,KS AZS AWF Katowice,Sezon 2009/2010
2009-11-21 18:00,PTG Sokół Łańcut(d),67 : 63W,67,18,37,48.6,8,18,44.4,26,55,47.3,7,8,87.5,7,11,18,13,18,15,18,15,3,1,68,KS AZS AWF Katowice,Sezon 2009/2010
2009-11-25 18:00,Victoria Górnik Wałbrzych(w),80 : 67P,67,18,35,51.4,6,21,28.6,24,56,42.9,13,19,68.4,4,22,26,12,17,19,12,6,3,1,64,KS AZS AWF Katowice,Sezon 2009/2010
2009-11-28 18:30,Miasto Szkła Krosno(d),67 : 82P,67,15,25,60.0,6,21,28.6,21,46,45.7,19,27,70.4,3,17,20,15,17,26,14,4,1,0,60,KS AZS AWF Katowice,Sezon 2009/2010
2009-12-12 18:30,Znicz Basket Pruszków(d),74 : 83P,74,11,19,57.9,8,31,25.8,19,50,38.0,28,31,90.3,1,20,21,7,22,26,14,9,3,2,66,KS AZS AWF Katowice,Sezon 2009/2010
2009-12-16 19:00,GKS Tychy(w),91 : 78P,78,21,37,56.8,8,20,40.0,29,57,50.9,12,19,63.2,4,14,18,13,19,20,10,9,0,0,73,KS AZS AWF Katowice,Sezon 2009/2010
2009-12-19 17:00,Żubry Białystok(w),89 : 78P,78,25,51,49.0,8,28,28.6,33,79,41.8,4,8,50.0,10,22,32,13,16,12,15,11,1,3,70,KS AZS AWF Katowice,Sezon 2009/2010
2010-01-06 18:00,KS Sudety Jelenia Góra(w),47 : 72W,72,17,35,48.6,10,19,52.6,27,54,50.0,8,16,50.0,8,27,35,21,18,15,14,13,2,2,94,KS AZS AWF Katowice,Sezon 2009/2010
2010-01-10 16:30,Asseco Prokom 2 Gdynia(w),94 : 59P,59,13,39,33.3,6,24,25.0,19,63,30.2,15,22,68.2,10,15,25,11,24,17,21,10,3,6,36,KS AZS AWF Katowice,Sezon 2009/2010
2010-01-16 17:00,Spójnia Stargard Szcz.(w),69 : 64P,64,17,33,51.5,6,21,28.6,23,54,42.6,12,20,60.0,7,19,26,15,17,23,21,16,3,2,64,KS AZS AWF Katowice,Sezon 2009/2010
2010-01-20 18:30,Intermarche Zastal Zielona Góra(d),71 : 93P,71,14,30,46.7,10,24,41.7,24,54,44.4,13,25,52.0,8,13,21,14,17,24,18,8,2,7,56,KS AZS AWF Katowice,Sezon 2009/2010
2010-01-30 18:00,MKS Dąbrowa Górnicza(w),83 : 59P,59,14,38,36.8,7,21,33.3,21,59,35.6,10,19,52.6,4,11,15,10,20,18,13,10,1,4,35,KS AZS AWF Katowice,Sezon 2009/2010
2010-02-03 19:00,AZS Politechnika Warszawska(w),98 : 90P,90,24,38,63.2,6,22,27.3,30,60,50.0,24,37,64.9,7,26,33,14,24,30,27,16,3,2,86,KS AZS AWF Katowice,Sezon 2009/2010
2010-02-06 18:00,MKS Start Lublin(d),66 : 69P,66,17,34,50.0,8,27,29.6,25,61,41.0,8,14,57.1,5,27,32,15,23,16,12,6,5,3,70,KS AZS AWF Katowice,Sezon 2009/2010
2010-02-10 18:00,Siarka Tarnobrzeg(w),80 : 62P,62,19,36,52.8,4,16,25.0,23,52,44.2,12,17,70.6,3,19,22,7,23,25,12,12,0,3,57,KS AZS AWF Katowice,Sezon 2009/2010
2010-02-13 18:00,GKS Tychy(d),79 : 72W,79,18,36,50.0,6,18,33.3,24,54,44.4,25,36,69.4,9,19,28,14,19,30,12,8,7,3,83,KS AZS AWF Katowice,Sezon 2009/2010
2010-02-17 19:00,Znicz Basket Pruszków(w),81 : 67P,67,21,42,50.0,5,20,25.0,26,62,41.9,10,16,62.5,6,20,26,15,22,21,12,8,5,4,67,KS AZS AWF Katowice,Sezon 2009/2010
2010-02-20 17:30,PTG Sokół Łańcut(w),90 : 58P,58,16,32,50.0,5,19,26.3,21,51,41.2,11,17,64.7,7,15,22,6,22,25,19,10,2,1,43,KS AZS AWF Katowice,Sezon 2009/2010
2010-02-24 18:30,Victoria Górnik Wałbrzych(d),68 : 63W,68,23,36,63.9,4,18,22.2,27,54,50.0,10,17,58.8,7,26,33,16,20,20,19,9,0,1,73,KS AZS AWF Katowice,Sezon 2009/2010
2010-02-28 18:00,Miasto Szkła Krosno(w),67 : 74W,74,17,29,58.6,7,21,33.3,24,50,48.0,19,29,65.5,6,24,30,14,18,26,12,6,0,1,76,KS AZS AWF Katowice,Sezon 2009/2010
2010-03-03 18:30,KS Sudety Jelenia Góra(d),61 : 63P,61,17,43,39.5,6,19,31.6,23,62,37.1,9,13,69.2,10,25,35,17,23,15,12,6,2,1,66,KS AZS AWF Katowice,Sezon 2009/2010
2010-03-12 19:00,ŁKS Łódź(w),90 : 82P,82,19,46,41.3,9,19,47.4,28,65,43.1,17,19,89.5,9,16,25,10,22,18,14,8,4,0,76,KS AZS AWF Katowice,Sezon 2009/2010
2010-03-20 18:30,Żubry Białystok(d),75 : 65W,75,23,44,52.3,6,26,23.1,29,70,41.4,11,16,68.8,9,29,38,14,21,14,12,8,0,5,77,KS AZS AWF Katowice,Sezon 2009/2010
2010-03-27 15:00,Asseco Prokom 2 Gdynia(w),109 : 102P,102,30,48,62.5,8,23,34.8,38,71,53.5,18,25,72.0,9,22,31,17,19,23,14,6,4,5,106,KS AZS AWF Katowice,Sezon 2009/2010
2010-03-31 18:30,Asseco Prokom 2 Gdynia(d),61 : 66P,61,16,30,53.3,7,22,31.8,23,52,44.2,8,13,61.5,6,20,26,13,15,16,15,7,3,0,61,KS AZS AWF Katowice,Sezon 2009/2010
2009-10-03 18:00,Siarka Tarnobrzeg(w),87 : 85P,85,24,37,64.9,8,23,34.8,32,60,53.3,13,21,61.9,5,20,25,15,34,22,19,8,2,2,80,GKS Tychy,Sezon 2009/2010
2009-10-10 17:00,Asseco Prokom 2 Gdynia(w),75 : 79W,79,27,44,61.4,8,26,30.8,35,70,50.0,1,1,100.0,8,22,30,18,22,13,14,10,3,3,91,GKS Tychy,Sezon 2009/2010
2009-10-14 19:00,PTG Sokół Łańcut(d),68 : 75P,68,21,47,44.7,6,24,25.0,27,71,38.0,8,14,57.1,6,19,25,14,23,20,7,7,5,0,62,GKS Tychy,Sezon 2009/2010
2009-10-21 18:00,Victoria Górnik Wałbrzych(w),81 : 91W,91,31,51,60.8,6,12,50.0,37,63,58.7,11,23,47.8,12,26,38,15,20,21,12,10,4,5,108,GKS Tychy,Sezon 2009/2010
2009-10-24 18:00,Miasto Szkła Krosno(d),72 : 59W,72,18,33,54.5,8,21,38.1,26,54,48.1,12,16,75.0,8,22,30,12,21,17,16,8,3,3,77,GKS Tychy,Sezon 2009/2010
2009-10-28 18:00,KS Sudety Jelenia Góra(w),65 : 71W,71,22,36,61.1,6,17,35.3,28,53,52.8,9,15,60.0,4,23,27,17,16,18,14,12,1,2,83,GKS Tychy,Sezon 2009/2010
2009-11-07 18:00,Znicz Basket Pruszków(d),94 : 81W,94,29,42,69.0,6,23,26.1,35,65,53.8,18,27,66.7,11,21,32,17,20,27,21,15,0,1,98,GKS Tychy,Sezon 2009/2010
2009-11-11 17:00,Żubry Białystok(w),74 : 66P,66,21,48,43.8,5,21,23.8,26,69,37.7,9,12,75.0,14,25,39,15,25,21,19,9,3,5,67,GKS Tychy,Sezon 2009/2010
2009-11-21 17:00,Spójnia Stargard Szcz.(w),70 : 69P,69,14,35,40.0,11,27,40.7,25,62,40.3,8,11,72.7,6,23,29,14,19,17,17,8,2,3,65,GKS Tychy,Sezon 2009/2010
2009-11-25 19:00,Intermarche Zastal Zielona Góra(d),73 : 70W,73,22,44,50.0,6,15,40.0,28,59,47.5,11,17,64.7,12,21,33,14,19,24,19,11,4,2,79,GKS Tychy,Sezon 2009/2010
2009-11-29 17:00,ŁKS Łódź(w),74 : 54P,54,15,32,46.9,7,24,29.2,22,56,39.3,3,9,33.3,6,19,25,6,16,13,20,13,4,1,42,GKS Tychy,Sezon 2009/2010
2009-12-05 18:00,MKS Dąbrowa Górnicza(d),87 : 76W,87,28,45,62.2,3,13,23.1,31,58,53.4,22,30,73.3,9,21,30,13,21,24,14,17,0,2,98,GKS Tychy,Sezon 2009/2010
2009-12-12 15:00,AZS Politechnika Warszawska(w),56 : 74W,74,25,43,58.1,6,23,26.1,31,66,47.0,6,7,85.7,8,24,32,14,15,17,14,11,2,2,83,GKS Tychy,Sezon 2009/2010
2009-12-16 19:00,KS AZS AWF Katowice(d),91 : 78W,91,23,35,65.7,11,20,55.0,34,55,61.8,12,20,60.0,9,25,34,22,20,18,19,10,0,0,109,GKS Tychy,Sezon 2009/2010
2009-12-19 18:00,MKS Start Lublin(d),77 : 74W,77,19,45,42.2,8,23,34.8,27,68,39.7,15,23,65.2,11,30,41,11,21,22,8,6,7,1,85,GKS Tychy,Sezon 2009/2010
2010-01-09 18:00,Siarka Tarnobrzeg(d),83 : 78W,83,17,43,39.5,10,24,41.7,27,67,40.3,19,21,90.5,13,21,34,17,16,21,12,11,2,4,93,GKS Tychy,Sezon 2009/2010
2010-01-16 18:00,Asseco Prokom 2 Gdynia(d),89 : 81W,89,19,41,46.3,10,25,40.0,29,66,43.9,21,25,84.0,12,21,33,16,22,22,16,15,0,3,96,GKS Tychy,Sezon 2009/2010
2010-01-20 18:00,PTG Sokół Łańcut(w),62 : 65W,65,19,39,48.7,5,20,25.0,24,59,40.7,12,20,60.0,11,26,37,12,31,19,15,14,3,3,73,GKS Tychy,Sezon 2009/2010
2010-01-23 18:00,Victoria Górnik Wałbrzych(d),66 : 69P,66,20,39,51.3,4,17,23.5,24,56,42.9,14,25,56.0,10,28,38,17,23,21,14,8,3,3,75,GKS Tychy,Sezon 2009/2010
2010-01-31 18:00,Miasto Szkła Krosno(w),80 : 85W,85,26,43,60.5,2,15,13.3,28,58,48.3,27,38,71.1,13,24,37,9,18,27,14,11,0,4,87,GKS Tychy,Sezon 2009/2010
2010-02-03 19:00,KS Sudety Jelenia Góra(d),87 : 71W,87,26,47,55.3,4,17,23.5,30,64,46.9,23,29,79.3,16,25,41,18,26,20,15,9,2,3,102,GKS Tychy,Sezon 2009/2010
2010-02-06 18:00,Znicz Basket Pruszków(w),75 : 68P,68,17,43,39.5,7,28,25.0,24,71,33.8,13,16,81.3,20,21,41,14,21,18,16,10,1,4,68,GKS Tychy,Sezon 2009/2010
2010-02-10 19:00,Żubry Białystok(d),93 : 74W,93,29,54,53.7,8,16,50.0,37,70,52.9,11,13,84.6,11,29,40,17,18,13,12,6,8,8,117,GKS Tychy,Sezon 2009/2010
2010-02-13 18:00,KS AZS AWF Katowice(w),79 : 72P,72,21,43,48.8,5,19,26.3,26,62,41.9,15,25,60.0,9,18,27,13,30,18,16,6,3,7,59,GKS Tychy,Sezon 2009/2010
2010-02-17 19:00,AZS Politechnika Warszawska(d),103 : 101W,103,24,43,55.8,14,21,66.7,38,64,59.4,13,17,76.5,7,14,21,25,20,19,17,13,1,1,116,GKS Tychy,Sezon 2009/2010
2010-02-20 18:00,Spójnia Stargard Szcz.(d),74 : 79P,74,24,42,57.1,6,22,27.3,30,64,46.9,8,12,66.7,10,23,33,15,19,18,18,14,1,0,81,GKS Tychy,Sezon 2009/2010
2010-02-24 18:00,Intermarche Zastal Zielona Góra(w),64 : 65W,65,23,46,50.0,4,19,21.1,27,65,41.5,7,13,53.8,8,30,38,11,16,17,13,11,5,4,73,GKS Tychy,Sezon 2009/2010
2010-02-27 18:00,ŁKS Łódź(d),88 : 61W,88,27,44,61.4,8,25,32.0,35,69,50.7,10,18,55.6,11,30,41,19,20,16,9,9,5,2,111,GKS Tychy,Sezon 2009/2010
2010-03-07 18:00,MKS Dąbrowa Górnicza(w),73 : 84W,84,28,47,59.6,5,13,38.5,33,60,55.0,13,18,72.2,6,29,35,10,21,16,15,9,4,1,95,GKS Tychy,Sezon 2009/2010
2010-03-19 18:30,MKS Start Lublin(w),75 : 69P,69,12,32,37.5,12,32,37.5,24,64,37.5,9,17,52.9,6,21,27,18,20,18,11,6,3,3,64,GKS Tychy,Sezon 2009/2010
2010-03-27 18:00,ŁKS Łódź(d),93 : 77W,93,27,45,60.0,11,26,42.3,38,71,53.5,6,8,75.0,10,20,30,19,19,17,13,9,4,0,107,GKS Tychy,Sezon 2009/2010
2010-03-31 19:00,ŁKS Łódź(w),73 : 62P,62,15,29,51.7,8,26,30.8,23,55,41.8,8,17,47.1,2,22,24,10,21,18,13,4,3,1,49,GKS Tychy,Sezon 2009/2010
2010-04-07 19:00,ŁKS Łódź(d),72 : 75P,72,18,35,51.4,10,24,41.7,28,59,47.5,6,11,54.5,7,23,30,20,23,17,17,9,1,2,79,GKS Tychy,Sezon 2009/2010
2009-10-02 00:00,ŁKS Łódź(w),74 : 86W,86,24,43,55.8,7,14,50.0,31,57,54.4,17,21,81.0,7,25,32,16,21,22,16,11,0,2,99,KS Sudety Jelenia Góra,Sezon 2009/2010
2009-10-10 18:00,MKS Dąbrowa Górnicza(d),71 : 81P,71,22,41,53.7,1,10,10.0,23,51,45.1,24,37,64.9,10,19,29,8,22,29,16,13,0,2,64,KS Sudety Jelenia Góra,Sezon 2009/2010
2009-10-15 18:00,AZS Politechnika Warszawska(w),79 : 81W,81,28,54,51.9,5,20,25.0,33,74,44.6,10,12,83.3,12,20,32,14,19,19,16,15,0,2,83,KS Sudety Jelenia Góra,Sezon 2009/2010
2009-10-21 18:00,MKS Start Lublin(d),67 : 64W,67,20,38,52.6,7,19,36.8,27,57,47.4,6,12,50.0,8,20,28,9,17,17,9,7,1,1,67,KS Sudety Jelenia Góra,Sezon 2009/2010
2009-10-24 18:00,Siarka Tarnobrzeg(w),78 : 71P,71,17,37,45.9,6,16,37.5,23,53,43.4,19,27,70.4,6,25,31,14,26,23,21,6,3,0,66,KS Sudety Jelenia Góra,Sezon 2009/2010
2009-10-28 18:00,GKS Tychy(d),65 : 71P,65,17,32,53.1,8,21,38.1,25,53,47.2,7,12,58.3,7,23,30,10,18,16,20,7,2,1,61,KS Sudety Jelenia Góra,Sezon 2009/2010
2009-11-07 17:30,PTG Sokół Łańcut(w),102 : 86P,86,25,47,53.2,8,21,38.1,33,68,48.5,12,14,85.7,13,19,32,12,19,16,12,8,1,2,90,KS Sudety Jelenia Góra,Sezon 2009/2010
2009-11-11 18:00,Victoria Górnik Wałbrzych(d),82 : 74W,82,30,47,63.8,3,12,25.0,33,59,55.9,13,22,59.1,8,26,34,12,19,22,8,6,1,1,92,KS Sudety Jelenia Góra,Sezon 2009/2010
2009-11-18 18:00,Miasto Szkła Krosno(w),89 : 39P,39,11,48,22.9,3,19,15.8,14,67,20.9,8,16,50.0,15,21,36,7,16,21,12,5,2,5,16,KS Sudety Jelenia Góra,Sezon 2009/2010
2009-11-25 18:00,Znicz Basket Pruszków(d),62 : 65P,62,16,43,37.2,8,24,33.3,24,67,35.8,6,8,75.0,11,28,39,17,20,18,13,9,2,4,71,KS Sudety Jelenia Góra,Sezon 2009/2010
2009-11-28 19:00,Żubry Białystok(w),80 : 73P,73,23,47,48.9,5,23,21.7,28,70,40.0,12,14,85.7,9,20,29,8,21,22,15,11,2,6,64,KS Sudety Jelenia Góra,Sezon 2009/2010
2009-12-12 17:00,Spójnia Stargard Szcz.(w),78 : 55P,55,14,37,37.8,6,23,26.1,20,60,33.3,9,14,64.3,8,19,27,8,19,16,17,11,2,5,41,KS Sudety Jelenia Góra,Sezon 2009/2010
2009-12-16 15:00,Asseco Prokom 2 Gdynia(w),91 : 70P,70,22,47,46.8,6,16,37.5,28,63,44.4,8,9,88.9,3,18,21,7,19,16,16,4,2,9,52,KS Sudety Jelenia Góra,Sezon 2009/2010
2009-12-19 18:00,Intermarche Zastal Zielona Góra(d),80 : 86P,80,17,33,51.5,9,26,34.6,26,59,44.1,19,25,76.0,10,27,37,9,23,24,10,5,0,3,82,KS Sudety Jelenia Góra,Sezon 2009/2010
2010-01-06 18:00,KS AZS AWF Katowice(d),47 : 72P,47,10,27,37.0,7,23,30.4,17,50,34.0,6,10,60.0,9,21,30,12,16,18,18,8,2,2,44,KS Sudety Jelenia Góra,Sezon 2009/2010
2010-01-09 18:00,ŁKS Łódź(d),61 : 85P,61,9,38,23.7,9,22,40.9,18,60,30.0,16,22,72.7,11,17,28,13,25,21,16,10,2,1,50,KS Sudety Jelenia Góra,Sezon 2009/2010
2010-01-16 18:00,MKS Dąbrowa Górnicza(w),100 : 67P,67,14,31,45.2,10,23,43.5,24,54,44.4,9,15,60.0,6,15,21,2,17,17,18,7,1,4,44,KS Sudety Jelenia Góra,Sezon 2009/2010
2010-01-20 18:00,AZS Politechnika Warszawska(d),65 : 74P,65,18,37,48.6,6,24,25.0,24,61,39.3,11,15,73.3,8,20,28,13,26,19,10,9,3,0,67,KS Sudety Jelenia Góra,Sezon 2009/2010
2010-01-23 18:30,MKS Start Lublin(w),77 : 71P,71,20,46,43.5,6,19,31.6,26,65,40.0,13,20,65.0,11,21,32,7,21,22,16,11,0,4,59,KS Sudety Jelenia Góra,Sezon 2009/2010
2010-01-30 18:00,Siarka Tarnobrzeg(d),62 : 76P,62,17,37,45.9,6,16,37.5,23,53,43.4,10,13,76.9,7,18,25,11,18,16,10,8,0,2,63,KS Sudety Jelenia Góra,Sezon 2009/2010
2010-02-03 19:00,GKS Tychy(w),87 : 71P,71,16,39,41.0,6,22,27.3,22,61,36.1,21,24,87.5,9,17,26,12,22,25,11,7,3,2,66,KS Sudety Jelenia Góra,Sezon 2009/2010
2010-02-06 17:30,PTG Sokół Łańcut(d),72 : 69W,72,16,30,53.3,9,18,50.0,25,48,52.1,13,19,68.4,4,26,30,20,19,20,12,5,2,0,88,KS Sudety Jelenia Góra,Sezon 2009/2010
2010-02-10 18:00,Victoria Górnik Wałbrzych(w),74 : 67P,67,18,40,45.0,7,19,36.8,25,59,42.4,10,22,45.5,10,25,35,11,26,21,10,5,1,4,63,KS Sudety Jelenia Góra,Sezon 2009/2010
2010-02-13 17:30,Miasto Szkła Krosno(d),75 : 73W,75,15,28,53.6,8,16,50.0,23,44,52.3,21,28,75.0,2,21,23,12,20,25,10,11,0,3,83,KS Sudety Jelenia Góra,Sezon 2009/2010
2010-02-17 17:30,Spójnia Stargard Szcz.(d),64 : 63W,64,18,45,40.0,8,20,40.0,26,65,40.0,4,8,50.0,9,25,34,16,19,17,9,5,7,2,74,KS Sudety Jelenia Góra,Sezon 2009/2010
2010-02-20 16:00,Asseco Prokom 2 Gdynia(d),65 : 75P,65,17,40,42.5,7,21,33.3,24,61,39.3,10,13,76.9,8,21,29,11,21,16,8,3,2,5,62,KS Sudety Jelenia Góra,Sezon 2009/2010
2010-02-24 18:00,Znicz Basket Pruszków(w),74 : 62P,62,17,42,40.5,5,14,35.7,22,56,39.3,13,16,81.3,9,20,29,9,20,18,11,10,1,4,63,KS Sudety Jelenia Góra,Sezon 2009/2010
2010-02-27 17:30,Żubry Białystok(d),55 : 59P,55,11,29,37.9,8,24,33.3,19,53,35.8,9,14,64.3,9,26,35,12,20,16,13,7,1,3,58,KS Sudety Jelenia Góra,Sezon 2009/2010
2010-03-03 18:30,KS AZS AWF Katowice(w),61 : 63W,63,19,41,46.3,4,21,19.0,23,62,37.1,13,19,68.4,11,25,36,12,15,23,12,8,1,2,63,KS Sudety Jelenia Góra,Sezon 2009/2010
2010-03-27 18:30,MKS Start Lublin(w),68 : 69W,69,19,34,55.9,6,24,25.0,25,58,43.1,13,19,68.4,9,33,42,11,23,20,19,5,7,2,76,KS Sudety Jelenia Góra,Sezon 2009/2010
2010-03-31 17:30,MKS Start Lublin(d),48 : 63P,48,8,31,25.8,7,23,30.4,15,54,27.8,11,19,57.9,13,14,27,8,17,18,10,5,5,2,36,KS Sudety Jelenia Góra,Sezon 2009/2010
2010-04-07 18:30,MKS Start Lublin(w),74 : 59P,59,15,37,40.5,7,25,28.0,22,62,35.5,8,13,61.5,9,11,20,8,21,20,10,10,3,2,45,KS Sudety Jelenia Góra,Sezon 2009/2010
2009-10-03 17:00,Spójnia Stargard Szcz.(w),101 : 65P,65,17,44,38.6,3,20,15.0,20,64,31.3,22,32,68.8,14,16,30,14,19,29,19,8,3,3,47,Żubry Białystok,Sezon 2009/2010
2009-10-10 17:00,Intermarche Zastal Zielona Góra(d),58 : 84P,58,15,41,36.6,7,15,46.7,22,56,39.3,7,12,58.3,6,27,33,13,22,15,30,11,4,3,50,Żubry Białystok,Sezon 2009/2010
2009-10-18 18:00,ŁKS Łódź(w),101 : 60P,60,12,32,37.5,7,27,25.9,19,59,32.2,15,24,62.5,5,15,20,8,22,22,17,7,4,4,33,Żubry Białystok,Sezon 2009/2010
2009-10-21 17:00,MKS Dąbrowa Górnicza(d),80 : 91P,80,26,49,53.1,7,19,36.8,33,68,48.5,7,11,63.6,5,29,34,12,29,17,22,8,3,2,76,Żubry Białystok,Sezon 2009/2010
2009-10-24 15:00,AZS Politechnika Warszawska(w),76 : 65P,65,19,37,51.4,5,21,23.8,24,58,41.4,12,21,57.1,8,25,33,13,19,24,21,12,4,2,63,Żubry Białystok,Sezon 2009/2010
2009-10-28 17:00,MKS Start Lublin(d),65 : 83P,65,14,35,40.0,7,24,29.2,21,59,35.6,16,20,80.0,8,19,27,11,21,16,20,15,3,3,59,Żubry Białystok,Sezon 2009/2010
2009-11-07 18:00,Siarka Tarnobrzeg(w),96 : 67P,67,16,32,50.0,8,32,25.0,24,64,37.5,11,19,57.9,8,17,25,14,21,15,16,7,3,1,52,Żubry Białystok,Sezon 2009/2010
2009-11-11 17:00,GKS Tychy(d),74 : 66W,74,17,30,56.7,4,24,16.7,21,54,38.9,28,36,77.8,10,25,35,10,21,25,18,9,6,3,75,Żubry Białystok,Sezon 2009/2010
2009-11-21 17:00,Victoria Górnik Wałbrzych(d),93 : 85W,93,24,44,54.5,10,32,31.3,34,76,44.7,15,21,71.4,14,25,39,12,18,18,8,3,6,0,97,Żubry Białystok,Sezon 2009/2010
2009-11-25 18:00,Miasto Szkła Krosno(w),59 : 95W,95,25,41,61.0,11,25,44.0,36,66,54.5,12,22,54.5,8,26,34,20,18,21,7,14,5,2,121,Żubry Białystok,Sezon 2009/2010
2009-11-28 19:00,KS Sudety Jelenia Góra(d),80 : 73W,80,18,40,45.0,8,18,44.4,26,58,44.8,20,24,83.3,12,26,38,14,22,20,21,8,6,2,89,Żubry Białystok,Sezon 2009/2010
2009-12-06 18:00,Znicz Basket Pruszków(w),78 : 77P,77,13,33,39.4,9,22,40.9,22,55,40.0,24,37,64.9,8,25,33,16,23,23,16,4,4,4,72,Żubry Białystok,Sezon 2009/2010
2009-12-12 15:30,Asseco Prokom 2 Gdynia(w),95 : 97W,97,17,33,51.5,16,36,44.4,33,69,47.8,15,19,78.9,14,19,33,23,21,17,11,2,5,3,109,Żubry Białystok,Sezon 2009/2010
2009-12-16 18:00,PTG Sokół Łańcut(w),91 : 80P,80,23,44,52.3,7,27,25.9,30,71,42.3,13,23,56.5,12,24,36,15,24,18,8,10,3,1,85,Żubry Białystok,Sezon 2009/2010
2009-12-19 17:00,KS AZS AWF Katowice(d),89 : 78W,89,14,31,45.2,14,30,46.7,28,61,45.9,19,24,79.2,9,31,40,22,12,15,18,6,3,1,104,Żubry Białystok,Sezon 2009/2010
2010-01-10 17:00,Spójnia Stargard Szcz.(d),69 : 91P,69,17,35,48.6,9,27,33.3,26,62,41.9,8,13,61.5,6,19,25,16,19,17,24,10,0,5,55,Żubry Białystok,Sezon 2009/2010
2010-01-17 17:00,Intermarche Zastal Zielona Góra(w),58 : 63W,63,12,26,46.2,7,23,30.4,19,49,38.8,18,31,58.1,5,32,37,12,19,24,19,14,3,3,67,Żubry Białystok,Sezon 2009/2010
2010-01-20 17:00,ŁKS Łódź(d),73 : 68W,73,12,29,41.4,13,31,41.9,25,60,41.7,10,15,66.7,6,24,30,15,22,16,12,7,7,1,80,Żubry Białystok,Sezon 2009/2010
2010-01-23 18:00,MKS Dąbrowa Górnicza(w),72 : 56P,56,10,26,38.5,8,30,26.7,18,56,32.1,12,21,57.1,13,21,34,9,27,22,18,5,0,5,39,Żubry Białystok,Sezon 2009/2010
2010-01-30 17:00,AZS Politechnika Warszawska(d),82 : 83P,82,25,46,54.3,5,18,27.8,30,64,46.9,17,26,65.4,10,21,31,16,18,20,18,11,3,2,82,Żubry Białystok,Sezon 2009/2010
2010-02-03 18:30,MKS Start Lublin(w),74 : 68P,68,14,40,35.0,8,30,26.7,22,70,31.4,16,23,69.6,15,23,38,15,27,22,15,14,5,3,70,Żubry Białystok,Sezon 2009/2010
2010-02-06 17:00,Siarka Tarnobrzeg(d),75 : 76P,75,18,33,54.5,6,24,25.0,24,57,42.1,21,32,65.6,10,18,28,15,20,27,14,12,4,2,76,Żubry Białystok,Sezon 2009/2010
2010-02-10 19:00,GKS Tychy(w),93 : 74P,74,15,41,36.6,12,31,38.7,27,72,37.5,8,16,50.0,10,21,31,19,13,18,11,9,8,8,77,Żubry Białystok,Sezon 2009/2010
2010-02-13 17:00,PTG Sokół Łańcut(d),70 : 80P,70,14,31,45.2,8,23,34.8,22,54,40.7,18,27,66.7,10,19,29,13,26,29,23,7,5,2,60,Żubry Białystok,Sezon 2009/2010
2010-02-20 17:00,Victoria Górnik Wałbrzych(w),82 : 73P,73,15,33,45.5,10,29,34.5,25,62,40.3,13,17,76.5,13,26,39,9,21,18,24,11,4,8,71,Żubry Białystok,Sezon 2009/2010
2010-02-24 17:00,Miasto Szkła Krosno(d),80 : 73W,80,15,34,44.1,10,23,43.5,25,57,43.9,20,27,74.1,8,20,28,12,14,24,13,5,3,4,76,Żubry Białystok,Sezon 2009/2010
2010-02-27 17:30,KS Sudety Jelenia Góra(w),55 : 59W,59,16,39,41.0,6,18,33.3,22,57,38.6,9,12,75.0,9,24,33,14,16,20,12,6,3,1,65,Żubry Białystok,Sezon 2009/2010
2010-03-06 17:00,Znicz Basket Pruszków(d),62 : 64P,62,17,40,42.5,5,23,21.7,22,63,34.9,13,16,81.3,7,27,34,11,18,17,13,10,4,4,64,Żubry Białystok,Sezon 2009/2010
2010-03-17 17:00,Asseco Prokom 2 Gdynia(d),88 : 90P,88,14,41,34.1,14,30,46.7,28,71,39.4,18,23,78.3,10,26,36,21,23,23,14,6,4,3,93,Żubry Białystok,Sezon 2009/2010
2010-03-20 18:30,KS AZS AWF Katowice(w),75 : 65P,65,20,42,47.6,5,21,23.8,25,63,39.7,10,21,47.6,9,26,35,14,14,21,11,5,6,0,65,Żubry Białystok,Sezon 2009/2010
2010-03-27 17:00,AZS Politechnika Warszawska(d),91 : 68W,91,20,42,47.6,11,23,47.8,31,65,47.7,18,27,66.7,14,23,37,14,22,27,16,8,2,2,93,Żubry Białystok,Sezon 2009/2010
2010-03-31 19:15,AZS Politechnika Warszawska(w),94 : 69P,69,16,35,45.7,9,25,36.0,25,60,41.7,10,21,47.6,9,17,26,9,23,25,24,13,1,6,48,Żubry Białystok,Sezon 2009/2010
2010-04-07 17:00,AZS Politechnika Warszawska(d),82 : 93P,82,17,30,56.7,9,29,31.0,26,59,44.1,21,26,80.8,8,14,22,16,28,23,19,6,5,1,74,Żubry Białystok,Sezon 2009/2010
2009-10-03 16:30,Victoria Górnik Wałbrzych(d),67 : 57W,67,17,40,42.5,6,28,21.4,23,68,33.8,15,21,71.4,14,29,43,14,19,24,17,8,0,6,64,AZS Politechnika Warszawska,Sezon 2009/2010
2009-10-11 18:00,Miasto Szkła Krosno(w),89 : 75P,75,23,37,62.2,6,25,24.0,29,62,46.8,11,15,73.3,10,15,25,8,25,18,10,11,1,2,73,AZS Politechnika Warszawska,Sezon 2009/2010
2009-10-15 18:00,KS Sudety Jelenia Góra(d),79 : 81P,79,20,37,54.1,10,19,52.6,30,56,53.6,9,14,64.3,5,23,28,12,19,19,22,10,2,0,78,AZS Politechnika Warszawska,Sezon 2009/2010
2009-10-21 18:00,Znicz Basket Pruszków(w),91 : 75P,75,18,36,50.0,7,27,25.9,25,63,39.7,18,26,69.2,8,23,31,15,27,24,15,13,0,1,73,AZS Politechnika Warszawska,Sezon 2009/2010
2009-10-24 15:00,Żubry Białystok(d),76 : 65W,76,17,36,47.2,8,23,34.8,25,59,42.4,18,24,75.0,8,18,26,19,24,19,19,17,2,4,81,AZS Politechnika Warszawska,Sezon 2009/2010
2009-10-28 18:30,KS AZS AWF Katowice(w),81 : 89W,89,18,36,50.0,16,29,55.2,34,65,52.3,5,9,55.6,9,28,37,18,20,16,15,5,2,2,101,AZS Politechnika Warszawska,Sezon 2009/2010
2009-11-11 18:00,Intermarche Zastal Zielona Góra(w),90 : 85P,85,20,42,47.6,9,25,36.0,29,67,43.3,18,24,75.0,7,25,32,13,23,21,12,10,1,5,85,AZS Politechnika Warszawska,Sezon 2009/2010
2009-11-18 16:00,ŁKS Łódź(d),82 : 71W,82,19,37,51.4,11,24,45.8,30,61,49.2,11,16,68.8,8,34,42,12,21,18,26,9,3,3,86,AZS Politechnika Warszawska,Sezon 2009/2010
2009-11-21 18:00,MKS Dąbrowa Górnicza(w),96 : 87P,87,19,44,43.2,10,21,47.6,29,65,44.6,19,28,67.9,8,22,30,10,17,20,10,6,1,1,79,AZS Politechnika Warszawska,Sezon 2009/2010
2009-11-25 18:15,Asseco Prokom 2 Gdynia(d),68 : 79P,68,13,31,41.9,10,33,30.3,23,64,35.9,12,14,85.7,7,23,30,12,19,21,21,11,3,2,60,AZS Politechnika Warszawska,Sezon 2009/2010
2009-12-05 18:00,Siarka Tarnobrzeg(w),80 : 68P,68,16,31,51.6,8,16,50.0,24,47,51.1,12,16,75.0,7,27,34,16,23,18,30,2,2,3,65,AZS Politechnika Warszawska,Sezon 2009/2010
2009-12-08 19:00,Spójnia Stargard Szcz.(d),79 : 81P,79,21,41,51.2,9,30,30.0,30,71,42.3,10,18,55.6,13,23,36,20,26,19,16,11,4,7,85,AZS Politechnika Warszawska,Sezon 2009/2010
2009-12-12 15:00,GKS Tychy(d),56 : 74P,56,11,34,32.4,7,28,25.0,18,62,29.0,13,15,86.7,13,24,37,12,17,14,22,6,2,2,45,AZS Politechnika Warszawska,Sezon 2009/2010
2009-12-19 17:30,PTG Sokół Łańcut(w),85 : 79P,79,12,25,48.0,13,24,54.2,25,49,51.0,16,21,76.2,4,25,29,19,29,20,22,8,0,1,84,AZS Politechnika Warszawska,Sezon 2009/2010
2010-01-05 19:30,MKS Start Lublin(d),64 : 60W,64,12,34,35.3,8,22,36.4,20,56,35.7,16,30,53.3,8,32,40,11,21,24,26,10,4,1,53,AZS Politechnika Warszawska,Sezon 2009/2010
2010-01-09 16:00,Victoria Górnik Wałbrzych(w),101 : 100P,100,22,36,61.1,15,30,50.0,37,66,56.1,11,16,68.8,9,18,27,17,22,20,12,14,0,0,112,AZS Politechnika Warszawska,Sezon 2009/2010
2010-01-16 15:00,Miasto Szkła Krosno(d),70 : 72P,70,13,31,41.9,11,27,40.7,24,58,41.4,11,22,50.0,10,20,30,17,19,19,19,11,1,1,65,AZS Politechnika Warszawska,Sezon 2009/2010
2010-01-20 18:00,KS Sudety Jelenia Góra(w),65 : 74W,74,13,26,50.0,10,27,37.0,23,53,43.4,18,27,66.7,12,25,37,16,19,26,13,5,0,2,80,AZS Politechnika Warszawska,Sezon 2009/2010
2010-01-23 15:00,Znicz Basket Pruszków(d),62 : 71P,62,11,30,36.7,3,30,10.0,14,60,23.3,31,43,72.1,19,26,45,10,32,34,30,12,2,3,43,AZS Politechnika Warszawska,Sezon 2009/2010
2010-01-30 17:00,Żubry Białystok(w),82 : 83W,83,22,35,62.9,9,28,32.1,31,63,49.2,12,20,60.0,11,21,32,16,21,18,22,12,2,3,83,AZS Politechnika Warszawska,Sezon 2009/2010
2010-02-03 19:00,KS AZS AWF Katowice(d),98 : 90W,98,18,42,42.9,16,38,42.1,34,80,42.5,14,22,63.6,19,23,42,27,31,23,26,13,2,3,102,AZS Politechnika Warszawska,Sezon 2009/2010
2010-02-06 17:00,Spójnia Stargard Szcz.(w),83 : 73P,73,20,35,57.1,7,27,25.9,27,62,43.5,12,19,63.2,8,20,28,14,23,17,12,5,3,2,69,AZS Politechnika Warszawska,Sezon 2009/2010
2010-02-10 15:00,Intermarche Zastal Zielona Góra(d),69 : 87P,69,18,44,40.9,5,28,17.9,23,72,31.9,18,26,69.2,17,24,41,15,21,20,11,6,1,6,64,AZS Politechnika Warszawska,Sezon 2009/2010
2010-02-13 17:30,ŁKS Łódź(w),67 : 55P,55,19,40,47.5,4,17,23.5,23,57,40.4,5,14,35.7,10,24,34,7,17,16,14,6,2,1,47,AZS Politechnika Warszawska,Sezon 2009/2010
2010-02-17 19:00,GKS Tychy(w),103 : 101P,101,27,38,71.1,13,26,50.0,40,64,62.5,8,16,50.0,10,21,31,22,19,20,20,12,1,1,115,AZS Politechnika Warszawska,Sezon 2009/2010
2010-02-20 18:00,MKS Dąbrowa Górnicza(d),75 : 69W,75,17,29,58.6,10,30,33.3,27,59,45.8,11,21,52.4,5,28,33,11,22,20,21,13,1,3,70,AZS Politechnika Warszawska,Sezon 2009/2010
2010-02-24 15:30,Asseco Prokom 2 Gdynia(w),101 : 74P,74,22,57,38.6,7,21,33.3,29,78,37.2,9,9,100.0,9,19,28,11,23,16,13,9,2,8,62,AZS Politechnika Warszawska,Sezon 2009/2010
2010-02-27 18:30,MKS Start Lublin(w),83 : 61P,61,14,31,45.2,8,29,27.6,22,60,36.7,9,19,47.4,6,24,30,17,16,17,19,14,3,6,58,AZS Politechnika Warszawska,Sezon 2009/2010
2010-03-03 18:00,Siarka Tarnobrzeg(d),76 : 88P,76,17,29,58.6,10,30,33.3,27,59,45.8,12,14,85.7,6,22,28,17,30,18,21,11,0,3,77,AZS Politechnika Warszawska,Sezon 2009/2010
2010-03-10 18:00,PTG Sokół Łańcut(d),93 : 96P,93,23,46,50.0,12,40,30.0,35,86,40.7,11,15,73.3,15,36,51,22,36,18,16,7,3,0,105,AZS Politechnika Warszawska,Sezon 2009/2010
2010-03-27 17:00,Żubry Białystok(w),91 : 68P,68,17,33,51.5,4,17,23.5,21,50,42.0,22,30,73.3,8,20,28,12,26,22,19,9,2,1,63,AZS Politechnika Warszawska,Sezon 2009/2010
2010-03-31 19:15,Żubry Białystok(d),94 : 69W,94,22,33,66.7,11,28,39.3,33,61,54.1,17,24,70.8,11,22,33,17,25,21,18,14,6,1,111,AZS Politechnika Warszawska,Sezon 2009/2010
2010-04-07 17:00,Żubry Białystok(w),82 : 93W,93,21,33,63.6,10,23,43.5,31,56,55.4,21,30,70.0,10,20,30,7,23,28,17,11,1,5,91,AZS Politechnika Warszawska,Sezon 2009/2010
2009-10-03 18:00,KS AZS AWF Katowice(w),76 : 73P,73,17,35,48.6,7,22,31.8,24,57,42.1,18,29,62.1,11,24,35,10,20,27,15,13,3,4,75,Asseco Prokom 2 Gdynia,Sezon 2009/2010
2009-10-10 17:00,GKS Tychy(d),75 : 79P,75,22,47,46.8,5,13,38.5,27,60,45.0,16,23,69.6,10,24,34,9,13,22,16,8,3,3,73,Asseco Prokom 2 Gdynia,Sezon 2009/2010
2009-10-14 18:00,Spójnia Stargard Szcz.(w),77 : 68P,68,22,51,43.1,3,17,17.6,25,68,36.8,15,23,65.2,11,28,39,9,15,24,14,5,0,1,56,Asseco Prokom 2 Gdynia,Sezon 2009/2010
2009-10-17 13:00,PTG Sokół Łańcut(d),102 : 98W,102,36,55,65.5,3,14,21.4,39,69,56.5,21,27,77.8,6,32,38,17,25,27,17,9,2,1,115,Asseco Prokom 2 Gdynia,Sezon 2009/2010
2009-11-08 17:00,ŁKS Łódź(w),87 : 68P,68,18,42,42.9,2,8,25.0,20,50,40.0,26,39,66.7,5,24,29,7,20,27,14,7,4,1,58,Asseco Prokom 2 Gdynia,Sezon 2009/2010
2009-11-11 16:30,Miasto Szkła Krosno(d),88 : 64W,88,27,54,50.0,5,13,38.5,32,67,47.8,19,21,90.5,11,27,38,15,13,20,12,11,4,1,107,Asseco Prokom 2 Gdynia,Sezon 2009/2010
2009-11-14 17:00,Intermarche Zastal Zielona Góra(w),80 : 59P,59,18,41,43.9,2,16,12.5,20,57,35.1,17,26,65.4,12,27,39,10,21,19,19,8,2,1,53,Asseco Prokom 2 Gdynia,Sezon 2009/2010
2009-11-17 18:00,MKS Dąbrowa Górnicza(w),77 : 60P,60,20,44,45.5,2,8,25.0,22,52,42.3,14,26,53.8,9,18,27,5,22,19,13,9,2,4,48,Asseco Prokom 2 Gdynia,Sezon 2009/2010
2009-11-25 18:15,AZS Politechnika Warszawska(w),68 : 79W,79,25,47,53.2,6,18,33.3,31,65,47.7,11,14,78.6,9,30,39,19,21,19,19,13,2,3,96,Asseco Prokom 2 Gdynia,Sezon 2009/2010
2009-11-29 18:00,Znicz Basket Pruszków(d),100 : 89W,100,29,39,74.4,5,19,26.3,34,58,58.6,27,32,84.4,8,23,31,21,20,28,18,12,0,1,117,Asseco Prokom 2 Gdynia,Sezon 2009/2010
2009-12-05 18:30,MKS Start Lublin(w),80 : 63P,63,18,38,47.4,4,20,20.0,22,58,37.9,15,28,53.6,9,29,38,15,18,21,23,8,2,0,54,Asseco Prokom 2 Gdynia,Sezon 2009/2010
2009-12-09 15:00,Victoria Górnik Wałbrzych(d),118 : 114W,118,37,69,53.6,7,17,41.2,44,86,51.2,23,27,85.2,16,34,50,18,19,24,14,8,7,3,141,Asseco Prokom 2 Gdynia,Sezon 2009/2010
2009-12-12 15:30,Żubry Białystok(d),95 : 97P,95,32,54,59.3,3,14,21.4,35,68,51.5,22,26,84.6,11,22,33,18,17,21,10,5,3,5,107,Asseco Prokom 2 Gdynia,Sezon 2009/2010
2009-12-16 15:00,KS Sudety Jelenia Góra(d),91 : 70W,91,30,50,60.0,5,24,20.8,35,74,47.3,16,17,94.1,13,30,43,15,16,19,14,10,9,2,114,Asseco Prokom 2 Gdynia,Sezon 2009/2010
2010-01-10 16:30,KS AZS AWF Katowice(d),94 : 59W,94,28,41,68.3,4,14,28.6,32,55,58.2,26,33,78.8,8,32,40,21,17,24,20,14,6,3,125,Asseco Prokom 2 Gdynia,Sezon 2009/2010
2010-01-16 18:00,GKS Tychy(w),89 : 81P,81,19,35,54.3,7,16,43.8,26,51,51.0,22,30,73.3,3,21,24,11,22,20,21,9,3,0,74,Asseco Prokom 2 Gdynia,Sezon 2009/2010
2010-01-20 17:00,Spójnia Stargard Szcz.(d),75 : 78P,75,23,44,52.3,3,15,20.0,26,59,44.1,20,25,80.0,8,21,29,12,19,23,20,7,2,4,67,Asseco Prokom 2 Gdynia,Sezon 2009/2010
2010-01-23 17:30,PTG Sokół Łańcut(w),61 : 66W,66,16,34,47.1,6,20,30.0,22,54,40.7,16,26,61.5,7,25,32,14,27,25,13,12,2,2,71,Asseco Prokom 2 Gdynia,Sezon 2009/2010
2010-01-31 15:00,Intermarche Zastal Zielona Góra(d),74 : 79P,74,16,38,42.1,6,17,35.3,22,55,40.0,24,29,82.8,9,23,32,13,25,26,20,9,1,2,71,Asseco Prokom 2 Gdynia,Sezon 2009/2010
2010-02-03 18:00,Victoria Górnik Wałbrzych(w),77 : 76P,76,19,36,52.8,8,21,38.1,27,57,47.4,14,21,66.7,8,32,40,15,20,17,16,7,0,4,85,Asseco Prokom 2 Gdynia,Sezon 2009/2010
2010-02-10 18:00,Miasto Szkła Krosno(w),79 : 76P,76,21,45,46.7,8,22,36.4,29,67,43.3,10,22,45.5,12,21,33,9,17,22,13,11,2,3,68,Asseco Prokom 2 Gdynia,Sezon 2009/2010
2010-02-14 16:00,MKS Dąbrowa Górnicza(d),83 : 96P,83,31,62,50.0,5,14,35.7,36,76,47.4,6,9,66.7,11,32,43,15,21,15,15,4,10,7,97,Asseco Prokom 2 Gdynia,Sezon 2009/2010
2010-02-20 16:00,KS Sudety Jelenia Góra(w),65 : 75W,75,22,40,55.0,4,17,23.5,26,57,45.6,19,29,65.5,12,27,39,13,16,21,5,3,5,2,89,Asseco Prokom 2 Gdynia,Sezon 2009/2010
2010-02-24 15:30,AZS Politechnika Warszawska(d),101 : 74W,101,34,55,61.8,2,12,16.7,36,67,53.7,27,33,81.8,6,38,44,16,17,22,16,8,8,2,124,Asseco Prokom 2 Gdynia,Sezon 2009/2010
2010-02-27 16:00,Znicz Basket Pruszków(w),89 : 78P,78,23,43,53.5,5,15,33.3,28,58,48.3,17,22,77.3,14,20,34,7,20,21,20,10,3,3,77,Asseco Prokom 2 Gdynia,Sezon 2009/2010
2010-03-03 15:00,MKS Start Lublin(d),84 : 83W,84,24,49,49.0,6,25,24.0,30,74,40.5,18,19,94.7,9,36,45,17,18,17,10,4,5,1,100,Asseco Prokom 2 Gdynia,Sezon 2009/2010
2010-03-17 17:00,Żubry Białystok(w),88 : 90W,90,20,52,38.5,9,19,47.4,29,71,40.8,23,30,76.7,7,26,33,12,23,22,15,9,3,4,83,Asseco Prokom 2 Gdynia,Sezon 2009/2010
2010-03-21 16:00,Siarka Tarnobrzeg(d),98 : 93W,98,22,40,55.0,7,19,36.8,29,59,49.2,33,44,75.0,11,25,36,18,30,30,12,4,6,0,109,Asseco Prokom 2 Gdynia,Sezon 2009/2010
2010-03-27 15:00,KS AZS AWF Katowice(d),109 : 102W,109,33,58,56.9,9,24,37.5,42,82,51.2,16,20,80.0,17,25,42,15,23,19,11,9,5,4,125,Asseco Prokom 2 Gdynia,Sezon 2009/2010
2010-03-31 18:30,KS AZS AWF Katowice(w),61 : 66W,66,22,41,53.7,6,27,22.2,28,68,41.2,4,6,66.7,14,21,35,8,16,15,10,13,0,3,70,Asseco Prokom 2 Gdynia,Sezon 2009/2010
2009-10-03 19:00,MKS Start Lublin(w),69 : 76W,76,16,33,48.5,10,23,43.5,26,56,46.4,14,24,58.3,7,21,28,12,22,23,12,9,1,1,74,PTG Sokół Łańcut,Sezon 2009/2010
2009-10-10 17:30,Siarka Tarnobrzeg(d),81 : 74W,81,17,29,58.6,7,18,38.9,24,47,51.1,26,30,86.7,3,20,23,16,21,24,19,17,1,3,92,PTG Sokół Łańcut,Sezon 2009/2010
2009-10-14 19:00,GKS Tychy(w),68 : 75W,75,20,38,52.6,5,18,27.8,25,56,44.6,20,26,76.9,10,29,39,9,20,23,16,6,0,4,76,PTG Sokół Łańcut,Sezon 2009/2010
2009-10-17 13:00,Asseco Prokom 2 Gdynia(w),102 : 98P,98,22,40,55.0,13,36,36.1,35,76,46.1,15,23,65.2,7,23,30,18,27,25,15,12,1,2,95,PTG Sokół Łańcut,Sezon 2009/2010
2009-10-24 17:30,Victoria Górnik Wałbrzych(d),72 : 66W,72,16,35,45.7,9,19,47.4,25,54,46.3,13,16,81.3,7,25,32,13,17,21,15,9,1,0,80,PTG Sokół Łańcut,Sezon 2009/2010
2009-10-28 18:00,Miasto Szkła Krosno(w),69 : 64P,64,19,35,54.3,3,23,13.0,22,58,37.9,17,22,77.3,11,13,24,7,22,20,12,11,2,3,55,PTG Sokół Łańcut,Sezon 2009/2010
2009-11-07 17:30,KS Sudety Jelenia Góra(d),102 : 86W,102,23,32,71.9,14,27,51.9,37,59,62.7,14,20,70.0,5,18,23,20,16,19,9,11,2,1,121,PTG Sokół Łańcut,Sezon 2009/2010
2009-11-11 18:00,Znicz Basket Pruszków(d),64 : 55W,64,9,22,40.9,8,25,32.0,17,47,36.2,22,27,81.5,7,21,28,14,16,26,19,12,0,0,64,PTG Sokół Łańcut,Sezon 2009/2010
2009-11-21 18:00,KS AZS AWF Katowice(w),67 : 63P,63,23,35,65.7,1,14,7.1,24,49,49.0,14,18,77.8,9,18,27,5,15,17,26,9,1,3,50,PTG Sokół Łańcut,Sezon 2009/2010
2009-12-05 17:30,ŁKS Łódź(d),79 : 71W,79,14,22,63.6,6,20,30.0,20,42,47.6,33,39,84.6,6,25,31,7,23,35,17,13,1,1,86,PTG Sokół Łańcut,Sezon 2009/2010
2009-12-09 18:00,Intermarche Zastal Zielona Góra(w),81 : 73P,73,10,29,34.5,12,32,37.5,22,61,36.1,17,27,63.0,10,23,33,12,23,24,9,12,1,7,73,PTG Sokół Łańcut,Sezon 2009/2010
2009-12-13 17:30,MKS Dąbrowa Górnicza(d),62 : 77P,62,11,25,44.0,7,21,33.3,18,46,39.1,19,26,73.1,6,25,31,10,23,21,17,9,1,4,61,PTG Sokół Łańcut,Sezon 2009/2010
2009-12-16 18:00,Żubry Białystok(d),91 : 80W,91,21,35,60.0,9,20,45.0,30,55,54.5,22,29,75.9,5,31,36,22,18,24,12,6,1,3,112,PTG Sokół Łańcut,Sezon 2009/2010
2009-12-19 17:30,AZS Politechnika Warszawska(d),85 : 79W,85,16,32,50.0,9,26,34.6,25,58,43.1,26,36,72.2,11,17,28,12,20,29,12,16,1,0,87,PTG Sokół Łańcut,Sezon 2009/2010
2009-12-21 18:00,Spójnia Stargard Szcz.(d),73 : 65W,73,12,25,48.0,10,29,34.5,22,54,40.7,19,28,67.9,5,26,31,13,20,27,15,13,1,2,75,PTG Sokół Łańcut,Sezon 2009/2010
2010-01-09 17:30,MKS Start Lublin(d),72 : 59W,72,14,23,60.9,10,39,25.6,24,62,38.7,14,19,73.7,13,23,36,13,21,22,17,20,2,3,83,PTG Sokół Łańcut,Sezon 2009/2010
2010-01-17 17:00,Siarka Tarnobrzeg(w),79 : 50P,50,14,42,33.3,5,25,20.0,19,67,28.4,7,11,63.6,13,18,31,10,16,23,20,11,3,8,33,PTG Sokół Łańcut,Sezon 2009/2010
2010-01-20 18:00,GKS Tychy(d),62 : 65P,62,8,22,36.4,5,29,17.2,13,51,25.5,31,36,86.1,8,28,36,9,19,30,18,12,3,3,61,PTG Sokół Łańcut,Sezon 2009/2010
2010-01-23 17:30,Asseco Prokom 2 Gdynia(d),61 : 66P,61,14,34,41.2,5,25,20.0,19,59,32.2,18,28,64.3,11,23,34,6,25,27,15,10,2,2,48,PTG Sokół Łańcut,Sezon 2009/2010
2010-01-30 16:00,Victoria Górnik Wałbrzych(w),76 : 67P,67,20,31,64.5,6,24,25.0,26,55,47.3,9,20,45.0,11,25,36,11,18,19,18,7,0,3,63,PTG Sokół Łańcut,Sezon 2009/2010
2010-02-03 18:00,Miasto Szkła Krosno(d),75 : 64W,75,19,29,65.5,8,26,30.8,27,55,49.1,13,21,61.9,13,24,37,18,23,24,17,14,2,2,93,PTG Sokół Łańcut,Sezon 2009/2010
2010-02-06 17:30,KS Sudety Jelenia Góra(w),72 : 69P,69,16,35,45.7,10,26,38.5,26,61,42.6,7,11,63.6,9,21,30,16,20,19,10,7,0,2,73,PTG Sokół Łańcut,Sezon 2009/2010
2010-02-10 18:00,Znicz Basket Pruszków(w),72 : 58P,58,17,29,58.6,5,25,20.0,22,54,40.7,9,12,75.0,8,19,27,11,23,19,22,8,2,2,49,PTG Sokół Łańcut,Sezon 2009/2010
2010-02-13 17:00,Żubry Białystok(w),70 : 80W,80,17,36,47.2,10,22,45.5,27,58,46.6,16,21,76.2,8,23,31,16,29,26,22,10,2,5,81,PTG Sokół Łańcut,Sezon 2009/2010
2010-02-20 17:30,KS AZS AWF Katowice(d),90 : 58W,90,24,39,61.5,9,20,45.0,33,59,55.9,15,21,71.4,8,26,34,21,26,22,11,11,1,2,114,PTG Sokół Łańcut,Sezon 2009/2010
2010-02-24 18:00,Spójnia Stargard Szcz.(w),86 : 77P,77,17,30,56.7,9,19,47.4,26,49,53.1,16,21,76.2,3,21,24,17,22,19,22,8,2,2,78,PTG Sokół Łańcut,Sezon 2009/2010
2010-02-27 17:30,Intermarche Zastal Zielona Góra(d),76 : 86P,76,14,31,45.2,9,26,34.6,23,57,40.4,21,27,77.8,12,25,37,13,20,24,14,12,3,6,87,PTG Sokół Łańcut,Sezon 2009/2010
2010-03-06 17:30,ŁKS Łódź(w),70 : 60P,60,16,30,53.3,4,24,16.7,20,54,37.0,16,26,61.5,10,21,31,6,25,25,17,14,2,0,52,PTG Sokół Łańcut,Sezon 2009/2010
2010-03-10 18:00,AZS Politechnika Warszawska(w),93 : 96W,96,23,48,47.9,7,27,25.9,30,75,40.0,29,41,70.7,10,30,40,10,18,36,14,12,0,3,87,PTG Sokół Łańcut,Sezon 2009/2010
2010-03-16 18:00,MKS Dąbrowa Górnicza(w),75 : 83W,83,25,41,61.0,3,15,20.0,28,56,50.0,24,34,70.6,8,24,32,11,19,27,16,12,1,3,85,PTG Sokół Łańcut,Sezon 2009/2010
2010-03-27 18:00,Intermarche Zastal Zielona Góra(w),87 : 54P,54,11,32,34.4,6,21,28.6,17,53,32.1,14,24,58.3,8,22,30,9,20,20,22,9,3,9,37,PTG Sokół Łańcut,Sezon 2009/2010
2010-03-31 18:00,Intermarche Zastal Zielona Góra(d),76 : 66W,76,18,36,50.0,8,25,32.0,26,61,42.6,16,22,72.7,8,19,27,10,27,28,13,19,1,6,79,PTG Sokół Łańcut,Sezon 2009/2010
2010-04-07 18:00,Intermarche Zastal Zielona Góra(w),84 : 60P,60,15,34,44.1,7,24,29.2,22,58,37.9,9,22,40.9,15,23,38,13,23,21,16,4,1,2,51,PTG Sokół Łańcut,Sezon 2009/2010
2009-10-03 18:00,Intermarche Zastal Zielona Góra(w),59 : 75W,75,20,38,52.6,10,22,45.5,30,60,50.0,5,6,83.3,8,31,39,19,21,16,16,16,4,0,106,Znicz Basket Pruszków,Sezon 2009/2010
2009-10-11 18:00,ŁKS Łódź(d),78 : 74W,78,19,39,48.7,9,18,50.0,28,57,49.1,13,15,86.7,8,20,28,14,27,22,18,14,1,1,86,Znicz Basket Pruszków,Sezon 2009/2010
2009-10-14 18:00,MKS Dąbrowa Górnicza(w),86 : 78P,78,23,39,59.0,8,22,36.4,31,61,50.8,8,13,61.5,9,17,26,13,25,19,21,13,2,1,76,Znicz Basket Pruszków,Sezon 2009/2010
2009-10-21 18:00,AZS Politechnika Warszawska(d),91 : 75W,91,14,34,41.2,11,21,52.4,25,55,45.5,30,41,73.2,9,26,35,13,24,27,20,10,1,0,89,Znicz Basket Pruszków,Sezon 2009/2010
2009-10-24 18:30,MKS Start Lublin(w),67 : 62P,62,16,38,42.1,5,25,20.0,21,63,33.3,15,17,88.2,13,24,37,12,22,19,18,9,3,4,61,Znicz Basket Pruszków,Sezon 2009/2010
2009-10-28 18:00,Siarka Tarnobrzeg(d),63 : 68P,63,20,38,52.6,6,22,27.3,26,60,43.3,5,7,71.4,5,17,22,19,20,16,18,15,4,2,69,Znicz Basket Pruszków,Sezon 2009/2010
2009-11-07 18:00,GKS Tychy(w),94 : 81P,81,22,40,55.0,9,27,33.3,31,67,46.3,10,15,66.7,10,19,29,17,28,18,24,11,1,0,74,Znicz Basket Pruszków,Sezon 2009/2010
2009-11-11 18:00,PTG Sokół Łańcut(w),64 : 55P,55,13,30,43.3,6,23,26.1,19,53,35.8,11,13,84.6,9,22,31,13,27,16,21,16,0,0,58,Znicz Basket Pruszków,Sezon 2009/2010
2009-11-18 18:00,Victoria Górnik Wałbrzych(w),100 : 89P,89,25,39,64.1,2,14,14.3,27,53,50.9,33,36,91.7,5,17,22,4,32,29,15,9,3,0,83,Znicz Basket Pruszków,Sezon 2009/2010
2009-11-22 18:00,Miasto Szkła Krosno(d),77 : 73W,77,24,51,47.1,4,15,26.7,28,66,42.4,17,24,70.8,13,26,39,10,26,28,14,4,3,1,74,Znicz Basket Pruszków,Sezon 2009/2010
2009-11-25 18:00,KS Sudety Jelenia Góra(w),62 : 65W,65,23,47,48.9,3,12,25.0,26,59,44.1,10,17,58.8,7,31,38,12,18,20,12,9,4,2,76,Znicz Basket Pruszków,Sezon 2009/2010
2009-11-29 18:00,Asseco Prokom 2 Gdynia(w),100 : 89P,89,31,43,72.1,5,23,21.7,36,66,54.5,12,15,80.0,5,16,21,16,28,20,15,7,1,0,86,Znicz Basket Pruszków,Sezon 2009/2010
2009-12-06 18:00,Żubry Białystok(d),78 : 77W,78,23,53,43.4,5,14,35.7,28,67,41.8,17,22,77.3,10,21,31,14,23,23,12,11,4,4,82,Znicz Basket Pruszków,Sezon 2009/2010
2009-12-12 18:30,KS AZS AWF Katowice(w),74 : 83W,83,24,43,55.8,6,17,35.3,30,60,50.0,17,21,81.0,8,24,32,18,26,22,13,7,2,3,95,Znicz Basket Pruszków,Sezon 2009/2010
2009-12-19 18:00,Spójnia Stargard Szcz.(d),63 : 84P,63,15,32,46.9,8,24,33.3,23,56,41.1,9,18,50.0,10,18,28,9,21,24,23,9,5,1,49,Znicz Basket Pruszków,Sezon 2009/2010
2010-01-10 18:00,Intermarche Zastal Zielona Góra(d),71 : 78P,71,23,44,52.3,5,18,27.8,28,62,45.2,10,15,66.7,13,22,35,9,24,21,17,6,4,2,69,Znicz Basket Pruszków,Sezon 2009/2010
2010-01-13 19:00,MKS Dąbrowa Górnicza(d),66 : 77P,66,16,37,43.2,6,14,42.9,22,51,43.1,16,20,80.0,8,19,27,15,21,21,20,13,2,2,70,Znicz Basket Pruszków,Sezon 2009/2010
2010-01-17 17:00,ŁKS Łódź(w),88 : 82P,82,19,36,52.8,9,23,39.1,28,59,47.5,17,19,89.5,7,23,30,18,27,20,10,9,3,3,99,Znicz Basket Pruszków,Sezon 2009/2010
2010-01-23 15:00,AZS Politechnika Warszawska(w),62 : 71W,71,20,38,52.6,4,13,30.8,24,51,47.1,19,34,55.9,2,24,26,12,34,32,18,13,3,2,65,Znicz Basket Pruszków,Sezon 2009/2010
2010-01-30 18:00,MKS Start Lublin(d),80 : 83P,80,16,28,57.1,11,31,35.5,27,59,45.8,15,21,71.4,9,19,28,18,24,21,11,7,1,0,85,Znicz Basket Pruszków,Sezon 2009/2010
2010-02-03 18:00,Siarka Tarnobrzeg(w),79 : 57P,57,13,38,34.2,7,21,33.3,20,59,33.9,10,15,66.7,9,18,27,12,20,20,19,7,5,5,45,Znicz Basket Pruszków,Sezon 2009/2010
2010-02-06 18:00,GKS Tychy(d),75 : 68W,75,25,40,62.5,2,12,16.7,27,52,51.9,19,27,70.4,6,24,30,14,18,21,17,14,4,1,87,Znicz Basket Pruszków,Sezon 2009/2010
2010-02-10 18:00,PTG Sokół Łańcut(d),72 : 58W,72,20,41,48.8,4,14,28.6,24,55,43.6,20,23,87.0,10,22,32,14,19,23,19,13,2,2,80,Znicz Basket Pruszków,Sezon 2009/2010
2010-02-14 16:00,Victoria Górnik Wałbrzych(d),86 : 64W,86,27,40,67.5,7,20,35.0,34,60,56.7,11,16,68.8,10,23,33,24,18,18,13,11,2,2,112,Znicz Basket Pruszków,Sezon 2009/2010
2010-02-17 19:00,KS AZS AWF Katowice(d),81 : 67W,81,32,53,60.4,1,9,11.1,33,62,53.2,14,26,53.8,10,28,38,13,21,21,13,9,4,5,91,Znicz Basket Pruszków,Sezon 2009/2010
2010-02-21 18:00,Miasto Szkła Krosno(w),95 : 63P,63,20,37,54.1,4,19,21.1,24,56,42.9,11,20,55.0,9,16,25,12,23,22,22,13,2,2,52,Znicz Basket Pruszków,Sezon 2009/2010
2010-02-24 18:00,KS Sudety Jelenia Góra(d),74 : 62W,74,8,26,30.8,15,34,44.1,23,60,38.3,13,16,81.3,12,22,34,21,18,20,13,8,4,1,88,Znicz Basket Pruszków,Sezon 2009/2010
2010-02-27 16:00,Asseco Prokom 2 Gdynia(d),89 : 78W,89,27,43,62.8,7,22,31.8,34,65,52.3,14,21,66.7,11,17,28,16,21,20,12,17,3,3,103,Znicz Basket Pruszków,Sezon 2009/2010
2010-03-06 17:00,Żubry Białystok(w),62 : 64W,64,15,41,36.6,9,27,33.3,24,68,35.3,7,9,77.8,15,27,42,10,18,18,19,3,4,4,58,Znicz Basket Pruszków,Sezon 2009/2010
2010-03-21 18:00,Spójnia Stargard Szcz.(w),68 : 72W,72,20,38,52.6,6,21,28.6,26,59,44.1,14,19,73.7,12,22,34,11,16,18,17,6,4,3,72,Znicz Basket Pruszków,Sezon 2009/2010
2010-03-27 18:00,Siarka Tarnobrzeg(w),70 : 58P,58,19,35,54.3,3,15,20.0,22,50,44.0,11,23,47.8,8,24,32,8,23,21,18,6,1,1,47,Znicz Basket Pruszków,Sezon 2009/2010
2010-04-01 18:00,Siarka Tarnobrzeg(d),47 : 74P,47,15,37,40.5,4,21,19.0,19,58,32.8,5,10,50.0,9,19,28,6,22,15,20,14,2,1,33,Znicz Basket Pruszków,Sezon 2009/2010
2009-10-03 18:00,MKS Dąbrowa Górnicza(w),50 : 44P,44,15,38,39.5,4,18,22.2,19,56,33.9,2,4,50.0,6,28,34,7,19,13,13,7,1,6,41,Miasto Szkła Krosno,Sezon 2009/2010
2009-10-11 18:00,AZS Politechnika Warszawska(d),89 : 75W,89,22,34,64.7,8,17,47.1,30,51,58.8,21,36,58.3,11,21,32,19,19,25,14,8,2,1,100,Miasto Szkła Krosno,Sezon 2009/2010
2009-10-14 18:30,MKS Start Lublin(w),71 : 62P,62,14,32,43.8,6,23,26.1,20,55,36.4,16,23,69.6,7,25,32,8,25,20,13,3,5,2,55,Miasto Szkła Krosno,Sezon 2009/2010
2009-10-21 18:00,Siarka Tarnobrzeg(d),57 : 76P,57,15,32,46.9,5,14,35.7,20,46,43.5,12,20,60.0,7,18,25,11,19,19,11,10,1,2,59,Miasto Szkła Krosno,Sezon 2009/2010
2009-10-24 18:00,GKS Tychy(w),72 : 59P,59,16,35,45.7,5,20,25.0,21,55,38.2,12,18,66.7,8,18,26,10,17,21,14,13,3,3,57,Miasto Szkła Krosno,Sezon 2009/2010
2009-10-28 18:00,PTG Sokół Łańcut(d),69 : 64W,69,21,39,53.8,4,23,17.4,25,62,40.3,15,21,71.4,16,26,42,10,21,20,14,10,3,2,77,Miasto Szkła Krosno,Sezon 2009/2010
2009-11-07 17:00,Victoria Górnik Wałbrzych(w),56 : 86W,86,25,44,56.8,8,18,44.4,33,62,53.2,12,17,70.6,13,33,46,18,17,20,17,10,3,3,112,Miasto Szkła Krosno,Sezon 2009/2010
2009-11-11 16:30,Asseco Prokom 2 Gdynia(w),88 : 64P,64,19,43,44.2,7,24,29.2,26,67,38.8,5,8,62.5,6,15,21,9,20,13,16,9,1,4,44,Miasto Szkła Krosno,Sezon 2009/2010
2009-11-18 18:00,KS Sudety Jelenia Góra(d),89 : 39W,89,19,37,51.4,13,27,48.1,32,64,50.0,12,16,75.0,13,35,48,20,21,16,7,12,5,2,131,Miasto Szkła Krosno,Sezon 2009/2010
2009-11-22 18:00,Znicz Basket Pruszków(w),77 : 73P,73,14,35,40.0,7,21,33.3,21,56,37.5,24,31,77.4,8,21,29,11,28,26,10,9,1,3,71,Miasto Szkła Krosno,Sezon 2009/2010
2009-11-25 18:00,Żubry Białystok(d),59 : 95P,59,13,34,38.2,7,21,33.3,20,55,36.4,12,17,70.6,7,24,31,10,21,18,22,4,2,5,44,Miasto Szkła Krosno,Sezon 2009/2010
2009-11-28 18:30,KS AZS AWF Katowice(w),67 : 82W,82,20,35,57.1,12,24,50.0,32,59,54.2,6,6,100.0,4,21,25,14,26,17,11,7,0,1,90,Miasto Szkła Krosno,Sezon 2009/2010
2009-12-06 18:00,Spójnia Stargard Szcz.(d),77 : 73W,77,18,31,58.1,10,18,55.6,28,49,57.1,11,15,73.3,6,21,27,19,14,19,14,6,2,1,92,Miasto Szkła Krosno,Sezon 2009/2010
2009-12-13 17:00,Intermarche Zastal Zielona Góra(w),86 : 64P,64,19,36,52.8,5,20,25.0,24,56,42.9,11,16,68.8,5,17,22,11,15,18,13,10,3,4,60,Miasto Szkła Krosno,Sezon 2009/2010
2009-12-20 18:00,ŁKS Łódź(d),72 : 73P,72,16,29,55.2,10,22,45.5,26,51,51.0,10,13,76.9,3,23,26,12,27,20,22,8,4,0,72,Miasto Szkła Krosno,Sezon 2009/2010
2010-01-10 18:00,MKS Dąbrowa Górnicza(d),49 : 67P,49,10,30,33.3,8,20,40.0,18,50,36.0,5,12,41.7,4,25,29,14,18,15,15,5,4,2,47,Miasto Szkła Krosno,Sezon 2009/2010
2010-01-16 15:00,AZS Politechnika Warszawska(w),70 : 72W,72,24,39,61.5,5,16,31.3,29,55,52.7,9,26,34.6,13,21,34,8,21,19,18,8,1,1,62,Miasto Szkła Krosno,Sezon 2009/2010
2010-01-20 18:00,MKS Start Lublin(d),72 : 78P,72,23,43,53.5,5,25,20.0,28,68,41.2,11,17,64.7,8,23,31,14,31,22,10,9,1,2,71,Miasto Szkła Krosno,Sezon 2009/2010
2010-01-24 17:00,Siarka Tarnobrzeg(w),74 : 58P,58,15,32,46.9,7,19,36.8,22,51,43.1,7,13,53.8,6,19,25,7,18,17,17,7,0,2,45,Miasto Szkła Krosno,Sezon 2009/2010
2010-01-31 18:00,GKS Tychy(d),80 : 85P,80,18,33,54.5,10,24,41.7,28,57,49.1,14,16,87.5,3,24,27,13,27,18,16,7,4,0,84,Miasto Szkła Krosno,Sezon 2009/2010
2010-02-03 18:00,PTG Sokół Łańcut(w),75 : 64P,64,16,34,47.1,6,25,24.0,22,59,37.3,14,19,73.7,10,15,25,12,24,22,15,14,2,2,60,Miasto Szkła Krosno,Sezon 2009/2010
2010-02-07 18:00,Victoria Górnik Wałbrzych(d),62 : 83P,62,12,34,35.3,10,26,38.5,22,60,36.7,8,12,66.7,6,16,22,14,24,13,13,5,1,2,49,Miasto Szkła Krosno,Sezon 2009/2010
2010-02-10 18:00,Asseco Prokom 2 Gdynia(d),79 : 76W,79,20,41,48.8,9,26,34.6,29,67,43.3,12,16,75.0,14,29,43,13,22,17,17,8,3,2,87,Miasto Szkła Krosno,Sezon 2009/2010
2010-02-13 17:30,KS Sudety Jelenia Góra(w),75 : 73P,73,20,35,57.1,6,22,27.3,26,57,45.6,15,22,68.2,12,24,36,12,25,20,15,5,3,0,76,Miasto Szkła Krosno,Sezon 2009/2010
2010-02-18 18:00,Intermarche Zastal Zielona Góra(d),73 : 77P,73,19,42,45.2,7,18,38.9,26,60,43.3,14,22,63.6,10,15,25,16,24,23,9,10,3,3,76,Miasto Szkła Krosno,Sezon 2009/2010
2010-02-21 18:00,Znicz Basket Pruszków(d),95 : 63W,95,17,30,56.7,13,23,56.5,30,53,56.6,22,27,81.5,5,25,30,16,22,22,18,15,2,2,112,Miasto Szkła Krosno,Sezon 2009/2010
2010-02-24 17:00,Żubry Białystok(w),80 : 73P,73,21,38,55.3,7,19,36.8,28,57,49.1,10,14,71.4,7,19,26,12,24,14,15,9,4,3,76,Miasto Szkła Krosno,Sezon 2009/2010
2010-02-28 18:00,KS AZS AWF Katowice(d),67 : 74P,67,23,44,52.3,5,20,25.0,28,64,43.8,6,12,50.0,10,19,29,16,26,18,9,7,1,0,69,Miasto Szkła Krosno,Sezon 2009/2010
2010-03-03 18:00,Spójnia Stargard Szcz.(w),73 : 64P,64,19,38,50.0,5,19,26.3,24,57,42.1,11,17,64.7,10,23,33,12,21,17,17,7,2,2,62,Miasto Szkła Krosno,Sezon 2009/2010
2010-03-21 16:00,ŁKS Łódź(w),79 : 52P,52,20,45,44.4,1,16,6.3,21,61,34.4,9,13,69.2,11,22,33,8,23,12,18,7,1,0,39,Miasto Szkła Krosno,Sezon 2009/2010
2010-03-27 18:00,Victoria Górnik Wałbrzych(d),76 : 77P,76,25,51,49.0,5,20,25.0,30,71,42.3,11,17,64.7,15,27,42,20,24,19,11,5,1,3,86,Miasto Szkła Krosno,Sezon 2009/2010
2010-03-31 18:00,Victoria Górnik Wałbrzych(w),73 : 77W,77,23,50,46.0,5,17,29.4,28,67,41.8,16,20,80.0,11,27,38,14,17,19,8,7,1,5,86,Miasto Szkła Krosno,Sezon 2009/2010
2010-04-07 18:00,Victoria Górnik Wałbrzych(d),69 : 70P,69,14,40,35.0,11,31,35.5,25,71,35.2,8,15,53.3,13,27,40,19,21,19,10,5,5,5,75,Miasto Szkła Krosno,Sezon 2009/2010
2009-10-02 00:00,KS Sudety Jelenia Góra(d),74 : 86P,74,25,39,64.1,5,22,22.7,30,61,49.2,9,19,47.4,9,16,25,15,22,21,16,13,2,0,72,ŁKS Łódź,Sezon 2009/2010
2009-10-11 18:00,Znicz Basket Pruszków(w),78 : 74P,74,16,31,51.6,7,21,33.3,23,52,44.2,21,28,75.0,6,18,24,16,23,26,19,9,1,1,69,ŁKS Łódź,Sezon 2009/2010
2009-10-18 18:00,Żubry Białystok(d),101 : 60W,101,34,64,53.1,6,9,66.7,40,73,54.8,15,24,62.5,13,34,47,21,22,22,14,14,4,4,131,ŁKS Łódź,Sezon 2009/2010
2009-10-21 18:30,KS AZS AWF Katowice(w),74 : 85W,85,28,52,53.8,5,16,31.3,33,68,48.5,14,17,82.4,11,24,35,16,23,20,13,12,3,5,100,ŁKS Łódź,Sezon 2009/2010
2009-10-25 17:00,Spójnia Stargard Szcz.(d),80 : 83P,80,20,44,45.5,6,14,42.9,26,58,44.8,22,35,62.9,12,16,28,12,22,27,12,9,2,1,74,ŁKS Łódź,Sezon 2009/2010
2009-10-28 18:00,Intermarche Zastal Zielona Góra(w),58 : 53P,53,20,46,43.5,2,14,14.3,22,60,36.7,7,9,77.8,9,26,35,12,19,14,14,10,0,5,56,ŁKS Łódź,Sezon 2009/2010
2009-11-08 17:00,Asseco Prokom 2 Gdynia(d),87 : 68W,87,22,49,44.9,10,25,40.0,32,74,43.2,13,19,68.4,15,27,42,19,27,20,13,8,1,4,96,ŁKS Łódź,Sezon 2009/2010
2009-11-14 17:30,MKS Dąbrowa Górnicza(d),74 : 61W,74,20,48,41.7,4,12,33.3,24,60,40.0,22,28,78.6,13,25,38,11,18,25,15,13,1,4,80,ŁKS Łódź,Sezon 2009/2010
2009-11-18 16:00,AZS Politechnika Warszawska(w),82 : 71P,71,23,55,41.8,5,15,33.3,28,70,40.0,10,22,45.5,7,19,26,11,20,20,13,19,3,3,63,ŁKS Łódź,Sezon 2009/2010
2009-11-21 19:00,MKS Start Lublin(d),80 : 56W,80,21,46,45.7,9,28,32.1,30,74,40.5,11,18,61.1,11,29,40,15,26,18,13,15,3,2,89,ŁKS Łódź,Sezon 2009/2010
2009-11-25 18:00,Siarka Tarnobrzeg(w),70 : 76W,76,17,39,43.6,6,19,31.6,23,58,39.7,24,32,75.0,10,19,29,11,28,26,11,9,2,7,73,ŁKS Łódź,Sezon 2009/2010
2009-11-29 17:00,GKS Tychy(d),74 : 54W,74,17,40,42.5,9,20,45.0,26,60,43.3,13,17,76.5,12,25,37,16,13,16,19,13,1,4,84,ŁKS Łódź,Sezon 2009/2010
2009-12-05 17:30,PTG Sokół Łańcut(w),79 : 71P,71,16,39,41.0,6,25,24.0,22,64,34.4,21,26,80.8,16,12,28,14,35,23,18,15,1,1,64,ŁKS Łódź,Sezon 2009/2010
2009-12-12 19:15,Victoria Górnik Wałbrzych(d),92 : 71W,92,31,53,58.5,8,22,36.4,39,75,52.0,6,13,46.2,11,28,39,25,20,16,11,9,1,4,112,ŁKS Łódź,Sezon 2009/2010
2009-12-20 18:00,Miasto Szkła Krosno(w),72 : 73W,73,18,39,46.2,3,11,27.3,21,50,42.0,28,38,73.7,3,18,21,7,20,27,13,14,0,4,63,ŁKS Łódź,Sezon 2009/2010
2010-01-09 18:00,KS Sudety Jelenia Góra(w),61 : 85W,85,20,40,50.0,6,12,50.0,26,52,50.0,27,33,81.8,9,30,39,13,22,24,17,9,1,2,98,ŁKS Łódź,Sezon 2009/2010
2010-01-17 17:00,Znicz Basket Pruszków(d),88 : 82W,88,20,38,52.6,10,18,55.6,30,56,53.6,18,29,62.1,7,20,27,14,20,27,13,6,3,3,88,ŁKS Łódź,Sezon 2009/2010
2010-01-20 17:00,Żubry Białystok(w),73 : 68P,68,14,46,30.4,9,21,42.9,23,67,34.3,13,22,59.1,15,27,42,14,17,22,11,8,1,6,69,ŁKS Łódź,Sezon 2009/2010
2010-01-30 17:00,Spójnia Stargard Szcz.(w),73 : 78W,78,17,39,43.6,8,23,34.8,25,62,40.3,20,25,80.0,14,22,36,9,15,23,16,9,1,5,75,ŁKS Łódź,Sezon 2009/2010
2010-02-03 19:00,Intermarche Zastal Zielona Góra(d),81 : 88P,81,19,43,44.2,11,20,55.0,30,63,47.6,10,22,45.5,6,22,28,19,22,24,15,5,1,5,74,ŁKS Łódź,Sezon 2009/2010
2010-02-10 18:00,MKS Dąbrowa Górnicza(w),86 : 77P,77,23,42,54.8,6,19,31.6,29,61,47.5,13,22,59.1,7,26,33,19,21,20,17,9,0,5,80,ŁKS Łódź,Sezon 2009/2010
2010-02-13 17:30,AZS Politechnika Warszawska(d),67 : 55W,67,21,38,55.3,5,28,17.9,26,66,39.4,10,16,62.5,14,26,40,15,17,17,9,8,1,2,76,ŁKS Łódź,Sezon 2009/2010
2010-02-17 18:00,Victoria Górnik Wałbrzych(w),80 : 86W,86,25,40,62.5,4,18,22.2,29,58,50.0,24,30,80.0,8,30,38,13,16,25,14,10,0,4,98,ŁKS Łódź,Sezon 2009/2010
2010-02-20 18:30,MKS Start Lublin(w),48 : 71W,71,16,36,44.4,10,27,37.0,26,63,41.3,9,12,75.0,5,23,28,12,18,17,15,19,0,2,75,ŁKS Łódź,Sezon 2009/2010
2010-02-24 19:00,Siarka Tarnobrzeg(d),57 : 72P,57,12,33,36.4,7,28,25.0,19,61,31.1,12,25,48.0,15,20,35,8,26,27,20,13,0,4,38,ŁKS Łódź,Sezon 2009/2010
2010-02-27 18:00,GKS Tychy(w),88 : 61P,61,13,40,32.5,8,22,36.4,21,62,33.9,11,17,64.7,9,23,32,14,16,20,13,4,2,5,53,ŁKS Łódź,Sezon 2009/2010
2010-03-06 17:30,PTG Sokół Łańcut(d),70 : 60W,70,13,28,46.4,8,26,30.8,21,54,38.9,20,28,71.4,9,24,33,11,26,25,18,11,0,2,66,ŁKS Łódź,Sezon 2009/2010
2010-03-12 19:00,KS AZS AWF Katowice(d),90 : 82W,90,21,37,56.8,12,24,50.0,33,61,54.1,12,20,60.0,10,23,33,21,18,22,14,9,0,4,103,ŁKS Łódź,Sezon 2009/2010
2010-03-21 16:00,Miasto Szkła Krosno(d),79 : 52W,79,16,35,45.7,10,27,37.0,26,62,41.9,17,24,70.8,9,24,33,19,12,23,13,13,0,1,88,ŁKS Łódź,Sezon 2009/2010
2010-03-27 18:00,GKS Tychy(w),93 : 77P,77,18,36,50.0,11,24,45.8,29,60,48.3,8,16,50.0,9,20,29,16,18,19,16,7,0,4,74,ŁKS Łódź,Sezon 2009/2010
2010-03-31 19:00,GKS Tychy(d),73 : 62W,73,17,37,45.9,7,26,26.9,24,63,38.1,18,27,66.7,10,29,39,15,18,21,9,9,1,3,80,ŁKS Łódź,Sezon 2009/2010
2010-04-07 19:00,GKS Tychy(w),72 : 75W,75,19,36,52.8,7,24,29.2,26,60,43.3,16,20,80.0,10,20,30,11,17,23,14,13,2,1,79,ŁKS Łódź,Sezon 2009/2010
2010-04-21 18:30,Intermarche Zastal Zielona Góra(w),73 : 61P,61,16,38,42.1,5,22,22.7,21,60,35.0,14,25,56.0,14,22,36,12,28,24,17,9,2,7,53,ŁKS Łódź,Sezon 2009/2010
2010-04-25 18:15,Intermarche Zastal Zielona Góra(d),71 : 56W,71,12,32,37.5,7,27,25.9,19,59,32.2,26,43,60.5,14,21,35,10,25,31,9,8,1,3,59,ŁKS Łódź,Sezon 2009/2010
2010-04-29 18:35,Intermarche Zastal Zielona Góra(w),75 : 71P,71,17,34,50.0,8,22,36.4,25,56,44.6,13,22,59.1,8,26,34,15,21,22,13,7,2,7,76,ŁKS Łódź,Sezon 2009/2010
2010-05-05 19:00,MKS Dąbrowa Górnicza(d),63 : 73P,63,22,42,52.4,3,20,15.0,25,62,40.3,10,16,62.5,5,23,28,19,14,15,13,11,0,1,65,ŁKS Łódź,Sezon 2009/2010
2010-05-09 20:00,MKS Dąbrowa Górnicza(w),56 : 72W,72,15,35,42.9,9,29,31.0,24,64,37.5,15,22,68.2,13,26,39,17,17,20,13,12,0,2,80,ŁKS Łódź,Sezon 2009/2010
2009-10-03 18:00,Znicz Basket Pruszków(d),59 : 75P,59,14,30,46.7,6,25,24.0,20,55,36.4,13,21,61.9,6,23,29,10,17,21,16,15,0,4,54,Intermarche Zastal Zielona Góra,Sezon 2009/2010
2009-10-10 17:00,Żubry Białystok(w),58 : 84W,84,21,48,43.8,7,22,31.8,28,70,40.0,21,31,67.7,13,27,40,10,15,22,16,19,3,4,88,Intermarche Zastal Zielona Góra,Sezon 2009/2010
2009-10-14 18:00,KS AZS AWF Katowice(d),75 : 58W,75,17,33,51.5,9,28,32.1,26,61,42.6,14,26,53.8,12,25,37,14,23,23,7,17,3,2,92,Intermarche Zastal Zielona Góra,Sezon 2009/2010
2009-10-21 18:00,Spójnia Stargard Szcz.(w),82 : 89W,89,20,37,54.1,9,27,33.3,29,64,45.3,22,26,84.6,5,19,24,15,20,26,19,21,2,4,93,Intermarche Zastal Zielona Góra,Sezon 2009/2010
2009-10-28 18:00,ŁKS Łódź(d),58 : 53W,58,11,25,44.0,8,28,28.6,19,53,35.8,12,14,85.7,4,26,30,12,14,19,10,14,5,0,73,Intermarche Zastal Zielona Góra,Sezon 2009/2010
2009-11-08 18:00,MKS Dąbrowa Górnicza(w),86 : 60P,60,19,50,38.0,4,16,25.0,23,66,34.8,10,20,50.0,13,14,27,5,17,20,8,6,3,7,40,Intermarche Zastal Zielona Góra,Sezon 2009/2010
2009-11-11 18:00,AZS Politechnika Warszawska(d),90 : 85W,90,31,52,59.6,3,23,13.0,34,75,45.3,19,22,86.4,14,33,47,16,21,23,10,12,5,1,116,Intermarche Zastal Zielona Góra,Sezon 2009/2010
2009-11-14 17:00,Asseco Prokom 2 Gdynia(d),80 : 59W,80,26,49,53.1,6,21,28.6,32,70,45.7,10,19,52.6,12,20,32,11,19,20,11,15,1,2,81,Intermarche Zastal Zielona Góra,Sezon 2009/2010
2009-11-18 18:30,MKS Start Lublin(w),72 : 89W,89,20,40,50.0,10,19,52.6,30,59,50.8,19,27,70.4,7,28,35,12,15,21,13,8,5,2,99,Intermarche Zastal Zielona Góra,Sezon 2009/2010
2009-11-22 17:00,Siarka Tarnobrzeg(d),56 : 51W,56,12,33,36.4,8,31,25.8,20,64,31.3,8,13,61.5,15,27,42,15,14,17,15,13,0,4,62,Intermarche Zastal Zielona Góra,Sezon 2009/2010
2009-11-25 19:00,GKS Tychy(w),73 : 70P,70,15,34,44.1,7,21,33.3,22,55,40.0,19,19,100.0,9,18,27,7,23,19,16,9,2,4,66,Intermarche Zastal Zielona Góra,Sezon 2009/2010
2009-12-05 17:00,Victoria Górnik Wałbrzych(w),75 : 87W,87,23,40,57.5,7,21,33.3,30,61,49.2,20,29,69.0,13,29,42,12,16,22,16,13,0,0,98,Intermarche Zastal Zielona Góra,Sezon 2009/2010
2009-12-09 18:00,PTG Sokół Łańcut(d),81 : 73W,81,13,30,43.3,12,24,50.0,25,54,46.3,19,27,70.4,8,33,41,22,24,23,12,9,7,1,111,Intermarche Zastal Zielona Góra,Sezon 2009/2010
2009-12-13 17:00,Miasto Szkła Krosno(d),86 : 64W,86,25,49,51.0,8,19,42.1,33,68,48.5,12,14,85.7,11,26,37,14,18,15,12,10,4,3,102,Intermarche Zastal Zielona Góra,Sezon 2009/2010
2009-12-19 18:00,KS Sudety Jelenia Góra(w),80 : 86W,86,20,31,64.5,10,30,33.3,30,61,49.2,16,26,61.5,6,26,32,14,24,23,8,9,3,0,95,Intermarche Zastal Zielona Góra,Sezon 2009/2010
2010-01-10 18:00,Znicz Basket Pruszków(w),71 : 78W,78,23,40,57.5,6,15,40.0,29,55,52.7,14,19,73.7,3,23,26,12,21,24,12,10,2,4,85,Intermarche Zastal Zielona Góra,Sezon 2009/2010
2010-01-17 17:00,Żubry Białystok(d),58 : 63P,58,15,36,41.7,3,23,13.0,18,59,30.5,19,25,76.0,8,28,36,10,24,19,17,16,3,3,59,Intermarche Zastal Zielona Góra,Sezon 2009/2010
2010-01-20 18:30,KS AZS AWF Katowice(w),71 : 93W,93,30,41,73.2,8,25,32.0,38,66,57.6,9,10,90.0,13,23,36,14,24,17,13,15,7,1,123,Intermarche Zastal Zielona Góra,Sezon 2009/2010
2010-01-23 17:00,Spójnia Stargard Szcz.(d),76 : 65W,76,17,40,42.5,9,27,33.3,26,67,38.8,15,22,68.2,17,21,38,11,23,19,16,18,3,0,82,Intermarche Zastal Zielona Góra,Sezon 2009/2010
2010-01-31 15:00,Asseco Prokom 2 Gdynia(w),74 : 79W,79,22,34,64.7,7,25,28.0,29,59,49.2,14,25,56.0,6,23,29,15,28,23,18,13,2,1,79,Intermarche Zastal Zielona Góra,Sezon 2009/2010
2010-02-03 19:00,ŁKS Łódź(w),81 : 88W,88,19,36,52.8,10,25,40.0,29,61,47.5,20,28,71.4,7,26,33,16,24,22,12,8,5,1,98,Intermarche Zastal Zielona Góra,Sezon 2009/2010
2010-02-06 17:00,MKS Dąbrowa Górnicza(d),74 : 59W,74,21,46,45.7,5,17,29.4,26,63,41.3,17,21,81.0,9,25,34,5,15,20,12,15,3,7,78,Intermarche Zastal Zielona Góra,Sezon 2009/2010
2010-02-10 15:00,AZS Politechnika Warszawska(w),69 : 87W,87,29,49,59.2,4,19,21.1,33,68,48.5,17,19,89.5,11,29,40,14,21,21,8,6,6,1,108,Intermarche Zastal Zielona Góra,Sezon 2009/2010
2010-02-14 17:00,MKS Start Lublin(d),81 : 67W,81,19,30,63.3,12,31,38.7,31,61,50.8,7,11,63.6,5,29,34,14,19,17,17,13,0,0,91,Intermarche Zastal Zielona Góra,Sezon 2009/2010
2010-02-18 18:00,Miasto Szkła Krosno(w),73 : 77W,77,23,37,62.2,6,23,26.1,29,60,48.3,13,23,56.5,15,27,42,10,23,24,14,7,3,3,84,Intermarche Zastal Zielona Góra,Sezon 2009/2010
2010-02-20 18:00,Siarka Tarnobrzeg(w),73 : 72P,72,14,35,40.0,4,25,16.0,18,60,30.0,32,36,88.9,9,30,39,6,23,26,9,7,2,3,71,Intermarche Zastal Zielona Góra,Sezon 2009/2010
2010-02-24 18:00,GKS Tychy(d),64 : 65P,64,17,42,40.5,7,20,35.0,24,62,38.7,9,15,60.0,10,30,40,11,17,15,18,11,4,5,68,Intermarche Zastal Zielona Góra,Sezon 2009/2010
2010-02-27 17:30,PTG Sokół Łańcut(w),76 : 86W,86,15,29,51.7,14,30,46.7,29,59,49.2,14,23,60.9,7,22,29,17,24,20,14,12,6,3,97,Intermarche Zastal Zielona Góra,Sezon 2009/2010
2010-03-06 17:00,Victoria Górnik Wałbrzych(d),79 : 59W,79,27,46,58.7,3,16,18.8,30,62,48.4,16,31,51.6,8,34,42,14,14,24,15,7,6,4,86,Intermarche Zastal Zielona Góra,Sezon 2009/2010
2010-03-27 18:00,PTG Sokół Łańcut(d),87 : 54W,87,17,37,45.9,13,24,54.2,30,61,49.2,14,22,63.6,9,29,38,17,20,20,11,18,9,3,119,Intermarche Zastal Zielona Góra,Sezon 2009/2010
2010-03-31 18:00,PTG Sokół Łańcut(w),76 : 66P,66,11,21,52.4,9,27,33.3,20,48,41.7,17,29,58.6,10,24,34,8,28,26,23,10,6,1,61,Intermarche Zastal Zielona Góra,Sezon 2009/2010
2010-04-07 18:00,PTG Sokół Łańcut(d),84 : 60W,84,20,34,58.8,8,19,42.1,28,53,52.8,20,27,74.1,5,23,28,17,23,17,10,13,2,1,102,Intermarche Zastal Zielona Góra,Sezon 2009/2010
2010-04-21 18:30,ŁKS Łódź(d),73 : 61W,73,16,32,50.0,5,21,23.8,21,53,39.6,26,34,76.5,10,23,33,12,24,28,13,15,7,2,87,Intermarche Zastal Zielona Góra,Sezon 2009/2010
2010-04-25 18:15,ŁKS Łódź(w),71 : 56P,56,10,24,41.7,7,32,21.9,17,56,30.4,15,25,60.0,13,24,37,5,31,25,15,7,3,1,44,Intermarche Zastal Zielona Góra,Sezon 2009/2010
2010-04-29 18:35,ŁKS Łódź(d),75 : 71W,75,22,37,59.5,5,25,20.0,27,62,43.5,16,25,64.0,10,25,35,10,22,21,11,11,6,2,82,Intermarche Zastal Zielona Góra,Sezon 2009/2010
2010-05-05 18:30,Siarka Tarnobrzeg(w),72 : 65P,65,17,37,45.9,8,30,26.7,25,67,37.3,7,9,77.8,6,26,32,12,15,14,13,11,0,4,63,Intermarche Zastal Zielona Góra,Sezon 2009/2010
2010-05-08 18:00,Siarka Tarnobrzeg(d),64 : 87P,64,16,43,37.2,6,22,27.3,22,65,33.8,14,21,66.7,8,24,32,10,22,19,11,8,1,3,54,Intermarche Zastal Zielona Góra,Sezon 2009/2010
2009-10-03 18:00,Miasto Szkła Krosno(d),50 : 44W,50,20,41,48.8,1,20,5.0,21,61,34.4,7,18,38.9,12,28,40,12,13,19,9,9,6,1,57,MKS Dąbrowa Górnicza,Sezon 2009/2010
2009-10-10 18:00,KS Sudety Jelenia Góra(w),71 : 81W,81,21,48,43.8,5,14,35.7,26,62,41.9,24,31,77.4,17,22,39,9,30,22,13,8,2,0,83,MKS Dąbrowa Górnicza,Sezon 2009/2010
2009-10-14 18:00,Znicz Basket Pruszków(d),86 : 78W,86,27,42,64.3,6,18,33.3,33,60,55.0,14,24,58.3,11,20,31,12,19,25,17,14,1,2,90,MKS Dąbrowa Górnicza,Sezon 2009/2010
2009-10-21 17:00,Żubry Białystok(w),80 : 91W,91,24,49,49.0,4,18,22.2,28,67,41.8,31,39,79.5,10,28,38,10,17,29,14,18,2,3,98,MKS Dąbrowa Górnicza,Sezon 2009/2010
2009-10-25 18:00,KS AZS AWF Katowice(w),85 : 88W,88,21,40,52.5,10,24,41.7,31,64,48.4,16,22,72.7,13,21,34,14,26,25,18,9,5,1,93,MKS Dąbrowa Górnicza,Sezon 2009/2010
2009-10-28 18:00,Spójnia Stargard Szcz.(w),62 : 74W,74,17,33,51.5,8,23,34.8,25,56,44.6,16,25,64.0,7,31,38,14,18,24,14,8,7,1,87,MKS Dąbrowa Górnicza,Sezon 2009/2010
2009-11-08 18:00,Intermarche Zastal Zielona Góra(d),86 : 60W,86,23,40,57.5,10,22,45.5,33,62,53.2,10,23,43.5,14,32,46,19,20,17,10,3,7,3,109,MKS Dąbrowa Górnicza,Sezon 2009/2010
2009-11-14 17:30,ŁKS Łódź(w),74 : 61P,61,21,39,53.8,3,22,13.6,24,61,39.3,10,14,71.4,9,23,32,11,25,18,15,6,4,1,58,MKS Dąbrowa Górnicza,Sezon 2009/2010
2009-11-17 18:00,Asseco Prokom 2 Gdynia(d),77 : 60W,77,27,34,79.4,6,18,33.3,33,52,63.5,5,16,31.3,12,28,40,20,19,22,14,8,4,2,105,MKS Dąbrowa Górnicza,Sezon 2009/2010
2009-11-21 18:00,AZS Politechnika Warszawska(d),96 : 87W,96,39,58,67.2,2,17,11.8,41,75,54.7,12,19,63.2,11,31,42,23,21,17,9,6,1,1,118,MKS Dąbrowa Górnicza,Sezon 2009/2010
2009-11-25 18:30,MKS Start Lublin(w),59 : 69W,69,20,39,51.3,8,22,36.4,28,61,45.9,5,7,71.4,10,25,35,22,25,15,19,9,3,2,84,MKS Dąbrowa Górnicza,Sezon 2009/2010
2009-12-05 18:00,GKS Tychy(w),87 : 76P,76,14,26,53.8,11,24,45.8,25,50,50.0,15,18,83.3,2,17,19,13,25,21,23,11,2,0,70,MKS Dąbrowa Górnicza,Sezon 2009/2010
2009-12-13 17:30,PTG Sokół Łańcut(w),62 : 77W,77,21,39,53.8,8,26,30.8,29,65,44.6,11,18,61.1,12,22,34,19,22,23,10,14,4,1,95,MKS Dąbrowa Górnicza,Sezon 2009/2010
2009-12-18 18:00,Victoria Górnik Wałbrzych(w),69 : 99W,99,26,37,70.3,11,19,57.9,37,56,66.1,14,20,70.0,7,28,35,12,25,17,23,11,2,1,111,MKS Dąbrowa Górnicza,Sezon 2009/2010
2009-12-23 18:00,Siarka Tarnobrzeg(d),70 : 62W,70,23,41,56.1,4,15,26.7,27,56,48.2,12,21,57.1,8,23,31,18,19,21,17,10,5,3,79,MKS Dąbrowa Górnicza,Sezon 2009/2010
2010-01-10 18:00,Miasto Szkła Krosno(w),49 : 67W,67,21,40,52.5,4,19,21.1,25,59,42.4,13,17,76.5,9,28,37,9,15,18,10,7,2,4,74,MKS Dąbrowa Górnicza,Sezon 2009/2010
2010-01-13 19:00,Znicz Basket Pruszków(w),66 : 77W,77,13,26,50.0,10,25,40.0,23,51,45.1,21,29,72.4,11,19,30,14,22,20,18,14,2,2,83,MKS Dąbrowa Górnicza,Sezon 2009/2010
2010-01-16 18:00,KS Sudety Jelenia Góra(d),100 : 67W,100,24,31,77.4,14,34,41.2,38,65,58.5,10,13,76.9,7,22,29,24,17,17,10,12,4,1,129,MKS Dąbrowa Górnicza,Sezon 2009/2010
2010-01-23 18:00,Żubry Białystok(d),72 : 56W,72,24,41,58.5,3,20,15.0,27,61,44.3,15,25,60.0,12,25,37,12,23,26,12,8,5,0,78,MKS Dąbrowa Górnicza,Sezon 2009/2010
2010-01-30 18:00,KS AZS AWF Katowice(d),83 : 59W,83,26,43,60.5,6,16,37.5,32,59,54.2,13,21,61.9,14,36,50,26,18,20,19,9,4,1,118,MKS Dąbrowa Górnicza,Sezon 2009/2010
2010-02-03 18:00,Spójnia Stargard Szcz.(d),71 : 59W,71,19,33,57.6,8,30,26.7,27,63,42.9,9,9,100.0,11,16,27,18,18,13,13,11,6,1,84,MKS Dąbrowa Górnicza,Sezon 2009/2010
2010-02-06 17:00,Intermarche Zastal Zielona Góra(w),74 : 59P,59,23,46,50.0,2,18,11.1,25,64,39.1,7,9,77.8,11,23,34,12,20,15,19,8,7,3,60,MKS Dąbrowa Górnicza,Sezon 2009/2010
2010-02-10 18:00,ŁKS Łódź(d),86 : 77W,86,24,36,66.7,7,23,30.4,31,59,52.5,17,27,63.0,6,24,30,21,20,21,13,14,5,0,105,MKS Dąbrowa Górnicza,Sezon 2009/2010
2010-02-14 16:00,Asseco Prokom 2 Gdynia(w),83 : 96W,96,31,56,55.4,7,18,38.9,38,74,51.4,13,18,72.2,3,26,29,25,15,21,6,8,7,10,118,MKS Dąbrowa Górnicza,Sezon 2009/2010
2010-02-20 18:00,AZS Politechnika Warszawska(w),75 : 69P,69,12,34,35.3,10,31,32.3,22,65,33.8,15,21,71.4,11,23,34,16,20,22,20,15,3,1,68,MKS Dąbrowa Górnicza,Sezon 2009/2010
2010-02-24 18:00,MKS Start Lublin(d),73 : 68W,73,21,43,48.8,5,20,25.0,26,63,41.3,16,21,76.2,15,28,43,20,18,19,15,9,1,1,89,MKS Dąbrowa Górnicza,Sezon 2009/2010
2010-02-27 19:00,Siarka Tarnobrzeg(w),77 : 68P,68,17,37,45.9,10,18,55.6,27,55,49.1,4,12,33.3,3,27,30,12,20,17,13,4,3,3,68,MKS Dąbrowa Górnicza,Sezon 2009/2010
2010-03-07 18:00,GKS Tychy(d),73 : 84P,73,20,41,48.8,6,21,28.6,26,62,41.9,15,21,71.4,8,17,25,11,17,20,10,11,1,4,69,MKS Dąbrowa Górnicza,Sezon 2009/2010
2010-03-16 18:00,PTG Sokół Łańcut(d),75 : 83P,75,13,31,41.9,12,27,44.4,25,58,43.1,13,20,65.0,11,20,31,16,27,19,23,7,3,1,69,MKS Dąbrowa Górnicza,Sezon 2009/2010
2010-03-20 18:00,Victoria Górnik Wałbrzych(d),89 : 66W,89,27,43,62.8,7,24,29.2,34,67,50.7,14,20,70.0,13,32,45,26,18,21,19,13,2,0,117,MKS Dąbrowa Górnicza,Sezon 2009/2010
2010-03-27 18:00,Spójnia Stargard Szcz.(d),87 : 77W,87,20,33,60.6,9,20,45.0,29,53,54.7,20,28,71.4,6,22,28,21,16,23,15,9,2,3,100,MKS Dąbrowa Górnicza,Sezon 2009/2010
2010-03-31 18:00,Spójnia Stargard Szcz.(w),69 : 81W,81,16,26,61.5,9,23,39.1,25,49,51.0,22,33,66.7,9,31,40,8,19,26,15,4,5,2,88,MKS Dąbrowa Górnicza,Sezon 2009/2010
2010-04-21 18:30,Siarka Tarnobrzeg(w),70 : 67P,67,24,42,57.1,5,27,18.5,29,69,42.0,4,8,50.0,15,17,32,14,21,17,13,5,4,1,65,MKS Dąbrowa Górnicza,Sezon 2009/2010
2010-04-24 18:00,Siarka Tarnobrzeg(d),67 : 64W,67,18,32,56.3,7,28,25.0,25,60,41.7,10,16,62.5,12,25,37,13,20,21,15,4,4,4,69,MKS Dąbrowa Górnicza,Sezon 2009/2010
2010-04-28 19:00,Siarka Tarnobrzeg(w),68 : 64P,64,18,46,39.1,5,19,26.3,23,65,35.4,13,26,50.0,12,28,40,9,25,20,8,6,1,9,57,MKS Dąbrowa Górnicza,Sezon 2009/2010
2010-05-05 19:00,ŁKS Łódź(w),63 : 73W,73,14,31,45.2,12,31,38.7,26,62,41.9,9,11,81.8,8,29,37,14,15,14,14,8,1,0,81,MKS Dąbrowa Górnicza,Sezon 2009/2010
2010-05-09 20:00,ŁKS Łódź(d),56 : 72P,56,15,29,51.7,6,30,20.0,21,59,35.6,8,15,53.3,11,29,40,20,20,17,21,8,2,0,60,MKS Dąbrowa Górnicza,Sezon 2009/2010
2009-10-03 19:00,PTG Sokół Łańcut(d),69 : 76P,69,22,42,52.4,3,17,17.6,25,59,42.4,16,20,80.0,8,27,35,11,23,22,16,10,1,1,72,MKS Start Lublin,Sezon 2009/2010
2009-10-14 18:30,Miasto Szkła Krosno(d),71 : 62W,71,18,46,39.1,4,14,28.6,22,60,36.7,23,27,85.2,11,27,38,13,20,25,9,11,2,5,84,MKS Start Lublin,Sezon 2009/2010
2009-10-21 18:00,KS Sudety Jelenia Góra(w),67 : 64P,64,20,36,55.6,4,20,20.0,24,56,42.9,12,12,100.0,8,20,28,11,17,17,11,2,1,1,63,MKS Start Lublin,Sezon 2009/2010
2009-10-24 18:30,Znicz Basket Pruszków(d),67 : 62W,67,18,36,50.0,6,20,30.0,24,56,42.9,13,21,61.9,7,23,30,12,20,22,14,11,4,3,70,MKS Start Lublin,Sezon 2009/2010
2009-10-28 17:00,Żubry Białystok(w),65 : 83W,83,22,44,50.0,7,18,38.9,29,62,46.8,18,24,75.0,10,29,39,10,17,19,23,14,3,3,87,MKS Start Lublin,Sezon 2009/2010
2009-11-07 18:30,KS AZS AWF Katowice(d),87 : 82W,87,29,46,63.0,5,19,26.3,34,65,52.3,14,20,70.0,6,25,31,22,26,20,17,13,3,5,102,MKS Start Lublin,Sezon 2009/2010
2009-11-14 17:00,Spójnia Stargard Szcz.(w),69 : 62P,62,17,36,47.2,6,20,30.0,23,56,41.1,10,14,71.4,9,24,33,12,23,21,20,9,2,0,61,MKS Start Lublin,Sezon 2009/2010
2009-11-18 18:30,Intermarche Zastal Zielona Góra(d),72 : 89P,72,24,44,54.5,4,23,17.4,28,67,41.8,12,15,80.0,7,19,26,15,21,15,11,9,2,5,71,MKS Start Lublin,Sezon 2009/2010
2009-11-21 19:00,ŁKS Łódź(w),80 : 56P,56,20,45,44.4,1,11,9.1,21,56,37.5,13,26,50.0,7,27,34,13,18,26,25,8,2,3,40,MKS Start Lublin,Sezon 2009/2010
2009-11-25 18:30,MKS Dąbrowa Górnicza(d),59 : 69P,59,20,42,47.6,1,15,6.7,21,57,36.8,16,20,80.0,10,16,26,9,15,24,15,12,2,3,53,MKS Start Lublin,Sezon 2009/2010
2009-12-05 18:30,Asseco Prokom 2 Gdynia(d),80 : 63W,80,25,52,48.1,5,17,29.4,30,69,43.5,15,21,71.4,11,26,37,13,21,18,16,17,0,2,86,MKS Start Lublin,Sezon 2009/2010
2009-12-12 18:30,Siarka Tarnobrzeg(d),83 : 84P,83,17,43,39.5,10,16,62.5,27,59,45.8,19,25,76.0,11,15,26,20,26,26,18,10,2,2,85,MKS Start Lublin,Sezon 2009/2010
2009-12-19 18:00,GKS Tychy(w),77 : 74P,74,16,43,37.2,8,30,26.7,24,73,32.9,18,24,75.0,12,31,43,14,22,21,7,5,1,7,75,MKS Start Lublin,Sezon 2009/2010
2009-12-21 18:00,Victoria Górnik Wałbrzych(w),58 : 81W,81,27,48,56.3,4,13,30.8,31,61,50.8,15,22,68.2,11,34,45,9,22,21,13,11,1,6,97,MKS Start Lublin,Sezon 2009/2010
2010-01-05 19:30,AZS Politechnika Warszawska(w),64 : 60P,60,19,48,39.6,4,18,22.2,23,66,34.8,10,18,55.6,8,28,36,10,24,21,21,16,1,4,51,MKS Start Lublin,Sezon 2009/2010
2010-01-09 17:30,PTG Sokół Łańcut(w),72 : 59P,59,16,30,53.3,4,23,17.4,20,53,37.7,15,24,62.5,14,21,35,14,22,21,23,15,3,1,61,MKS Start Lublin,Sezon 2009/2010
2010-01-16 18:30,Victoria Górnik Wałbrzych(d),94 : 76W,94,23,41,56.1,9,17,52.9,32,58,55.2,21,26,80.8,9,31,40,12,18,19,20,10,3,3,108,MKS Start Lublin,Sezon 2009/2010
2010-01-20 18:00,Miasto Szkła Krosno(w),72 : 78W,78,17,38,44.7,7,14,50.0,24,52,46.2,23,37,62.2,7,32,39,4,22,31,16,6,2,1,71,MKS Start Lublin,Sezon 2009/2010
2010-01-23 18:30,KS Sudety Jelenia Góra(d),77 : 71W,77,21,39,53.8,6,19,31.6,27,58,46.6,17,23,73.9,8,25,33,10,22,21,14,11,4,0,84,MKS Start Lublin,Sezon 2009/2010
2010-01-30 18:00,Znicz Basket Pruszków(w),80 : 83W,83,18,33,54.5,11,23,47.8,29,56,51.8,14,20,70.0,6,21,27,14,21,24,12,8,0,1,87,MKS Start Lublin,Sezon 2009/2010
2010-02-03 18:30,Żubry Białystok(d),74 : 68W,74,15,35,42.9,9,21,42.9,24,56,42.9,17,26,65.4,8,26,34,17,22,27,19,12,3,5,80,MKS Start Lublin,Sezon 2009/2010
2010-02-06 18:00,KS AZS AWF Katowice(w),66 : 69W,69,15,38,39.5,8,19,42.1,23,57,40.4,15,22,68.2,8,24,32,10,16,22,12,7,3,5,68,MKS Start Lublin,Sezon 2009/2010
2010-02-10 18:30,Spójnia Stargard Szcz.(d),97 : 89W,97,24,36,66.7,7,19,36.8,31,55,56.4,28,32,87.5,3,23,26,17,17,23,10,10,2,2,114,MKS Start Lublin,Sezon 2009/2010
2010-02-14 17:00,Intermarche Zastal Zielona Góra(w),81 : 67P,67,12,30,40.0,9,25,36.0,21,55,38.2,16,21,76.2,7,26,33,13,17,18,19,10,0,0,65,MKS Start Lublin,Sezon 2009/2010
2010-02-20 18:30,ŁKS Łódź(d),48 : 71P,48,17,36,47.2,2,19,10.5,19,55,34.5,8,10,80.0,10,28,38,8,17,18,22,8,2,0,44,MKS Start Lublin,Sezon 2009/2010
2010-02-24 18:00,MKS Dąbrowa Górnicza(w),73 : 68P,68,18,36,50.0,7,21,33.3,25,57,43.9,11,17,64.7,8,22,30,11,19,18,15,6,1,1,63,MKS Start Lublin,Sezon 2009/2010
2010-02-27 18:30,AZS Politechnika Warszawska(d),83 : 61W,83,28,50,56.0,6,22,27.3,34,72,47.2,9,17,52.9,11,32,43,15,17,16,17,12,6,3,96,MKS Start Lublin,Sezon 2009/2010
2010-03-03 15:00,Asseco Prokom 2 Gdynia(w),84 : 83P,83,20,47,42.6,10,27,37.0,30,74,40.5,13,15,86.7,8,29,37,19,17,18,9,4,1,5,89,MKS Start Lublin,Sezon 2009/2010
2010-03-11 18:00,Siarka Tarnobrzeg(w),89 : 68P,68,25,44,56.8,3,18,16.7,28,62,45.2,9,16,56.3,10,18,28,13,16,18,13,8,1,3,64,MKS Start Lublin,Sezon 2009/2010
2010-03-19 18:30,GKS Tychy(d),75 : 69W,75,21,49,42.9,6,17,35.3,27,66,40.9,15,16,93.8,13,30,43,14,18,20,12,7,3,3,90,MKS Start Lublin,Sezon 2009/2010
2010-03-27 18:30,KS Sudety Jelenia Góra(d),68 : 69P,68,24,54,44.4,2,17,11.8,26,71,36.6,14,21,66.7,15,21,36,14,20,23,9,13,2,7,72,MKS Start Lublin,Sezon 2009/2010
2010-03-31 17:30,KS Sudety Jelenia Góra(w),48 : 63W,63,17,36,47.2,6,19,31.6,23,55,41.8,11,13,84.6,15,28,43,14,18,17,15,7,2,5,80,MKS Start Lublin,Sezon 2009/2010
2010-04-07 18:30,KS Sudety Jelenia Góra(d),74 : 59W,74,20,35,57.1,5,17,29.4,25,52,48.1,19,25,76.0,11,31,42,19,20,21,16,5,2,3,93,MKS Start Lublin,Sezon 2009/2010
2009-10-03 18:00,GKS Tychy(d),87 : 85W,87,21,38,55.3,8,18,44.4,29,56,51.8,21,37,56.8,9,22,31,16,22,34,14,14,2,2,93,Siarka Tarnobrzeg,Sezon 2009/2010
2009-10-10 17:30,PTG Sokół Łańcut(w),81 : 74P,74,16,34,47.1,8,27,29.6,24,61,39.3,18,26,69.2,15,16,31,13,25,21,20,13,3,0,69,Siarka Tarnobrzeg,Sezon 2009/2010
2009-10-14 18:00,Victoria Górnik Wałbrzych(d),82 : 67W,82,20,49,40.8,7,15,46.7,27,64,42.2,21,27,77.8,11,21,32,14,20,24,8,13,3,4,93,Siarka Tarnobrzeg,Sezon 2009/2010
2009-10-21 18:00,Miasto Szkła Krosno(w),57 : 76W,76,26,45,57.8,4,18,22.2,30,63,47.6,12,17,70.6,13,24,37,19,19,18,15,9,2,1,90,Siarka Tarnobrzeg,Sezon 2009/2010
2009-10-24 18:00,KS Sudety Jelenia Góra(d),78 : 71W,78,20,39,51.3,8,22,36.4,28,61,45.9,14,21,66.7,7,26,33,19,23,25,13,13,0,3,90,Siarka Tarnobrzeg,Sezon 2009/2010
2009-10-28 18:00,Znicz Basket Pruszków(w),63 : 68W,68,14,34,41.2,10,23,43.5,24,57,42.1,10,15,66.7,12,19,31,13,16,20,22,13,2,4,67,Siarka Tarnobrzeg,Sezon 2009/2010
2009-11-07 18:00,Żubry Białystok(d),96 : 67W,96,25,44,56.8,10,19,52.6,35,63,55.6,16,27,59.3,11,28,39,23,16,21,17,12,1,3,115,Siarka Tarnobrzeg,Sezon 2009/2010
2009-11-11 18:30,KS AZS AWF Katowice(w),65 : 69W,69,18,32,56.3,7,22,31.8,25,54,46.3,12,21,57.1,6,22,28,14,21,23,16,12,3,4,72,Siarka Tarnobrzeg,Sezon 2009/2010
2009-11-18 18:00,Spójnia Stargard Szcz.(d),72 : 67W,72,17,40,42.5,7,23,30.4,24,63,38.1,17,22,77.3,11,24,35,14,16,24,15,14,7,0,83,Siarka Tarnobrzeg,Sezon 2009/2010
2009-11-22 17:00,Intermarche Zastal Zielona Góra(w),56 : 51P,51,15,35,42.9,5,20,25.0,20,55,36.4,6,10,60.0,9,25,34,10,17,14,14,13,4,0,59,Siarka Tarnobrzeg,Sezon 2009/2010
2009-11-25 18:00,ŁKS Łódź(d),70 : 76P,70,18,35,51.4,6,17,35.3,24,52,46.2,16,23,69.6,9,25,34,14,29,28,15,5,7,2,80,Siarka Tarnobrzeg,Sezon 2009/2010
2009-12-05 18:00,AZS Politechnika Warszawska(d),80 : 68W,80,26,46,56.5,4,24,16.7,30,70,42.9,16,22,72.7,10,13,23,17,18,23,10,21,3,2,88,Siarka Tarnobrzeg,Sezon 2009/2010
2009-12-12 18:30,MKS Start Lublin(w),83 : 84W,84,19,40,47.5,9,30,30.0,28,70,40.0,19,24,79.2,17,21,38,12,27,26,14,14,2,2,89,Siarka Tarnobrzeg,Sezon 2009/2010
2009-12-23 18:00,MKS Dąbrowa Górnicza(w),70 : 62P,62,16,37,43.2,5,21,23.8,21,58,36.2,15,24,62.5,10,19,29,8,21,19,17,7,3,5,46,Siarka Tarnobrzeg,Sezon 2009/2010
2010-01-09 18:00,GKS Tychy(w),83 : 78P,78,19,39,48.7,10,23,43.5,29,62,46.8,10,13,76.9,12,21,33,16,21,16,14,8,4,2,89,Siarka Tarnobrzeg,Sezon 2009/2010
2010-01-17 17:00,PTG Sokół Łańcut(d),79 : 50W,79,22,34,64.7,9,22,40.9,31,56,55.4,8,11,72.7,8,28,36,16,23,16,13,13,8,3,111,Siarka Tarnobrzeg,Sezon 2009/2010
2010-01-20 16:00,Victoria Górnik Wałbrzych(w),67 : 78W,78,21,40,52.5,5,21,23.8,26,61,42.6,21,24,87.5,12,32,44,9,18,26,17,4,2,2,82,Siarka Tarnobrzeg,Sezon 2009/2010
2010-01-24 17:00,Miasto Szkła Krosno(d),74 : 58W,74,15,28,53.6,11,25,44.0,26,53,49.1,11,14,78.6,9,21,30,22,17,17,13,11,2,0,96,Siarka Tarnobrzeg,Sezon 2009/2010
2010-01-30 18:00,KS Sudety Jelenia Góra(w),62 : 76W,76,22,37,59.5,7,14,50.0,29,51,56.9,11,15,73.3,6,23,29,18,16,18,9,8,2,0,98,Siarka Tarnobrzeg,Sezon 2009/2010
2010-02-03 18:00,Znicz Basket Pruszków(d),79 : 57W,79,16,29,55.2,10,22,45.5,26,51,51.0,17,28,60.7,9,25,34,21,20,19,18,13,5,5,98,Siarka Tarnobrzeg,Sezon 2009/2010
2010-02-06 17:00,Żubry Białystok(w),75 : 76W,76,23,43,53.5,5,17,29.4,28,60,46.7,15,18,83.3,10,20,30,12,28,20,18,10,2,3,77,Siarka Tarnobrzeg,Sezon 2009/2010
2010-02-10 18:00,KS AZS AWF Katowice(d),80 : 62W,80,19,36,52.8,10,22,45.5,29,58,50.0,12,18,66.7,10,23,33,14,25,22,17,7,3,0,85,Siarka Tarnobrzeg,Sezon 2009/2010
2010-02-13 17:00,Spójnia Stargard Szcz.(w),54 : 48P,48,10,38,26.3,8,24,33.3,18,62,29.0,4,11,36.4,7,29,36,10,23,18,17,10,6,3,42,Siarka Tarnobrzeg,Sezon 2009/2010
2010-02-20 18:00,Intermarche Zastal Zielona Góra(d),73 : 72W,73,18,47,38.3,8,28,28.6,26,75,34.7,13,20,65.0,19,32,51,13,27,22,14,5,3,2,75,Siarka Tarnobrzeg,Sezon 2009/2010
2010-02-24 19:00,ŁKS Łódź(w),57 : 72W,72,18,37,48.6,8,23,34.8,26,60,43.3,12,21,57.1,18,21,39,4,27,26,15,14,4,0,75,Siarka Tarnobrzeg,Sezon 2009/2010
2010-02-27 19:00,MKS Dąbrowa Górnicza(d),77 : 68W,77,19,46,41.3,8,25,32.0,27,71,38.0,15,17,88.2,16,28,44,12,17,20,8,6,3,3,88,Siarka Tarnobrzeg,Sezon 2009/2010
2010-03-03 18:00,AZS Politechnika Warszawska(w),76 : 88W,88,21,43,48.8,10,19,52.6,31,62,50.0,16,29,55.2,10,20,30,14,19,30,13,15,3,0,93,Siarka Tarnobrzeg,Sezon 2009/2010
2010-03-11 18:00,MKS Start Lublin(d),89 : 68W,89,13,24,54.2,18,34,52.9,31,58,53.4,9,10,90.0,6,23,29,23,18,16,13,7,3,1,110,Siarka Tarnobrzeg,Sezon 2009/2010
2010-03-21 16:00,Asseco Prokom 2 Gdynia(w),98 : 93P,93,21,43,48.8,9,26,34.6,30,69,43.5,24,31,77.4,11,22,33,14,30,30,12,5,0,6,87,Siarka Tarnobrzeg,Sezon 2009/2010
2010-03-27 18:00,Znicz Basket Pruszków(d),70 : 58W,70,13,30,43.3,7,29,24.1,20,59,33.9,23,26,88.5,12,24,36,15,21,22,11,10,1,1,79,Siarka Tarnobrzeg,Sezon 2009/2010
2010-04-01 18:00,Znicz Basket Pruszków(w),47 : 74W,74,16,35,45.7,8,22,36.4,24,57,42.1,18,27,66.7,13,29,42,12,15,22,18,12,1,2,81,Siarka Tarnobrzeg,Sezon 2009/2010
2010-04-21 18:30,MKS Dąbrowa Górnicza(d),70 : 67W,70,24,41,58.5,2,14,14.3,26,55,47.3,16,20,80.0,11,24,35,12,17,21,11,9,1,4,83,Siarka Tarnobrzeg,Sezon 2009/2010
2010-04-24 18:00,MKS Dąbrowa Górnicza(w),67 : 64P,64,18,39,46.2,4,28,14.3,22,67,32.8,16,25,64.0,18,20,38,5,21,20,10,8,4,4,55,Siarka Tarnobrzeg,Sezon 2009/2010
2010-04-28 19:00,MKS Dąbrowa Górnicza(d),68 : 64W,68,15,35,42.9,6,20,30.0,21,55,38.2,20,24,83.3,6,30,36,11,22,25,9,7,9,1,84,Siarka Tarnobrzeg,Sezon 2009/2010
2010-05-05 18:30,Intermarche Zastal Zielona Góra(d),72 : 65W,72,22,37,59.5,7,25,28.0,29,62,46.8,7,10,70.0,9,34,43,17,14,15,16,9,4,0,93,Siarka Tarnobrzeg,Sezon 2009/2010
2010-05-08 18:00,Intermarche Zastal Zielona Góra(w),64 : 87W,87,24,39,61.5,8,21,38.1,32,60,53.3,15,24,62.5,7,37,44,14,19,22,12,10,3,1,109,Siarka Tarnobrzeg,Sezon 2009/2010
2009-10-03 17:00,Żubry Białystok(d),101 : 65W,101,35,53,66.0,6,22,27.3,41,75,54.7,13,18,72.2,16,32,48,22,29,19,15,12,3,3,132,Spójnia Stargard Szcz.,Sezon 2009/2010
2009-10-10 18:00,KS AZS AWF Katowice(w),78 : 87W,87,24,43,55.8,5,19,26.3,29,62,46.8,24,27,88.9,9,16,25,10,25,28,12,12,3,4,89,Spójnia Stargard Szcz.,Sezon 2009/2010
2009-10-14 18:00,Asseco Prokom 2 Gdynia(d),77 : 68W,77,24,47,51.1,7,25,28.0,31,72,43.1,8,14,57.1,13,30,43,16,24,15,13,10,1,0,87,Spójnia Stargard Szcz.,Sezon 2009/2010
2009-10-21 18:00,Intermarche Zastal Zielona Góra(d),82 : 89P,82,22,42,52.4,9,21,42.9,31,63,49.2,11,18,61.1,10,25,35,16,26,20,33,16,4,2,81,Spójnia Stargard Szcz.,Sezon 2009/2010
2009-10-25 17:00,ŁKS Łódź(w),80 : 83W,83,20,40,50.0,9,23,39.1,29,63,46.0,16,20,80.0,12,27,39,13,27,22,19,7,1,2,86,Spójnia Stargard Szcz.,Sezon 2009/2010
2009-10-28 18:00,MKS Dąbrowa Górnicza(d),62 : 74P,62,15,41,36.6,7,28,25.0,22,69,31.9,11,24,45.8,12,27,39,14,24,18,14,10,1,7,52,Spójnia Stargard Szcz.,Sezon 2009/2010
2009-11-14 17:00,MKS Start Lublin(d),69 : 62W,69,18,41,43.9,5,24,20.8,23,65,35.4,18,25,72.0,13,21,34,11,21,23,12,14,0,2,67,Spójnia Stargard Szcz.,Sezon 2009/2010
2009-11-18 18:00,Siarka Tarnobrzeg(w),72 : 67P,67,12,33,36.4,10,30,33.3,22,63,34.9,13,17,76.5,11,26,37,7,24,16,21,10,0,7,55,Spójnia Stargard Szcz.,Sezon 2009/2010
2009-11-21 17:00,GKS Tychy(d),70 : 69W,70,19,37,51.4,7,24,29.2,26,61,42.6,11,19,57.9,10,27,37,12,17,19,16,10,3,2,73,Spójnia Stargard Szcz.,Sezon 2009/2010
2009-11-28 17:00,Victoria Górnik Wałbrzych(d),82 : 62W,82,30,55,54.5,4,19,21.1,34,74,45.9,10,14,71.4,15,26,41,18,22,13,14,13,2,2,98,Spójnia Stargard Szcz.,Sezon 2009/2010
2009-12-06 18:00,Miasto Szkła Krosno(w),77 : 73P,73,20,38,52.6,9,20,45.0,29,58,50.0,6,11,54.5,7,15,22,16,19,14,10,7,1,2,75,Spójnia Stargard Szcz.,Sezon 2009/2010
2009-12-08 19:00,AZS Politechnika Warszawska(w),79 : 81W,81,24,43,55.8,4,18,22.2,28,61,45.9,21,34,61.8,11,28,39,15,19,26,16,9,7,4,89,Spójnia Stargard Szcz.,Sezon 2009/2010
2009-12-12 17:00,KS Sudety Jelenia Góra(d),78 : 55W,78,22,44,50.0,7,15,46.7,29,59,49.2,13,21,61.9,16,27,43,18,16,19,17,9,5,2,98,Spójnia Stargard Szcz.,Sezon 2009/2010
2009-12-19 18:00,Znicz Basket Pruszków(w),63 : 84W,84,23,40,57.5,7,17,41.2,30,57,52.6,17,26,65.4,8,24,32,19,24,21,16,16,1,5,100,Spójnia Stargard Szcz.,Sezon 2009/2010
2009-12-21 18:00,PTG Sokół Łańcut(w),73 : 65P,65,15,32,46.9,6,23,26.1,21,55,38.2,17,22,77.3,6,24,30,16,28,20,17,11,2,1,68,Spójnia Stargard Szcz.,Sezon 2009/2010
2010-01-10 17:00,Żubry Białystok(w),69 : 91W,91,28,47,59.6,7,14,50.0,35,61,57.4,14,19,73.7,9,24,33,17,17,19,16,20,5,0,119,Spójnia Stargard Szcz.,Sezon 2009/2010
2010-01-16 17:00,KS AZS AWF Katowice(d),69 : 64W,69,25,47,53.2,4,16,25.0,29,63,46.0,7,14,50.0,13,27,40,20,23,17,22,15,2,3,83,Spójnia Stargard Szcz.,Sezon 2009/2010
2010-01-20 17:00,Asseco Prokom 2 Gdynia(w),75 : 78W,78,22,42,52.4,6,20,30.0,28,62,45.2,16,17,94.1,11,18,29,19,23,19,22,11,4,2,84,Spójnia Stargard Szcz.,Sezon 2009/2010
2010-01-23 17:00,Intermarche Zastal Zielona Góra(w),76 : 65P,65,22,34,64.7,3,14,21.4,25,48,52.1,12,20,60.0,3,23,26,20,19,23,21,11,0,3,70,Spójnia Stargard Szcz.,Sezon 2009/2010
2010-01-30 17:00,ŁKS Łódź(d),73 : 78P,73,22,38,57.9,5,19,26.3,27,57,47.4,14,22,63.6,9,19,28,15,23,15,15,11,5,1,79,Spójnia Stargard Szcz.,Sezon 2009/2010
2010-02-03 18:00,MKS Dąbrowa Górnicza(w),71 : 59P,59,14,35,40.0,6,16,37.5,20,51,39.2,13,18,72.2,8,19,27,10,16,17,17,9,1,6,53,Spójnia Stargard Szcz.,Sezon 2009/2010
2010-02-06 17:00,AZS Politechnika Warszawska(d),83 : 73W,83,27,46,58.7,4,14,28.6,31,60,51.7,17,26,65.4,7,26,33,17,17,23,11,10,2,3,96,Spójnia Stargard Szcz.,Sezon 2009/2010
2010-02-10 18:30,MKS Start Lublin(w),97 : 89P,89,20,32,62.5,15,33,45.5,35,65,53.8,4,7,57.1,7,22,29,17,23,17,17,8,2,2,95,Spójnia Stargard Szcz.,Sezon 2009/2010
2010-02-13 17:00,Siarka Tarnobrzeg(d),54 : 48W,54,17,48,35.4,4,15,26.7,21,63,33.3,8,14,57.1,13,30,43,15,18,23,18,12,3,6,61,Spójnia Stargard Szcz.,Sezon 2009/2010
2010-02-17 17:30,KS Sudety Jelenia Góra(w),64 : 63P,63,18,42,42.9,4,12,33.3,22,54,40.7,15,22,68.2,9,29,38,11,17,19,13,6,2,7,68,Spójnia Stargard Szcz.,Sezon 2009/2010
2010-02-20 18:00,GKS Tychy(w),74 : 79W,79,17,32,53.1,9,22,40.9,26,54,48.1,18,24,75.0,6,27,33,15,18,19,18,14,0,1,89,Spójnia Stargard Szcz.,Sezon 2009/2010
2010-02-24 18:00,PTG Sokół Łańcut(d),86 : 77W,86,19,36,52.8,10,20,50.0,29,56,51.8,18,26,69.2,6,21,27,21,20,22,14,15,2,2,102,Spójnia Stargard Szcz.,Sezon 2009/2010
2010-02-27 16:30,Victoria Górnik Wałbrzych(w),67 : 78W,78,23,45,51.1,9,25,36.0,32,70,45.7,5,9,55.6,15,20,35,15,18,14,9,15,2,6,94,Spójnia Stargard Szcz.,Sezon 2009/2010
2010-03-03 18:00,Miasto Szkła Krosno(d),73 : 64W,73,19,36,52.8,5,20,25.0,24,56,42.9,20,23,87.0,8,23,31,19,17,21,15,13,2,2,88,Spójnia Stargard Szcz.,Sezon 2009/2010
2010-03-21 18:00,Znicz Basket Pruszków(d),68 : 72P,68,17,32,53.1,9,29,31.0,26,61,42.6,7,11,63.6,10,19,29,19,19,16,20,10,3,4,70,Spójnia Stargard Szcz.,Sezon 2009/2010
2010-03-27 18:00,MKS Dąbrowa Górnicza(w),87 : 77P,77,20,42,47.6,8,21,38.1,28,63,44.4,13,18,72.2,11,19,30,14,23,16,15,9,3,2,78,Spójnia Stargard Szcz.,Sezon 2009/2010
2010-03-31 18:00,MKS Dąbrowa Górnicza(d),69 : 81P,69,17,35,48.6,7,31,22.6,24,66,36.4,14,24,58.3,12,15,27,11,26,19,4,9,2,5,62,Spójnia Stargard Szcz.,Sezon 2009/2010
2009-10-03 16:30,AZS Politechnika Warszawska(w),67 : 57P,57,22,39,56.4,2,25,8.0,24,64,37.5,7,19,36.8,8,28,36,7,24,19,14,13,6,0,53,Victoria Górnik Wałbrzych,Sezon 2009/2010
2009-10-14 18:00,Siarka Tarnobrzeg(w),82 : 67P,67,25,45,55.6,3,19,15.8,28,64,43.8,8,24,33.3,14,22,36,7,24,20,17,3,4,3,48,Victoria Górnik Wałbrzych,Sezon 2009/2010
2009-10-21 18:00,GKS Tychy(d),81 : 91P,81,19,35,54.3,10,25,40.0,29,60,48.3,13,18,72.2,8,21,29,13,21,20,10,13,5,4,95,Victoria Górnik Wałbrzych,Sezon 2009/2010
2009-10-24 17:30,PTG Sokół Łańcut(w),72 : 66P,66,19,38,50.0,7,28,25.0,26,66,39.4,7,11,63.6,13,19,32,9,21,17,12,9,0,1,60,Victoria Górnik Wałbrzych,Sezon 2009/2010
2009-11-07 17:00,Miasto Szkła Krosno(d),56 : 86P,56,17,42,40.5,4,20,20.0,21,62,33.9,10,19,52.6,5,19,24,12,20,17,11,14,3,3,48,Victoria Górnik Wałbrzych,Sezon 2009/2010
2009-11-11 18:00,KS Sudety Jelenia Góra(w),82 : 74P,74,24,46,52.2,7,22,31.8,31,68,45.6,5,13,38.5,13,22,35,11,22,18,11,5,1,1,70,Victoria Górnik Wałbrzych,Sezon 2009/2010
2009-11-18 18:00,Znicz Basket Pruszków(d),100 : 89W,100,20,36,55.6,10,21,47.6,30,57,52.6,30,43,69.8,10,21,31,14,29,32,9,15,0,3,111,Victoria Górnik Wałbrzych,Sezon 2009/2010
2009-11-21 17:00,Żubry Białystok(w),93 : 85P,85,26,51,51.0,6,22,27.3,32,73,43.8,15,20,75.0,13,22,35,7,18,18,11,5,0,6,75,Victoria Górnik Wałbrzych,Sezon 2009/2010
2009-11-25 18:00,KS AZS AWF Katowice(d),80 : 67W,80,20,41,48.8,9,22,40.9,29,63,46.0,13,15,86.7,13,28,41,11,19,17,13,11,1,3,95,Victoria Górnik Wałbrzych,Sezon 2009/2010
2009-11-28 17:00,Spójnia Stargard Szcz.(w),82 : 62P,62,19,41,46.3,5,21,23.8,24,62,38.7,9,17,52.9,9,23,32,9,13,22,21,9,2,2,47,Victoria Górnik Wałbrzych,Sezon 2009/2010
2009-12-05 17:00,Intermarche Zastal Zielona Góra(d),75 : 87P,75,23,43,53.5,5,26,19.2,28,69,40.6,14,18,77.8,12,23,35,9,22,16,13,16,0,0,77,Victoria Górnik Wałbrzych,Sezon 2009/2010
2009-12-09 15:00,Asseco Prokom 2 Gdynia(w),118 : 114P,114,33,61,54.1,12,27,44.4,45,88,51.1,12,20,60.0,9,27,36,17,24,19,10,8,3,7,117,Victoria Górnik Wałbrzych,Sezon 2009/2010
2009-12-12 19:15,ŁKS Łódź(w),92 : 71P,71,19,42,45.2,5,17,29.4,24,59,40.7,18,22,81.8,4,21,25,10,17,20,15,4,4,1,60,Victoria Górnik Wałbrzych,Sezon 2009/2010
2009-12-18 18:00,MKS Dąbrowa Górnicza(d),69 : 99P,69,13,32,40.6,7,25,28.0,20,57,35.1,22,29,75.9,6,13,19,9,17,25,16,18,1,2,56,Victoria Górnik Wałbrzych,Sezon 2009/2010
2009-12-21 18:00,MKS Start Lublin(d),58 : 81P,58,19,37,51.4,5,30,16.7,24,67,35.8,5,10,50.0,10,20,30,8,21,22,12,13,6,1,55,Victoria Górnik Wałbrzych,Sezon 2009/2010
2010-01-09 16:00,AZS Politechnika Warszawska(d),101 : 100W,101,24,39,61.5,12,26,46.2,36,65,55.4,17,24,70.8,12,22,34,18,20,21,15,12,0,0,114,Victoria Górnik Wałbrzych,Sezon 2009/2010
2010-01-16 18:30,MKS Start Lublin(w),94 : 76P,76,23,46,50.0,6,24,25.0,29,70,41.4,12,19,63.2,6,17,23,13,19,18,13,12,3,3,66,Victoria Górnik Wałbrzych,Sezon 2009/2010
2010-01-20 16:00,Siarka Tarnobrzeg(d),67 : 78P,67,11,33,33.3,11,28,39.3,22,61,36.1,12,15,80.0,4,21,25,13,26,18,7,16,2,2,74,Victoria Górnik Wałbrzych,Sezon 2009/2010
2010-01-23 18:00,GKS Tychy(w),66 : 69W,69,12,30,40.0,11,31,35.5,23,61,37.7,12,21,57.1,10,21,31,12,21,22,13,6,3,3,61,Victoria Górnik Wałbrzych,Sezon 2009/2010
2010-01-30 16:00,PTG Sokół Łańcut(d),76 : 67W,76,16,32,50.0,11,29,37.9,27,61,44.3,11,11,100.0,6,18,24,18,19,18,8,17,3,0,96,Victoria Górnik Wałbrzych,Sezon 2009/2010
2010-02-03 18:00,Asseco Prokom 2 Gdynia(d),77 : 76W,77,23,45,51.1,8,19,42.1,31,64,48.4,7,12,58.3,2,23,25,17,17,19,7,14,4,0,92,Victoria Górnik Wałbrzych,Sezon 2009/2010
2010-02-07 18:00,Miasto Szkła Krosno(w),62 : 83W,83,21,30,70.0,7,22,31.8,28,52,53.8,20,23,87.0,7,26,33,10,13,24,13,4,2,1,92,Victoria Górnik Wałbrzych,Sezon 2009/2010
2010-02-10 18:00,KS Sudety Jelenia Góra(d),74 : 67W,74,16,37,43.2,6,13,46.2,22,50,44.0,24,33,72.7,6,29,35,7,21,26,9,10,4,1,84,Victoria Górnik Wałbrzych,Sezon 2009/2010
2010-02-14 16:00,Znicz Basket Pruszków(w),86 : 64P,64,9,23,39.1,13,30,43.3,22,53,41.5,7,11,63.6,8,17,25,11,18,18,19,6,2,2,54,Victoria Górnik Wałbrzych,Sezon 2009/2010
2010-02-17 18:00,ŁKS Łódź(d),80 : 86P,80,16,38,42.1,13,30,43.3,29,68,42.6,9,10,90.0,8,18,26,13,25,16,12,14,4,0,85,Victoria Górnik Wałbrzych,Sezon 2009/2010
2010-02-20 17:00,Żubry Białystok(d),82 : 73W,82,21,41,51.2,8,26,30.8,29,67,43.3,16,21,76.2,13,25,38,10,18,21,14,20,8,4,101,Victoria Górnik Wałbrzych,Sezon 2009/2010
2010-02-24 18:30,KS AZS AWF Katowice(w),68 : 63P,63,20,35,57.1,5,23,21.7,25,58,43.1,8,14,57.1,6,20,26,6,20,20,14,10,1,0,53,Victoria Górnik Wałbrzych,Sezon 2009/2010
2010-02-27 16:30,Spójnia Stargard Szcz.(d),67 : 78P,67,19,32,59.4,7,19,36.8,26,51,51.0,8,12,66.7,7,23,30,11,14,18,17,8,6,2,76,Victoria Górnik Wałbrzych,Sezon 2009/2010
2010-03-06 17:00,Intermarche Zastal Zielona Góra(w),79 : 59P,59,18,41,43.9,6,28,21.4,24,69,34.8,5,7,71.4,8,26,34,7,25,14,14,13,4,6,56,Victoria Górnik Wałbrzych,Sezon 2009/2010
2010-03-20 18:00,MKS Dąbrowa Górnicza(w),89 : 66P,66,19,40,47.5,7,26,26.9,26,66,39.4,7,14,50.0,9,19,28,10,21,18,19,11,0,2,49,Victoria Górnik Wałbrzych,Sezon 2009/2010
2010-03-27 18:00,Miasto Szkła Krosno(w),76 : 77W,77,15,32,46.9,10,32,31.3,25,64,39.1,17,25,68.0,12,26,38,8,19,24,11,7,3,1,75,Victoria Górnik Wałbrzych,Sezon 2009/2010
2010-03-31 18:00,Miasto Szkła Krosno(d),73 : 77P,73,19,37,51.4,8,26,30.8,27,63,42.9,11,12,91.7,5,28,33,11,20,17,10,8,5,1,83,Victoria Górnik Wałbrzych,Sezon 2009/2010
2010-04-07 18:00,Miasto Szkła Krosno(w),69 : 70W,70,16,34,47.1,10,26,38.5,26,60,43.3,8,18,44.4,8,29,37,12,19,21,10,6,5,5,76,Victoria Górnik Wałbrzych,Sezon 2009/2010
2008-09-20 18:00,MKS Dąbrowa Górnicza(w),64 : 75W,75,23,42,54.8,6,16,37.5,29,58,50.0,11,17,64.7,10,27,37,8,18,17,11,12,1,2,87,GKS Tychy,Sezon 2008/2009
2008-09-27 18:00,KS AZS AWF Katowice(d),85 : 69W,85,30,48,62.5,4,14,28.6,34,62,54.8,13,17,76.5,14,31,45,21,22,19,20,4,10,3,113,GKS Tychy,Sezon 2008/2009
2008-10-04 17:00,Stal Stalowa Wola(w),74 : 81W,81,28,44,63.6,4,20,20.0,32,64,50.0,13,15,86.7,11,29,40,9,23,15,10,7,3,3,96,GKS Tychy,Sezon 2008/2009
2008-10-08 18:00,Resovia Rzeszów(d),87 : 58W,87,30,43,69.8,5,19,26.3,35,62,56.5,12,16,75.0,10,29,39,21,10,14,14,8,5,0,115,GKS Tychy,Sezon 2008/2009
2008-10-12 15:45,Asseco Prokom 2 Gdynia(w),63 : 83W,83,26,47,55.3,6,21,28.6,32,68,47.1,13,19,68.4,11,23,34,18,17,21,14,15,2,1,96,GKS Tychy,Sezon 2008/2009
2008-10-18 18:00,Miasto Szkła Krosno(d),79 : 70W,79,30,43,69.8,3,14,21.4,33,57,57.9,10,14,71.4,7,19,26,16,15,16,12,9,5,0,95,GKS Tychy,Sezon 2008/2009
2008-10-26 17:00,Znicz Basket Pruszków(w),80 : 76P,76,19,31,61.3,4,20,20.0,23,51,45.1,26,40,65.0,15,19,34,9,22,33,17,11,3,0,74,GKS Tychy,Sezon 2008/2009
2008-10-29 18:00,AZS PWSZ Kalisz(d),84 : 61W,84,28,42,66.7,5,22,22.7,33,64,51.6,13,22,59.1,16,24,40,17,20,19,16,15,5,1,105,GKS Tychy,Sezon 2008/2009
2008-11-09 18:00,Żubry Białystok(w),81 : 77P,77,27,50,54.0,4,13,30.8,31,63,49.2,11,13,84.6,10,18,28,12,12,16,14,8,7,4,84,GKS Tychy,Sezon 2008/2009
2008-11-15 18:00,Zastal Intermarche Zielona Góra(w),51 : 62W,62,11,36,30.6,11,20,55.0,22,56,39.3,7,9,77.8,10,23,33,14,17,13,10,9,1,2,73,GKS Tychy,Sezon 2008/2009
2008-11-22 18:00,Siarka Tarnobrzeg(d),99 : 89W,99,36,49,73.5,2,11,18.2,38,60,63.3,21,29,72.4,5,21,26,23,28,25,12,13,7,0,126,GKS Tychy,Sezon 2008/2009
2008-11-26 18:00,PTG Sokół Łańcut(w),79 : 76P,76,23,45,51.1,6,26,23.1,29,71,40.8,12,22,54.5,9,28,37,13,27,23,13,11,2,3,74,GKS Tychy,Sezon 2008/2009
2008-11-29 18:00,ŁKS Łódź(d),87 : 80W,87,22,42,52.4,9,21,42.9,31,63,49.2,16,19,84.2,5,19,24,17,13,19,11,12,3,2,97,GKS Tychy,Sezon 2008/2009
2008-12-06 15:00,Polonia 2011 Warszawa(w),88 : 79P,79,19,37,51.4,8,29,27.6,27,66,40.9,17,20,85.0,8,24,32,14,23,22,12,9,2,1,82,GKS Tychy,Sezon 2008/2009
2008-12-13 18:00,KS Sudety Jelenia Góra(d),77 : 65W,77,24,38,63.2,7,21,33.3,31,59,52.5,8,10,80.0,8,25,33,21,17,14,16,8,3,2,96,GKS Tychy,Sezon 2008/2009
2008-12-20 18:00,MKS Dąbrowa Górnicza(d),79 : 70W,79,31,53,58.5,3,14,21.4,34,67,50.7,8,15,53.3,10,18,28,14,15,13,12,14,4,1,87,GKS Tychy,Sezon 2008/2009
2009-01-04 17:00,KS AZS AWF Katowice(w),64 : 85W,85,26,49,53.1,7,14,50.0,33,63,52.4,12,19,63.2,10,23,33,16,17,17,13,6,3,1,93,GKS Tychy,Sezon 2008/2009
2009-01-10 18:00,Stal Stalowa Wola(d),77 : 81P,77,20,36,55.6,10,25,40.0,30,61,49.2,7,9,77.8,11,18,29,19,17,13,21,13,4,2,88,GKS Tychy,Sezon 2008/2009
2009-01-14 18:00,Resovia Rzeszów(w),62 : 76W,76,22,41,53.7,3,11,27.3,25,52,48.1,23,32,71.9,16,22,38,19,28,21,22,7,1,0,83,GKS Tychy,Sezon 2008/2009
2009-01-17 18:00,Asseco Prokom 2 Gdynia(d),94 : 84W,94,31,49,63.3,7,15,46.7,38,64,59.4,11,13,84.6,8,23,31,20,16,11,16,12,4,1,117,GKS Tychy,Sezon 2008/2009
2009-01-25 18:00,Miasto Szkła Krosno(w),71 : 69P,69,22,38,57.9,4,23,17.4,26,61,42.6,13,21,61.9,9,21,30,10,12,24,9,10,1,0,68,GKS Tychy,Sezon 2008/2009
2009-01-31 18:00,Znicz Basket Pruszków(d),91 : 79W,91,24,40,60.0,9,21,42.9,33,61,54.1,16,18,88.9,10,19,29,12,22,12,12,10,2,2,102,GKS Tychy,Sezon 2008/2009
2009-02-04 18:00,AZS PWSZ Kalisz(w),70 : 81W,81,22,44,50.0,7,14,50.0,29,58,50.0,16,20,80.0,7,24,31,18,20,19,13,6,1,2,91,GKS Tychy,Sezon 2008/2009
2009-02-07 18:00,Żubry Białystok(d),75 : 68W,75,18,40,45.0,7,12,58.3,25,52,48.1,18,23,78.3,9,22,31,8,24,22,17,9,2,2,76,GKS Tychy,Sezon 2008/2009
2009-02-14 18:00,Zastal Intermarche Zielona Góra(d),75 : 69W,75,26,43,60.5,3,12,25.0,29,55,52.7,14,18,77.8,12,22,34,15,20,18,16,14,6,0,98,GKS Tychy,Sezon 2008/2009
2009-02-21 18:00,Siarka Tarnobrzeg(w),88 : 79P,79,22,35,62.9,8,24,33.3,30,59,50.8,11,16,68.8,7,26,33,13,17,20,19,7,4,3,83,GKS Tychy,Sezon 2008/2009
2009-02-25 18:00,PTG Sokół Łańcut(d),83 : 62W,83,27,43,62.8,8,21,38.1,35,64,54.7,5,9,55.6,9,25,34,25,20,9,14,12,3,3,110,GKS Tychy,Sezon 2008/2009
2009-03-03 19:00,ŁKS Łódź(w),92 : 69P,69,19,31,61.3,7,28,25.0,26,59,44.1,10,15,66.7,7,22,29,13,18,18,14,5,2,0,66,GKS Tychy,Sezon 2008/2009
2009-03-11 18:00,Polonia 2011 Warszawa(d),80 : 87P,80,21,38,55.3,9,28,32.1,30,66,45.5,11,18,61.1,12,21,33,14,16,18,16,13,2,1,83,GKS Tychy,Sezon 2008/2009
2009-03-14 18:30,KS Sudety Jelenia Góra(w),67 : 64P,64,20,40,50.0,6,18,33.3,26,58,44.8,6,10,60.0,10,26,36,10,17,13,13,4,3,0,68,GKS Tychy,Sezon 2008/2009
2009-03-21 18:00,ŁKS Łódź(d),81 : 91P,81,18,37,48.6,8,27,29.6,26,64,40.6,21,27,77.8,5,26,31,13,26,23,11,10,4,0,84,GKS Tychy,Sezon 2008/2009
2009-03-22 18:00,ŁKS Łódź(d),80 : 71W,80,20,36,55.6,9,26,34.6,29,62,46.8,13,19,68.4,9,18,27,13,22,26,11,13,3,1,86,GKS Tychy,Sezon 2008/2009
2009-03-28 16:00,ŁKS Łódź(w),65 : 64P,64,17,37,45.9,4,17,23.5,21,54,38.9,18,24,75.0,12,25,37,11,21,21,13,5,3,0,68,GKS Tychy,Sezon 2008/2009
2009-03-29 16:00,ŁKS Łódź(w),80 : 88W,88,21,38,55.3,10,25,40.0,31,63,49.2,16,24,66.7,7,20,27,19,22,20,6,5,4,1,97,GKS Tychy,Sezon 2008/2009
2009-04-01 19:00,ŁKS Łódź(d),89 : 85W,89,24,40,60.0,6,21,28.6,30,61,49.2,23,37,62.2,7,22,29,18,20,25,7,8,6,1,98,GKS Tychy,Sezon 2008/2009
2009-04-18 19:00,Stal Stalowa Wola(d),67 : 69P,67,17,42,40.5,7,22,31.8,24,64,37.5,12,17,70.6,13,20,33,14,20,21,15,10,2,2,66,GKS Tychy,Sezon 2008/2009
2009-04-19 19:00,Stal Stalowa Wola(d),92 : 82W,92,24,39,61.5,9,21,42.9,33,60,55.0,17,23,73.9,7,18,25,17,21,21,12,14,0,2,103,GKS Tychy,Sezon 2008/2009
2009-04-25 20:00,Stal Stalowa Wola(w),67 : 69W,69,15,33,45.5,9,24,37.5,24,57,42.1,12,16,75.0,6,21,27,11,19,23,10,4,1,0,65,GKS Tychy,Sezon 2008/2009
2009-04-26 18:30,Stal Stalowa Wola(w),50 : 44P,44,12,34,35.3,4,24,16.7,16,58,27.6,8,12,66.7,7,20,27,8,21,17,10,10,4,2,37,GKS Tychy,Sezon 2008/2009
2009-04-29 19:00,Stal Stalowa Wola(d),63 : 85P,63,19,40,47.5,4,22,18.2,23,62,37.1,13,14,92.9,12,15,27,8,29,16,15,10,2,2,55,GKS Tychy,Sezon 2008/2009
2008-09-20 19:00,Miasto Szkła Krosno(w),90 : 63P,63,20,36,55.6,3,26,11.5,23,62,37.1,14,26,53.8,14,16,30,2,26,8,19,9,0,0,34,Asseco Prokom 2 Gdynia,Sezon 2008/2009
2008-09-27 18:00,Znicz Basket Pruszków(w),92 : 63P,63,21,43,48.8,4,23,17.4,25,66,37.9,9,20,45.0,17,13,30,7,21,20,21,14,1,2,42,Asseco Prokom 2 Gdynia,Sezon 2008/2009
2008-10-05 15:45,AZS PWSZ Kalisz(d),60 : 65P,60,16,35,45.7,5,18,27.8,21,53,39.6,13,20,65.0,12,31,43,11,21,19,27,7,3,2,58,Asseco Prokom 2 Gdynia,Sezon 2008/2009
2008-10-08 18:00,Żubry Białystok(w),89 : 85P,85,20,30,66.7,9,28,32.1,29,58,50.0,18,20,90.0,3,15,18,11,25,18,16,16,0,2,83,Asseco Prokom 2 Gdynia,Sezon 2008/2009
2008-10-12 15:45,GKS Tychy(d),63 : 83P,63,15,37,40.5,8,26,30.8,23,63,36.5,9,15,60.0,14,26,40,9,22,17,25,9,1,2,51,Asseco Prokom 2 Gdynia,Sezon 2008/2009
2008-10-18 18:30,Siarka Tarnobrzeg(w),97 : 75P,75,22,43,51.2,5,21,23.8,27,64,42.2,16,29,55.2,12,22,34,11,19,25,22,10,5,2,63,Asseco Prokom 2 Gdynia,Sezon 2008/2009
2008-10-19 18:00,Resovia Rzeszów(w),74 : 70P,70,22,38,57.9,4,19,21.1,26,57,45.6,14,22,63.6,9,29,38,18,22,20,19,9,2,0,79,Asseco Prokom 2 Gdynia,Sezon 2008/2009
2008-10-25 15:45,PTG Sokół Łańcut(d),87 : 81W,87,20,36,55.6,10,25,40.0,30,61,49.2,17,29,58.6,13,15,28,11,23,23,15,15,1,1,84,Asseco Prokom 2 Gdynia,Sezon 2008/2009
2008-10-29 18:00,ŁKS Łódź(w),79 : 93W,93,24,45,53.3,11,27,40.7,35,72,48.6,12,16,75.0,4,20,24,18,16,18,11,9,3,4,95,Asseco Prokom 2 Gdynia,Sezon 2008/2009
2008-11-09 15:00,Polonia 2011 Warszawa(d),93 : 92W,93,21,42,50.0,10,29,34.5,31,71,43.7,21,31,67.7,19,23,42,14,25,24,17,12,1,1,95,Asseco Prokom 2 Gdynia,Sezon 2008/2009
2008-11-15 18:30,KS Sudety Jelenia Góra(w),62 : 71W,71,16,29,55.2,10,19,52.6,26,48,54.2,9,14,64.3,4,19,23,6,18,13,9,4,1,0,69,Asseco Prokom 2 Gdynia,Sezon 2008/2009
2008-11-22 15:45,MKS Dąbrowa Górnicza(d),78 : 87P,78,20,50,40.0,8,32,25.0,28,82,34.1,14,14,100.0,17,23,40,8,23,15,12,12,5,4,77,Asseco Prokom 2 Gdynia,Sezon 2008/2009
2008-11-26 18:30,KS AZS AWF Katowice(w),80 : 77P,77,12,23,52.2,11,26,42.3,23,49,46.9,20,28,71.4,7,25,32,7,17,15,23,5,4,2,68,Asseco Prokom 2 Gdynia,Sezon 2008/2009
2008-11-29 15:45,Stal Stalowa Wola(d),77 : 74W,77,24,50,48.0,4,31,12.9,28,81,34.6,17,29,58.6,22,33,55,9,30,23,18,10,5,8,73,Asseco Prokom 2 Gdynia,Sezon 2008/2009
2008-12-13 13:00,Zastal Intermarche Zielona Góra(d),53 : 76P,53,12,23,52.2,8,31,25.8,20,54,37.0,5,9,55.6,8,20,28,9,22,19,24,9,3,0,40,Asseco Prokom 2 Gdynia,Sezon 2008/2009
2008-12-20 15:45,Miasto Szkła Krosno(d),60 : 78P,60,16,28,57.1,6,27,22.2,22,55,40.0,10,14,71.4,6,18,24,9,16,19,20,9,1,1,46,Asseco Prokom 2 Gdynia,Sezon 2008/2009
2009-01-04 15:45,Znicz Basket Pruszków(d),76 : 62W,76,19,33,57.6,8,23,34.8,27,56,48.2,14,25,56.0,9,29,38,10,18,22,17,11,3,0,81,Asseco Prokom 2 Gdynia,Sezon 2008/2009
2009-01-10 15:00,AZS PWSZ Kalisz(w),74 : 73P,73,12,30,40.0,12,31,38.7,24,61,39.3,13,18,72.2,8,25,33,12,13,16,11,5,2,2,72,Asseco Prokom 2 Gdynia,Sezon 2008/2009
2009-01-14 18:45,Żubry Białystok(d),77 : 60W,77,18,39,46.2,12,24,50.0,30,63,47.6,5,8,62.5,8,25,33,17,21,15,18,16,6,3,95,Asseco Prokom 2 Gdynia,Sezon 2008/2009
2009-01-17 18:00,GKS Tychy(w),94 : 84P,84,23,42,54.8,9,24,37.5,32,66,48.5,11,14,78.6,10,17,27,12,11,16,17,9,1,4,79,Asseco Prokom 2 Gdynia,Sezon 2008/2009
2009-01-24 15:45,Siarka Tarnobrzeg(d),66 : 78P,66,20,38,52.6,5,23,21.7,25,61,41.0,11,21,52.4,9,25,34,11,23,24,22,10,4,1,57,Asseco Prokom 2 Gdynia,Sezon 2008/2009
2009-01-31 17:30,PTG Sokół Łańcut(w),77 : 72P,72,12,34,35.3,10,28,35.7,22,62,35.5,18,24,75.0,13,25,38,9,24,20,16,6,3,2,66,Asseco Prokom 2 Gdynia,Sezon 2008/2009
2009-02-04 16:00,ŁKS Łódź(d),91 : 94P,91,11,28,39.3,20,39,51.3,31,67,46.3,9,18,50.0,4,24,28,15,26,21,22,8,4,2,79,Asseco Prokom 2 Gdynia,Sezon 2008/2009
2009-02-07 15:00,Polonia 2011 Warszawa(w),80 : 65P,65,17,36,47.2,5,25,20.0,22,61,36.1,16,19,84.2,9,27,36,10,18,18,25,10,3,3,57,Asseco Prokom 2 Gdynia,Sezon 2008/2009
2009-02-11 13:00,KS Sudety Jelenia Góra(d),68 : 76P,68,24,43,55.8,5,19,26.3,29,62,46.8,5,8,62.5,11,24,35,17,19,18,21,10,1,1,74,Asseco Prokom 2 Gdynia,Sezon 2008/2009
2009-02-18 18:00,MKS Dąbrowa Górnicza(w),117 : 69P,69,18,32,56.3,8,28,28.6,26,60,43.3,9,19,47.4,7,17,24,4,13,20,22,6,1,2,38,Asseco Prokom 2 Gdynia,Sezon 2008/2009
2009-02-25 16:00,KS AZS AWF Katowice(d),56 : 65P,56,17,42,40.5,4,24,16.7,21,66,31.8,10,14,71.4,12,25,37,9,15,11,13,8,5,0,53,Asseco Prokom 2 Gdynia,Sezon 2008/2009
2009-03-01 17:00,Stal Stalowa Wola(w),90 : 65P,65,15,47,31.9,8,21,38.1,23,68,33.8,11,18,61.1,13,25,38,12,17,13,21,6,4,7,52,Asseco Prokom 2 Gdynia,Sezon 2008/2009
2009-03-21 16:00,Znicz Basket Pruszków(w),74 : 72P,72,12,22,54.5,11,27,40.7,23,49,46.9,15,18,83.3,7,19,26,11,19,20,17,8,4,2,75,Asseco Prokom 2 Gdynia,Sezon 2008/2009
2009-03-22 18:00,Znicz Basket Pruszków(w),83 : 58P,58,12,25,48.0,7,26,26.9,19,51,37.3,13,22,59.1,8,16,24,8,8,23,21,6,3,2,37,Asseco Prokom 2 Gdynia,Sezon 2008/2009
2009-03-28 15:45,Znicz Basket Pruszków(d),78 : 76W,78,18,28,64.3,8,31,25.8,26,59,44.1,18,26,69.2,13,16,29,15,22,23,13,11,5,1,84,Asseco Prokom 2 Gdynia,Sezon 2008/2009
2009-03-29 15:45,Znicz Basket Pruszków(d),82 : 71W,82,10,25,40.0,9,33,27.3,19,58,32.8,35,49,71.4,15,23,38,11,26,38,14,18,3,0,85,Asseco Prokom 2 Gdynia,Sezon 2008/2009
2009-04-01 19:00,Znicz Basket Pruszków(w),71 : 69P,69,18,34,52.9,7,23,30.4,25,57,43.9,12,20,60.0,12,25,37,8,16,23,20,5,3,4,62,Asseco Prokom 2 Gdynia,Sezon 2008/2009
2008-09-20 15:00,Polonia 2011 Warszawa(w),75 : 58P,58,16,34,47.1,3,21,14.3,19,55,34.5,17,25,68.0,7,24,31,9,24,28,27,14,0,6,41,PTG Sokół Łańcut,Sezon 2008/2009
2008-09-27 17:30,KS Sudety Jelenia Góra(d),73 : 62W,73,18,33,54.5,9,24,37.5,27,57,47.4,10,13,76.9,8,27,35,21,23,19,15,13,8,5,102,PTG Sokół Łańcut,Sezon 2008/2009
2008-10-04 18:00,MKS Dąbrowa Górnicza(w),69 : 54P,54,16,35,45.7,5,17,29.4,21,52,40.4,7,8,87.5,7,18,25,8,13,12,14,6,6,2,53,PTG Sokół Łańcut,Sezon 2008/2009
2008-10-08 18:00,KS AZS AWF Katowice(d),64 : 51W,64,22,42,52.4,2,13,15.4,24,55,43.6,14,18,77.8,10,35,45,16,17,19,21,7,3,1,79,PTG Sokół Łańcut,Sezon 2008/2009
2008-10-12 17:30,Stal Stalowa Wola(d),69 : 63W,69,17,40,42.5,8,18,44.4,25,58,43.1,11,12,91.7,12,29,41,14,18,14,16,6,2,2,82,PTG Sokół Łańcut,Sezon 2008/2009
2008-10-18 17:30,Resovia Rzeszów(d),71 : 32W,71,24,43,55.8,5,19,26.3,29,62,46.8,8,11,72.7,12,32,44,17,16,17,15,18,1,3,100,PTG Sokół Łańcut,Sezon 2008/2009
2008-10-25 15:45,Asseco Prokom 2 Gdynia(w),87 : 81P,81,25,42,59.5,6,16,37.5,31,58,53.4,13,19,68.4,9,16,25,13,23,23,22,13,1,1,78,PTG Sokół Łańcut,Sezon 2008/2009
2008-10-29 18:00,Miasto Szkła Krosno(d),71 : 74P,71,14,30,46.7,8,23,34.8,22,53,41.5,19,22,86.4,11,20,31,10,23,19,19,10,4,3,73,PTG Sokół Łańcut,Sezon 2008/2009
2008-11-09 17:00,Znicz Basket Pruszków(w),68 : 75W,75,16,32,50.0,7,22,31.8,23,54,42.6,22,28,78.6,7,27,34,18,17,25,9,8,7,1,96,PTG Sokół Łańcut,Sezon 2008/2009
2008-11-15 17:30,AZS PWSZ Kalisz(d),76 : 69W,76,22,32,68.8,7,27,25.9,29,59,49.2,11,17,64.7,11,21,32,12,14,19,12,9,3,3,84,PTG Sokół Łańcut,Sezon 2008/2009
2008-11-22 18:00,Żubry Białystok(w),64 : 59P,59,19,38,50.0,4,20,20.0,23,58,39.7,9,12,75.0,7,28,35,9,21,20,18,4,3,7,54,PTG Sokół Łańcut,Sezon 2008/2009
2008-11-26 18:00,GKS Tychy(d),79 : 76W,79,27,50,54.0,2,22,9.1,29,72,40.3,19,34,55.9,14,36,50,15,23,26,15,8,3,2,82,PTG Sokół Łańcut,Sezon 2008/2009
2008-11-29 18:30,Siarka Tarnobrzeg(w),66 : 59P,59,14,30,46.7,3,13,23.1,17,43,39.5,22,31,71.0,7,25,32,8,28,29,17,3,8,0,58,PTG Sokół Łańcut,Sezon 2008/2009
2008-12-06 19:00,Zastal Intermarche Zielona Góra(w),78 : 51P,51,14,31,45.2,5,12,41.7,19,43,44.2,8,12,66.7,7,19,26,10,15,15,19,8,4,2,52,PTG Sokół Łańcut,Sezon 2008/2009
2008-12-14 17:30,ŁKS Łódź(d),67 : 78P,67,14,37,37.8,9,27,33.3,23,64,35.9,12,15,80.0,7,14,21,13,24,22,11,14,4,1,64,PTG Sokół Łańcut,Sezon 2008/2009
2008-12-20 17:30,Polonia 2011 Warszawa(d),58 : 66P,58,13,36,36.1,7,19,36.8,20,55,36.4,11,14,78.6,5,25,30,14,18,20,17,12,2,5,61,PTG Sokół Łańcut,Sezon 2008/2009
2009-01-03 18:30,KS Sudety Jelenia Góra(w),62 : 64W,64,18,37,48.6,6,17,35.3,24,54,44.4,10,17,58.8,6,24,30,10,18,20,13,6,5,0,65,PTG Sokół Łańcut,Sezon 2008/2009
2009-01-10 18:00,MKS Dąbrowa Górnicza(d),53 : 80P,53,17,37,45.9,4,23,17.4,21,60,35.0,7,14,50.0,8,25,33,10,13,16,19,7,5,4,43,PTG Sokół Łańcut,Sezon 2008/2009
2009-01-14 18:30,KS AZS AWF Katowice(w),62 : 79W,79,22,36,61.1,7,17,41.2,29,53,54.7,14,15,93.3,7,21,28,18,12,18,18,6,3,0,91,PTG Sokół Łańcut,Sezon 2008/2009
2009-01-18 17:00,Stal Stalowa Wola(w),84 : 56P,56,16,33,48.5,5,25,20.0,21,58,36.2,9,12,75.0,7,18,25,7,13,15,13,4,1,2,40,PTG Sokół Łańcut,Sezon 2008/2009
2009-01-31 17:30,Asseco Prokom 2 Gdynia(d),77 : 72W,77,23,48,47.9,5,21,23.8,28,69,40.6,16,23,69.6,12,23,35,16,20,23,13,11,2,3,80,PTG Sokół Łańcut,Sezon 2008/2009
2009-02-04 18:00,Miasto Szkła Krosno(w),84 : 70P,70,17,28,60.7,5,24,20.8,22,52,42.3,21,27,77.8,7,19,26,7,25,27,17,13,2,7,65,PTG Sokół Łańcut,Sezon 2008/2009
2009-02-07 17:30,Znicz Basket Pruszków(d),81 : 58W,81,24,41,58.5,6,18,33.3,30,59,50.8,15,23,65.2,11,28,39,15,20,25,12,12,2,4,100,PTG Sokół Łańcut,Sezon 2008/2009
2009-02-14 17:30,AZS PWSZ Kalisz(w),52 : 55W,55,12,33,36.4,7,15,46.7,19,48,39.6,10,11,90.9,5,29,34,9,13,16,18,6,3,2,59,PTG Sokół Łańcut,Sezon 2008/2009
2009-02-18 18:00,Resovia Rzeszów(w),56 : 63W,63,20,29,69.0,3,12,25.0,23,41,56.1,14,26,53.8,4,30,34,16,26,21,26,8,1,0,66,PTG Sokół Łańcut,Sezon 2008/2009
2009-02-21 17:30,Żubry Białystok(d),72 : 77P,72,15,35,42.9,9,24,37.5,24,59,40.7,15,24,62.5,11,20,31,15,14,22,10,10,2,2,76,PTG Sokół Łańcut,Sezon 2008/2009
2009-02-25 18:00,GKS Tychy(w),83 : 62P,62,16,34,47.1,4,22,18.2,20,56,35.7,18,23,78.3,8,19,27,7,9,20,18,9,3,3,49,PTG Sokół Łańcut,Sezon 2008/2009
2009-02-28 17:30,Siarka Tarnobrzeg(d),66 : 55W,66,20,35,57.1,6,19,31.6,26,54,48.1,8,13,61.5,6,34,40,15,20,19,21,6,3,1,76,PTG Sokół Łańcut,Sezon 2008/2009
2009-03-08 17:30,Zastal Intermarche Zielona Góra(d),51 : 88P,51,11,25,44.0,6,26,23.1,17,51,33.3,11,17,64.7,11,13,24,8,15,18,20,7,5,0,35,PTG Sokół Łańcut,Sezon 2008/2009
2009-03-14 18:30,ŁKS Łódź(w),89 : 62P,62,15,39,38.5,6,24,25.0,21,63,33.3,14,17,82.4,16,13,29,13,12,20,12,4,2,3,53,PTG Sokół Łańcut,Sezon 2008/2009
2008-09-21 18:00,Znicz Basket Pruszków(d),62 : 76P,62,17,36,47.2,4,16,25.0,21,52,40.4,16,26,61.5,10,22,32,12,26,20,14,12,1,0,64,Resovia Rzeszów,Sezon 2008/2009
2008-09-27 17:30,AZS PWSZ Kalisz(w),64 : 58P,58,18,35,51.4,2,13,15.4,20,48,41.7,16,23,69.6,7,22,29,9,18,26,17,6,0,0,50,Resovia Rzeszów,Sezon 2008/2009
2008-10-05 18:00,Żubry Białystok(d),71 : 77P,71,19,42,45.2,9,20,45.0,28,62,45.2,6,12,50.0,12,22,34,16,27,19,22,11,1,0,71,Resovia Rzeszów,Sezon 2008/2009
2008-10-08 18:00,GKS Tychy(w),87 : 58P,58,20,44,45.5,4,15,26.7,24,59,40.7,6,11,54.5,3,16,19,10,14,10,11,9,0,5,45,Resovia Rzeszów,Sezon 2008/2009
2008-10-12 18:00,Siarka Tarnobrzeg(d),70 : 82P,70,23,42,54.8,5,13,38.5,28,55,50.9,9,19,47.4,4,13,17,19,26,26,16,19,3,0,75,Resovia Rzeszów,Sezon 2008/2009
2008-10-18 17:30,PTG Sokół Łańcut(w),71 : 32P,32,9,40,22.5,2,16,12.5,11,56,19.6,8,11,72.7,13,20,33,5,17,16,20,10,3,1,15,Resovia Rzeszów,Sezon 2008/2009
2008-10-19 18:00,Asseco Prokom 2 Gdynia(d),74 : 70W,74,20,38,52.6,6,23,26.1,26,61,42.6,16,28,57.1,11,25,36,20,20,22,14,10,2,0,81,Resovia Rzeszów,Sezon 2008/2009
2008-10-26 18:00,ŁKS Łódź(d),26 : 103P,26,10,38,26.3,1,22,4.5,11,60,18.3,3,6,50.0,12,18,30,5,12,14,18,7,3,0,1,Resovia Rzeszów,Sezon 2008/2009
2008-10-29 18:00,Polonia 2011 Warszawa(w),107 : 49P,49,15,43,34.9,2,17,11.8,17,60,28.3,13,29,44.8,14,13,27,9,21,27,23,15,2,8,20,Resovia Rzeszów,Sezon 2008/2009
2008-11-09 18:00,KS Sudety Jelenia Góra(d),65 : 75P,65,19,45,42.2,4,16,25.0,23,61,37.7,15,25,60.0,9,18,27,11,22,23,9,11,3,0,60,Resovia Rzeszów,Sezon 2008/2009
2008-11-15 18:00,MKS Dąbrowa Górnicza(w),91 : 57P,57,12,34,35.3,9,22,40.9,21,56,37.5,6,12,50.0,6,11,17,7,23,18,19,11,3,7,35,Resovia Rzeszów,Sezon 2008/2009
2008-11-23 18:00,KS AZS AWF Katowice(d),68 : 81P,68,20,33,60.6,5,20,25.0,25,53,47.2,13,18,72.2,11,15,26,19,20,21,14,11,1,0,78,Resovia Rzeszów,Sezon 2008/2009
2008-11-26 18:00,Stal Stalowa Wola(w),80 : 82W,82,17,28,60.7,9,22,40.9,26,50,52.0,21,27,77.8,5,21,26,7,23,25,15,11,1,2,82,Resovia Rzeszów,Sezon 2008/2009
2008-11-30 18:00,Zastal Intermarche Zielona Góra(d),61 : 74P,61,18,34,52.9,5,18,27.8,23,52,44.2,10,19,52.6,3,17,20,12,25,21,15,14,0,0,54,Resovia Rzeszów,Sezon 2008/2009
2008-12-14 18:00,Miasto Szkła Krosno(w),82 : 77P,77,22,39,56.4,9,21,42.9,31,60,51.7,6,13,46.2,2,19,21,16,21,16,11,10,1,5,78,Resovia Rzeszów,Sezon 2008/2009
2008-12-20 18:00,Znicz Basket Pruszków(w),85 : 73P,73,19,31,61.3,9,28,32.1,28,59,47.5,8,10,80.0,6,10,16,12,17,14,13,13,3,2,71,Resovia Rzeszów,Sezon 2008/2009
2009-01-04 18:00,AZS PWSZ Kalisz(d),54 : 69P,54,15,38,39.5,5,24,20.8,20,62,32.3,9,12,75.0,10,21,31,10,16,12,13,13,2,0,52,Resovia Rzeszów,Sezon 2008/2009
2009-01-10 18:00,Żubry Białystok(w),81 : 70P,70,18,50,36.0,7,20,35.0,25,70,35.7,13,20,65.0,19,17,36,15,22,22,19,10,2,11,62,Resovia Rzeszów,Sezon 2008/2009
2009-01-14 18:00,GKS Tychy(d),62 : 76P,62,13,33,39.4,4,18,22.2,17,51,33.3,24,31,77.4,7,13,20,10,22,27,15,12,1,0,49,Resovia Rzeszów,Sezon 2008/2009
2009-01-17 18:00,Siarka Tarnobrzeg(w),98 : 59P,59,15,32,46.9,5,19,26.3,20,51,39.2,14,21,66.7,6,20,26,5,24,24,28,7,1,5,32,Resovia Rzeszów,Sezon 2008/2009
2009-01-31 19:00,ŁKS Łódź(w),80 : 60P,60,13,33,39.4,6,19,31.6,19,52,36.5,16,22,72.7,9,14,23,13,16,22,18,8,0,3,47,Resovia Rzeszów,Sezon 2008/2009
2009-02-04 18:00,Polonia 2011 Warszawa(d),62 : 92P,62,12,38,31.6,8,23,34.8,20,61,32.8,14,22,63.6,10,18,28,13,21,20,18,12,4,0,52,Resovia Rzeszów,Sezon 2008/2009
2009-02-07 18:30,KS Sudety Jelenia Góra(w),90 : 60P,60,13,30,43.3,5,21,23.8,18,51,35.3,19,31,61.3,9,15,24,6,17,25,13,8,2,0,42,Resovia Rzeszów,Sezon 2008/2009
2009-02-15 18:00,MKS Dąbrowa Górnicza(d),63 : 76P,63,16,35,45.7,5,29,17.2,21,64,32.8,16,21,76.2,19,17,36,18,26,20,14,11,4,0,70,Resovia Rzeszów,Sezon 2008/2009
2009-02-18 18:00,PTG Sokół Łańcut(d),56 : 63P,56,15,25,60.0,5,31,16.1,20,56,35.7,11,22,50.0,10,15,25,13,21,26,12,20,4,0,59,Resovia Rzeszów,Sezon 2008/2009
2009-02-21 18:00,KS AZS AWF Katowice(w),67 : 70W,70,17,37,45.9,8,18,44.4,25,55,45.5,12,24,50.0,9,13,22,8,19,20,11,8,3,1,58,Resovia Rzeszów,Sezon 2008/2009
2009-02-25 18:00,Stal Stalowa Wola(d),50 : 107P,50,12,31,38.7,5,21,23.8,17,52,32.7,11,17,64.7,4,13,17,9,18,19,14,11,4,0,36,Resovia Rzeszów,Sezon 2008/2009
2009-03-01 17:00,Zastal Intermarche Zielona Góra(w),101 : 41P,41,9,36,25.0,3,18,16.7,12,54,22.2,14,16,87.5,7,18,25,6,14,17,21,14,1,7,22,Resovia Rzeszów,Sezon 2008/2009
2009-03-15 18:00,Miasto Szkła Krosno(d),61 : 69P,61,17,41,41.5,5,25,20.0,22,66,33.3,12,18,66.7,11,25,36,18,22,21,8,16,2,0,75,Resovia Rzeszów,Sezon 2008/2009
2009-03-21 18:00,KS Sudety Jelenia Góra(w),80 : 71P,71,17,32,53.1,7,23,30.4,24,55,43.6,16,24,66.7,10,15,25,5,20,23,10,6,1,0,59,Resovia Rzeszów,Sezon 2008/2009
2009-03-22 18:00,KS Sudety Jelenia Góra(w),64 : 55P,55,20,32,62.5,2,15,13.3,22,47,46.8,9,26,34.6,7,17,24,8,17,18,11,13,0,0,47,Resovia Rzeszów,Sezon 2008/2009
2009-03-28 18:00,KS Sudety Jelenia Góra(d),79 : 80P,79,17,27,63.0,8,24,33.3,25,51,49.0,21,35,60.0,10,20,30,17,16,26,11,7,3,0,85,Resovia Rzeszów,Sezon 2008/2009
2008-09-21 17:00,Stal Stalowa Wola(w),69 : 62P,62,15,37,40.5,7,21,33.3,22,58,37.9,11,14,78.6,4,23,27,10,20,20,10,6,6,4,62,AZS PWSZ Kalisz,Sezon 2008/2009
2008-09-27 17:30,Resovia Rzeszów(d),64 : 58W,64,17,29,58.6,6,25,24.0,23,54,42.6,12,15,80.0,5,20,25,11,27,18,9,10,1,0,68,AZS PWSZ Kalisz,Sezon 2008/2009
2008-10-05 15:45,Asseco Prokom 2 Gdynia(w),60 : 65W,65,12,27,44.4,12,34,35.3,24,61,39.3,5,8,62.5,5,20,25,9,20,21,16,19,2,3,64,AZS PWSZ Kalisz,Sezon 2008/2009
2008-10-08 18:30,Miasto Szkła Krosno(d),58 : 91P,58,16,44,36.4,6,26,23.1,22,70,31.4,8,14,57.1,9,17,26,9,17,15,8,5,2,4,38,AZS PWSZ Kalisz,Sezon 2008/2009
2008-10-11 18:00,Znicz Basket Pruszków(w),77 : 81W,81,15,31,48.4,14,35,40.0,29,66,43.9,9,13,69.2,6,24,30,17,24,19,13,10,3,4,87,AZS PWSZ Kalisz,Sezon 2008/2009
2008-10-19 17:00,Zastal Intermarche Zielona Góra(w),57 : 44P,44,11,32,34.4,3,19,15.8,14,51,27.5,13,22,59.1,8,17,25,6,22,21,9,14,2,1,36,AZS PWSZ Kalisz,Sezon 2008/2009
2008-10-25 17:30,Żubry Białystok(d),50 : 62P,50,11,28,39.3,8,25,32.0,19,53,35.8,4,8,50.0,6,17,23,9,24,15,19,7,0,2,32,AZS PWSZ Kalisz,Sezon 2008/2009
2008-10-29 18:00,GKS Tychy(w),84 : 61P,61,17,36,47.2,4,11,36.4,21,47,44.7,15,20,75.0,5,18,23,8,21,20,19,11,1,5,54,AZS PWSZ Kalisz,Sezon 2008/2009
2008-11-09 16:00,Siarka Tarnobrzeg(d),73 : 75P,73,16,33,48.5,8,23,34.8,24,56,42.9,17,19,89.5,8,19,27,11,24,21,10,9,1,3,77,AZS PWSZ Kalisz,Sezon 2008/2009
2008-11-15 17:30,PTG Sokół Łańcut(w),76 : 69P,69,16,32,50.0,7,20,35.0,23,52,44.2,16,18,88.9,3,17,20,11,19,14,12,10,3,3,70,AZS PWSZ Kalisz,Sezon 2008/2009
2008-11-23 16:30,ŁKS Łódź(d),68 : 61W,68,12,24,50.0,9,32,28.1,21,56,37.5,17,21,81.0,3,20,23,16,16,23,9,11,1,1,71,AZS PWSZ Kalisz,Sezon 2008/2009
2008-11-26 18:00,Polonia 2011 Warszawa(w),92 : 67P,67,19,40,47.5,7,22,31.8,26,62,41.9,8,16,50.0,9,22,31,16,21,16,19,11,3,3,65,AZS PWSZ Kalisz,Sezon 2008/2009
2008-11-30 16:30,KS Sudety Jelenia Góra(d),67 : 76P,67,15,39,38.5,8,24,33.3,23,63,36.5,13,15,86.7,12,20,32,13,19,19,12,8,2,2,68,AZS PWSZ Kalisz,Sezon 2008/2009
2008-12-06 18:00,MKS Dąbrowa Górnicza(w),54 : 57W,57,9,32,28.1,8,23,34.8,17,55,30.9,15,25,60.0,4,30,34,4,19,24,14,9,2,7,44,AZS PWSZ Kalisz,Sezon 2008/2009
2008-12-13 17:30,KS AZS AWF Katowice(d),82 : 76W,82,17,25,68.0,12,23,52.2,29,48,60.4,12,14,85.7,5,24,29,12,24,19,14,9,4,0,101,AZS PWSZ Kalisz,Sezon 2008/2009
2009-01-04 18:00,Resovia Rzeszów(w),54 : 69W,69,20,40,50.0,6,16,37.5,26,56,46.4,11,12,91.7,8,27,35,13,13,16,16,5,6,0,81,AZS PWSZ Kalisz,Sezon 2008/2009
2009-01-10 15:00,Asseco Prokom 2 Gdynia(d),74 : 73W,74,18,37,48.6,11,27,40.7,29,64,45.3,5,8,62.5,6,30,36,13,16,14,9,9,2,2,87,AZS PWSZ Kalisz,Sezon 2008/2009
2009-01-14 18:00,Miasto Szkła Krosno(w),85 : 63P,63,15,32,46.9,8,24,33.3,23,56,41.1,9,12,75.0,2,22,24,10,18,15,11,7,3,3,60,AZS PWSZ Kalisz,Sezon 2008/2009
2009-01-17 17:30,Znicz Basket Pruszków(d),75 : 65W,75,15,37,40.5,9,22,40.9,24,59,40.7,18,22,81.8,11,28,39,10,19,23,10,11,0,4,86,AZS PWSZ Kalisz,Sezon 2008/2009
2009-01-21 18:00,Stal Stalowa Wola(d),65 : 82P,65,18,43,41.9,8,23,34.8,26,66,39.4,5,8,62.5,6,17,23,9,21,13,10,16,0,1,60,AZS PWSZ Kalisz,Sezon 2008/2009
2009-01-24 17:30,Zastal Intermarche Zielona Góra(d),35 : 70P,35,10,31,32.3,2,20,10.0,12,51,23.5,9,14,64.3,8,22,30,9,12,20,17,6,1,0,20,AZS PWSZ Kalisz,Sezon 2008/2009
2009-01-31 18:00,Żubry Białystok(w),102 : 75P,75,22,40,55.0,5,17,29.4,27,57,47.4,16,23,69.6,8,16,24,11,18,20,23,9,1,6,60,AZS PWSZ Kalisz,Sezon 2008/2009
2009-02-04 18:00,GKS Tychy(d),70 : 81P,70,15,36,41.7,8,20,40.0,23,56,41.1,16,23,69.6,7,21,28,8,19,20,8,10,2,1,70,AZS PWSZ Kalisz,Sezon 2008/2009
2009-02-07 18:00,Siarka Tarnobrzeg(w),90 : 62P,62,19,36,52.8,3,18,16.7,22,54,40.7,15,26,57.7,9,18,27,10,18,22,18,8,1,3,47,AZS PWSZ Kalisz,Sezon 2008/2009
2009-02-14 17:30,PTG Sokół Łańcut(d),52 : 55P,52,15,42,35.7,5,19,26.3,20,61,32.8,7,11,63.6,8,21,29,10,16,13,6,13,2,3,55,AZS PWSZ Kalisz,Sezon 2008/2009
2009-02-21 18:00,ŁKS Łódź(w),70 : 72W,72,17,32,53.1,7,21,33.3,24,53,45.3,17,22,77.3,5,18,23,13,25,21,15,8,3,2,70,AZS PWSZ Kalisz,Sezon 2008/2009
2009-02-25 18:00,Polonia 2011 Warszawa(d),74 : 95P,74,23,44,52.3,7,22,31.8,30,66,45.5,7,14,50.0,7,11,18,21,19,22,12,12,1,4,71,AZS PWSZ Kalisz,Sezon 2008/2009
2009-02-28 18:30,KS Sudety Jelenia Góra(w),73 : 58P,58,15,36,41.7,6,22,27.3,21,58,36.2,10,16,62.5,9,18,27,8,18,16,8,10,3,0,55,AZS PWSZ Kalisz,Sezon 2008/2009
2009-03-07 17:30,MKS Dąbrowa Górnicza(d),69 : 86P,69,21,32,65.6,6,19,31.6,27,51,52.9,9,14,64.3,2,21,23,16,29,22,17,7,1,0,70,AZS PWSZ Kalisz,Sezon 2008/2009
2009-03-14 18:00,KS AZS AWF Katowice(w),82 : 58P,58,21,44,47.7,4,11,36.4,25,55,45.5,4,6,66.7,10,20,30,13,13,9,14,8,0,2,63,AZS PWSZ Kalisz,Sezon 2008/2009
2009-03-21 17:30,KS AZS AWF Katowice(d),57 : 63P,57,16,32,50.0,5,23,21.7,21,55,38.2,10,14,71.4,5,22,27,13,28,19,13,8,0,1,54,AZS PWSZ Kalisz,Sezon 2008/2009
2009-03-22 16:30,KS AZS AWF Katowice(d),69 : 62W,69,21,33,63.6,6,20,30.0,27,53,50.9,9,15,60.0,5,29,34,13,16,18,7,8,4,1,89,AZS PWSZ Kalisz,Sezon 2008/2009
2009-03-28 18:00,KS AZS AWF Katowice(w),66 : 58P,58,18,33,54.5,3,17,17.6,21,50,42.0,13,19,68.4,4,20,24,10,22,23,8,6,4,1,59,AZS PWSZ Kalisz,Sezon 2008/2009
2009-03-29 18:00,KS AZS AWF Katowice(w),70 : 68P,68,24,45,53.3,5,21,23.8,29,66,43.9,5,10,50.0,7,18,25,14,18,19,12,9,2,2,64,AZS PWSZ Kalisz,Sezon 2008/2009
2008-09-20 18:00,KS AZS AWF Katowice(w),69 : 86W,86,21,39,53.8,8,21,38.1,29,60,48.3,20,26,76.9,9,21,30,18,19,17,17,8,2,0,90,Żubry Białystok,Sezon 2008/2009
2008-09-27 15:00,Stal Stalowa Wola(d),66 : 71P,66,18,33,54.5,7,25,28.0,25,58,43.1,9,14,64.3,11,20,31,10,16,19,14,10,2,1,67,Żubry Białystok,Sezon 2008/2009
2008-10-05 18:00,Resovia Rzeszów(w),71 : 77W,77,18,31,58.1,6,25,24.0,24,56,42.9,23,36,63.9,12,20,32,16,19,27,26,14,3,0,71,Żubry Białystok,Sezon 2008/2009
2008-10-08 18:00,Asseco Prokom 2 Gdynia(d),89 : 85W,89,27,40,67.5,5,19,26.3,32,59,54.2,20,29,69.0,13,15,28,18,21,25,19,7,3,0,90,Żubry Białystok,Sezon 2008/2009
2008-10-11 18:00,Miasto Szkła Krosno(w),69 : 64P,64,17,30,56.7,4,18,22.2,21,48,43.8,18,25,72.0,7,21,28,6,17,23,16,6,7,3,61,Żubry Białystok,Sezon 2008/2009
2008-10-19 18:00,Znicz Basket Pruszków(d),91 : 69W,91,32,52,61.5,3,19,15.8,35,71,49.3,18,24,75.0,15,23,38,13,16,22,2,5,4,3,107,Żubry Białystok,Sezon 2008/2009
2008-10-25 17:30,AZS PWSZ Kalisz(w),50 : 62W,62,11,24,45.8,7,24,29.2,18,48,37.5,19,23,82.6,7,19,26,5,16,23,13,10,2,0,58,Żubry Białystok,Sezon 2008/2009
2008-10-29 18:00,Zastal Intermarche Zielona Góra(w),69 : 72W,72,15,37,40.5,9,20,45.0,24,57,42.1,15,29,51.7,8,22,30,8,26,25,10,15,6,0,74,Żubry Białystok,Sezon 2008/2009
2008-11-09 18:00,GKS Tychy(d),81 : 77W,81,24,43,55.8,6,21,28.6,30,64,46.9,15,19,78.9,13,19,32,12,16,12,12,6,4,7,85,Żubry Białystok,Sezon 2008/2009
2008-11-15 18:30,Siarka Tarnobrzeg(w),72 : 68P,68,14,32,43.8,6,24,25.0,20,56,35.7,22,28,78.6,9,11,20,7,31,27,15,11,0,2,49,Żubry Białystok,Sezon 2008/2009
2008-11-22 18:00,PTG Sokół Łańcut(d),64 : 59W,64,15,39,38.5,6,22,27.3,21,61,34.4,16,18,88.9,10,25,35,12,21,20,14,10,7,3,72,Żubry Białystok,Sezon 2008/2009
2008-11-26 19:00,ŁKS Łódź(w),80 : 61P,61,14,32,43.8,7,33,21.2,21,65,32.3,12,17,70.6,7,16,23,10,15,17,9,7,3,3,46,Żubry Białystok,Sezon 2008/2009
2008-11-29 18:00,Polonia 2011 Warszawa(d),87 : 78W,87,21,43,48.8,9,20,45.0,30,63,47.6,18,24,75.0,7,23,30,22,16,25,17,6,3,6,92,Żubry Białystok,Sezon 2008/2009
2008-12-06 18:30,KS Sudety Jelenia Góra(w),74 : 54P,54,15,26,57.7,5,18,27.8,20,44,45.5,9,16,56.3,6,16,22,9,15,15,13,4,1,0,46,Żubry Białystok,Sezon 2008/2009
2008-12-13 18:00,MKS Dąbrowa Górnicza(d),73 : 80P,73,14,32,43.8,9,24,37.5,23,56,41.1,18,23,78.3,8,18,26,15,23,23,23,9,4,5,66,Żubry Białystok,Sezon 2008/2009
2008-12-20 18:00,KS AZS AWF Katowice(d),78 : 54W,78,21,35,60.0,5,21,23.8,26,56,46.4,21,29,72.4,16,21,37,16,16,22,21,17,6,2,95,Żubry Białystok,Sezon 2008/2009
2009-01-03 17:00,Stal Stalowa Wola(w),69 : 68P,68,16,31,51.6,6,22,27.3,22,53,41.5,18,24,75.0,10,24,34,6,23,19,19,7,1,1,60,Żubry Białystok,Sezon 2008/2009
2009-01-10 18:00,Resovia Rzeszów(d),81 : 70W,81,21,41,51.2,7,21,33.3,28,62,45.2,18,24,75.0,12,29,41,17,22,22,17,11,11,2,104,Żubry Białystok,Sezon 2008/2009
2009-01-14 18:45,Asseco Prokom 2 Gdynia(w),77 : 60P,60,20,44,45.5,4,26,15.4,24,70,34.3,8,19,42.1,17,24,41,9,15,21,18,12,3,6,50,Żubry Białystok,Sezon 2008/2009
2009-01-17 18:00,Miasto Szkła Krosno(d),72 : 82P,72,11,30,36.7,10,30,33.3,21,60,35.0,20,26,76.9,8,23,31,13,21,26,13,3,3,4,64,Żubry Białystok,Sezon 2008/2009
2009-01-25 17:00,Znicz Basket Pruszków(w),64 : 59P,59,13,32,40.6,5,25,20.0,18,57,31.6,18,28,64.3,9,25,34,4,22,21,15,7,2,4,42,Żubry Białystok,Sezon 2008/2009
2009-01-31 18:00,AZS PWSZ Kalisz(d),102 : 75W,102,31,51,60.8,9,20,45.0,40,71,56.3,13,18,72.2,10,21,31,15,20,18,14,15,6,1,119,Żubry Białystok,Sezon 2008/2009
2009-02-04 18:00,Zastal Intermarche Zielona Góra(d),63 : 84P,63,20,31,64.5,3,18,16.7,23,49,46.9,14,24,58.3,6,21,27,11,17,22,16,4,4,2,57,Żubry Białystok,Sezon 2008/2009
2009-02-07 18:00,GKS Tychy(w),75 : 68P,68,22,44,50.0,3,20,15.0,25,64,39.1,15,26,57.7,15,18,33,9,22,24,13,10,2,2,59,Żubry Białystok,Sezon 2008/2009
2009-02-14 18:00,Siarka Tarnobrzeg(d),68 : 74P,68,14,33,42.4,10,23,43.5,24,56,42.9,10,15,66.7,7,21,28,18,21,18,24,10,6,7,69,Żubry Białystok,Sezon 2008/2009
2009-02-21 17:30,PTG Sokół Łańcut(w),72 : 77W,77,14,25,56.0,12,29,41.4,26,54,48.1,13,19,68.4,8,21,29,12,22,14,13,7,2,2,80,Żubry Białystok,Sezon 2008/2009
2009-02-25 18:00,ŁKS Łódź(d),72 : 60W,72,17,40,42.5,7,23,30.4,24,63,38.1,17,22,77.3,8,33,41,9,20,27,17,10,10,1,81,Żubry Białystok,Sezon 2008/2009
2009-02-28 15:00,Polonia 2011 Warszawa(w),79 : 59P,59,19,44,43.2,4,19,21.1,23,63,36.5,9,21,42.9,14,21,35,7,19,22,17,8,5,5,45,Żubry Białystok,Sezon 2008/2009
2009-03-07 18:00,KS Sudety Jelenia Góra(d),85 : 68W,85,17,31,54.8,14,32,43.8,31,63,49.2,9,11,81.8,7,19,26,20,20,20,12,8,4,1,97,Żubry Białystok,Sezon 2008/2009
2009-03-14 18:00,MKS Dąbrowa Górnicza(w),56 : 66W,66,16,33,48.5,8,18,44.4,24,51,47.1,10,17,58.8,5,26,31,12,22,19,17,9,4,3,71,Żubry Białystok,Sezon 2008/2009
2009-03-21 15:00,Polonia 2011 Warszawa(w),70 : 61P,61,14,36,38.9,3,25,12.0,17,61,27.9,24,29,82.8,8,25,33,7,22,25,14,12,3,5,53,Żubry Białystok,Sezon 2008/2009
2009-03-22 15:00,Polonia 2011 Warszawa(w),91 : 88P,88,21,37,56.8,9,24,37.5,30,61,49.2,19,22,86.4,7,20,27,12,17,21,15,6,0,3,84,Żubry Białystok,Sezon 2008/2009
2009-03-28 18:00,Polonia 2011 Warszawa(d),91 : 98P,91,19,44,43.2,14,29,48.3,33,73,45.2,11,22,50.0,7,19,26,19,28,18,13,18,8,4,98,Żubry Białystok,Sezon 2008/2009
2008-09-20 18:00,Zastal Intermarche Zielona Góra(d),90 : 91P,90,24,46,52.2,9,22,40.9,33,68,48.5,15,22,68.2,11,22,33,10,28,19,11,7,3,2,90,ŁKS Łódź,Sezon 2008/2009
2008-09-27 17:00,Polonia 2011 Warszawa(d),67 : 98P,67,16,42,38.1,5,16,31.3,21,58,36.2,20,33,60.6,9,16,25,7,32,22,13,7,0,2,43,ŁKS Łódź,Sezon 2008/2009
2008-10-04 18:30,KS Sudety Jelenia Góra(w),74 : 75W,75,17,32,53.1,7,15,46.7,24,47,51.1,20,25,80.0,6,18,24,9,26,19,11,7,0,0,76,ŁKS Łódź,Sezon 2008/2009
2008-10-09 18:00,MKS Dąbrowa Górnicza(d),76 : 73W,76,16,35,45.7,6,19,31.6,22,54,40.7,26,36,72.2,12,27,39,19,27,27,18,6,3,1,83,ŁKS Łódź,Sezon 2008/2009
2008-10-12 18:00,KS AZS AWF Katowice(w),70 : 77W,77,22,28,78.6,5,13,38.5,27,41,65.9,18,24,75.0,5,17,22,8,19,18,15,7,3,0,82,ŁKS Łódź,Sezon 2008/2009
2008-10-17 18:00,Stal Stalowa Wola(d),84 : 69W,84,24,40,60.0,7,16,43.8,31,56,55.4,15,24,62.5,9,32,41,19,18,19,11,5,3,1,107,ŁKS Łódź,Sezon 2008/2009
2008-10-26 18:00,Resovia Rzeszów(w),26 : 103W,103,22,36,61.1,16,24,66.7,38,60,63.3,11,14,78.6,5,37,42,27,14,12,12,10,0,0,145,ŁKS Łódź,Sezon 2008/2009
2008-10-29 18:00,Asseco Prokom 2 Gdynia(d),79 : 93P,79,28,48,58.3,5,20,25.0,33,68,48.5,8,11,72.7,9,26,35,19,18,16,15,10,4,3,94,ŁKS Łódź,Sezon 2008/2009
2008-11-09 18:00,Miasto Szkła Krosno(w),80 : 69P,69,16,36,44.4,6,22,27.3,22,58,37.9,19,31,61.3,9,21,30,12,24,28,17,8,0,7,54,ŁKS Łódź,Sezon 2008/2009
2008-11-16 16:00,Znicz Basket Pruszków(d),92 : 83W,92,21,40,52.5,4,16,25.0,25,56,44.6,38,45,84.4,14,23,37,16,22,29,12,13,1,0,109,ŁKS Łódź,Sezon 2008/2009
2008-11-23 16:30,AZS PWSZ Kalisz(w),68 : 61P,61,20,36,55.6,2,15,13.3,22,51,43.1,15,21,71.4,8,32,40,8,22,17,15,7,1,1,67,ŁKS Łódź,Sezon 2008/2009
2008-11-26 19:00,Żubry Białystok(d),80 : 61W,80,23,46,50.0,8,18,44.4,31,64,48.4,10,13,76.9,12,33,45,19,17,13,15,10,3,3,106,ŁKS Łódź,Sezon 2008/2009
2008-11-29 18:00,GKS Tychy(w),87 : 80P,80,25,46,54.3,8,15,53.3,33,61,54.1,6,9,66.7,7,25,32,18,19,13,16,5,2,3,90,ŁKS Łódź,Sezon 2008/2009
2008-12-06 17:30,Siarka Tarnobrzeg(d),72 : 76P,72,20,45,44.4,5,28,17.9,25,73,34.2,17,20,85.0,13,23,36,15,25,21,18,7,2,8,63,ŁKS Łódź,Sezon 2008/2009
2008-12-14 17:30,PTG Sokół Łańcut(w),67 : 78W,78,27,40,67.5,2,17,11.8,29,57,50.9,18,22,81.8,15,29,44,11,22,24,19,7,1,4,90,ŁKS Łódź,Sezon 2008/2009
2008-12-20 19:00,Zastal Intermarche Zielona Góra(w),61 : 64W,64,17,39,43.6,6,16,37.5,23,55,41.8,12,15,80.0,9,26,35,14,21,15,13,7,3,0,75,ŁKS Łódź,Sezon 2008/2009
2009-01-03 15:00,Polonia 2011 Warszawa(w),81 : 80P,80,16,36,44.4,7,25,28.0,23,61,37.7,27,42,64.3,16,24,40,12,37,32,17,11,3,4,76,ŁKS Łódź,Sezon 2008/2009
2009-01-10 18:00,KS Sudety Jelenia Góra(d),78 : 60W,78,23,44,52.3,6,21,28.6,29,65,44.6,14,22,63.6,14,17,31,14,16,20,13,10,2,2,78,ŁKS Łódź,Sezon 2008/2009
2009-01-14 18:00,MKS Dąbrowa Górnicza(w),68 : 74W,74,22,38,57.9,5,10,50.0,27,48,56.3,15,29,51.7,9,25,34,8,17,25,16,13,2,2,80,ŁKS Łódź,Sezon 2008/2009
2009-01-17 17:30,KS AZS AWF Katowice(d),79 : 63W,79,30,49,61.2,4,12,33.3,34,61,55.7,7,12,58.3,10,31,41,15,18,19,19,9,2,3,95,ŁKS Łódź,Sezon 2008/2009
2009-01-25 17:00,Stal Stalowa Wola(w),75 : 72P,72,22,46,47.8,5,16,31.3,27,62,43.5,13,15,86.7,7,23,30,12,28,15,14,7,0,9,70,ŁKS Łódź,Sezon 2008/2009
2009-01-31 19:00,Resovia Rzeszów(d),80 : 60W,80,28,39,71.8,5,17,29.4,33,56,58.9,9,13,69.2,7,21,28,24,22,16,14,13,3,0,107,ŁKS Łódź,Sezon 2008/2009
2009-02-04 16:00,Asseco Prokom 2 Gdynia(w),91 : 94W,94,27,49,55.1,5,16,31.3,32,65,49.2,25,33,75.8,10,31,41,14,21,26,20,18,2,4,108,ŁKS Łódź,Sezon 2008/2009
2009-02-08 17:00,Miasto Szkła Krosno(d),94 : 82W,94,26,47,55.3,8,17,47.1,34,64,53.1,18,22,81.8,12,24,36,12,22,25,11,6,0,0,103,ŁKS Łódź,Sezon 2008/2009
2009-02-11 19:00,Znicz Basket Pruszków(w),77 : 72P,72,19,37,51.4,5,19,26.3,24,56,42.9,19,25,76.0,10,21,31,16,26,22,18,7,1,0,71,ŁKS Łódź,Sezon 2008/2009
2009-02-21 18:00,AZS PWSZ Kalisz(d),70 : 72P,70,19,45,42.2,4,14,28.6,23,59,39.0,20,28,71.4,13,21,34,13,26,22,14,10,2,3,71,ŁKS Łódź,Sezon 2008/2009
2009-02-25 18:00,Żubry Białystok(w),72 : 60P,60,14,42,33.3,4,17,23.5,18,59,30.5,20,23,87.0,6,29,35,7,27,20,16,10,1,10,53,ŁKS Łódź,Sezon 2008/2009
2009-03-03 19:00,GKS Tychy(d),92 : 69W,92,24,45,53.3,9,27,33.3,33,72,45.8,17,23,73.9,13,28,41,17,18,18,7,6,0,2,104,ŁKS Łódź,Sezon 2008/2009
2009-03-07 18:30,Siarka Tarnobrzeg(w),81 : 74P,74,19,39,48.7,8,25,32.0,27,64,42.2,12,23,52.2,8,33,41,9,25,23,20,9,0,6,65,ŁKS Łódź,Sezon 2008/2009
2009-03-14 18:30,PTG Sokół Łańcut(d),89 : 62W,89,27,42,64.3,10,26,38.5,37,68,54.4,5,7,71.4,14,24,38,18,20,12,12,9,3,2,112,ŁKS Łódź,Sezon 2008/2009
2009-03-21 18:00,GKS Tychy(w),81 : 91W,91,24,48,50.0,6,13,46.2,30,61,49.2,25,31,80.6,5,29,34,16,23,26,13,6,0,4,97,ŁKS Łódź,Sezon 2008/2009
2009-03-22 18:00,GKS Tychy(w),80 : 71P,71,22,45,48.9,4,10,40.0,26,55,47.3,15,21,71.4,11,22,33,13,26,22,21,6,1,3,68,ŁKS Łódź,Sezon 2008/2009
2009-03-28 16:00,GKS Tychy(d),65 : 64W,65,21,44,47.7,4,16,25.0,25,60,41.7,11,22,50.0,8,21,29,12,21,21,9,6,0,3,57,ŁKS Łódź,Sezon 2008/2009
2009-03-29 16:00,GKS Tychy(d),80 : 88P,80,18,34,52.9,7,24,29.2,25,58,43.1,23,30,76.7,9,24,33,12,20,22,13,4,1,4,77,ŁKS Łódź,Sezon 2008/2009
2009-04-01 19:00,GKS Tychy(w),89 : 85P,85,23,49,46.9,8,15,53.3,31,64,48.4,15,26,57.7,8,25,33,14,26,21,14,6,1,6,81,ŁKS Łódź,Sezon 2008/2009
2008-09-20 18:00,Żubry Białystok(d),69 : 86P,69,19,45,42.2,5,24,20.8,24,69,34.8,16,20,80.0,13,10,23,10,21,16,13,11,3,0,54,KS AZS AWF Katowice,Sezon 2008/2009
2008-09-27 18:00,GKS Tychy(w),85 : 69P,69,19,45,42.2,7,24,29.2,26,69,37.7,10,21,47.6,14,13,27,11,20,22,10,13,3,10,59,KS AZS AWF Katowice,Sezon 2008/2009
2008-10-04 18:00,Siarka Tarnobrzeg(d),75 : 71W,75,22,35,62.9,7,31,22.6,29,66,43.9,10,12,83.3,6,20,26,10,30,17,3,11,0,0,80,KS AZS AWF Katowice,Sezon 2008/2009
2008-10-08 18:00,PTG Sokół Łańcut(w),64 : 51P,51,14,36,38.9,6,29,20.7,20,65,30.8,5,11,45.5,9,19,28,9,19,17,13,18,1,3,43,KS AZS AWF Katowice,Sezon 2008/2009
2008-10-12 18:00,ŁKS Łódź(d),70 : 77P,70,12,29,41.4,11,25,44.0,23,54,42.6,13,16,81.3,10,12,22,7,21,18,16,9,4,0,62,KS AZS AWF Katowice,Sezon 2008/2009
2008-10-18 15:00,Polonia 2011 Warszawa(w),91 : 71P,71,13,31,41.9,11,31,35.5,24,62,38.7,12,22,54.5,11,25,36,11,22,26,25,10,5,5,60,KS AZS AWF Katowice,Sezon 2008/2009
2008-10-25 18:00,KS Sudety Jelenia Góra(d),80 : 75W,80,18,35,51.4,11,33,33.3,29,68,42.6,11,18,61.1,7,20,27,14,23,19,8,18,5,0,90,KS AZS AWF Katowice,Sezon 2008/2009
2008-10-29 18:00,MKS Dąbrowa Górnicza(w),72 : 74W,74,22,38,57.9,6,17,35.3,28,55,50.9,12,16,75.0,4,16,20,9,22,18,13,10,1,6,70,KS AZS AWF Katowice,Sezon 2008/2009
2008-11-09 18:30,Zastal Intermarche Zielona Góra(d),78 : 72W,78,17,43,39.5,10,17,58.8,27,60,45.0,14,25,56.0,8,18,26,10,22,22,6,11,4,2,79,KS AZS AWF Katowice,Sezon 2008/2009
2008-11-16 18:00,Stal Stalowa Wola(d),79 : 62W,79,23,41,56.1,6,21,28.6,29,62,46.8,15,18,83.3,8,17,25,13,13,12,12,13,2,2,84,KS AZS AWF Katowice,Sezon 2008/2009
2008-11-23 18:00,Resovia Rzeszów(w),68 : 81W,81,17,30,56.7,12,20,60.0,29,50,58.0,11,19,57.9,5,13,18,20,21,20,15,6,2,0,83,KS AZS AWF Katowice,Sezon 2008/2009
2008-11-26 18:30,Asseco Prokom 2 Gdynia(d),80 : 77W,80,25,50,50.0,7,21,33.3,32,71,45.1,9,12,75.0,10,14,24,12,21,15,9,15,2,4,82,KS AZS AWF Katowice,Sezon 2008/2009
2008-11-29 18:00,Miasto Szkła Krosno(w),85 : 74P,74,14,32,43.8,9,23,39.1,23,55,41.8,19,28,67.9,6,12,18,11,17,22,11,7,0,5,58,KS AZS AWF Katowice,Sezon 2008/2009
2008-12-06 18:30,Znicz Basket Pruszków(d),67 : 71P,67,14,33,42.4,7,22,31.8,21,55,38.2,18,27,66.7,10,16,26,11,20,24,14,13,4,1,64,KS AZS AWF Katowice,Sezon 2008/2009
2008-12-13 17:30,AZS PWSZ Kalisz(w),82 : 76P,76,20,45,44.4,6,19,31.6,26,64,40.6,18,23,78.3,11,16,27,8,19,22,11,7,0,4,64,KS AZS AWF Katowice,Sezon 2008/2009
2008-12-20 18:00,Żubry Białystok(w),78 : 54P,54,20,39,51.3,3,26,11.5,23,65,35.4,5,7,71.4,14,15,29,9,22,15,26,15,2,6,39,KS AZS AWF Katowice,Sezon 2008/2009
2009-01-04 17:00,GKS Tychy(d),64 : 85P,64,13,43,30.2,8,23,34.8,21,66,31.8,14,20,70.0,10,19,29,9,18,16,10,9,1,3,51,KS AZS AWF Katowice,Sezon 2008/2009
2009-01-10 18:30,Siarka Tarnobrzeg(w),72 : 67P,67,22,44,50.0,4,14,28.6,26,58,44.8,11,19,57.9,10,13,23,11,26,25,22,10,2,6,51,KS AZS AWF Katowice,Sezon 2008/2009
2009-01-14 18:30,PTG Sokół Łańcut(d),62 : 79P,62,16,31,51.6,7,28,25.0,23,59,39.0,9,10,90.0,10,16,26,16,19,8,10,9,3,0,69,KS AZS AWF Katowice,Sezon 2008/2009
2009-01-17 17:30,ŁKS Łódź(w),79 : 63P,63,13,36,36.1,8,27,29.6,21,63,33.3,13,16,81.3,12,11,23,12,19,18,16,11,3,2,51,KS AZS AWF Katowice,Sezon 2008/2009
2009-01-24 18:00,Polonia 2011 Warszawa(d),78 : 84P,78,16,37,43.2,12,31,38.7,28,68,41.2,10,16,62.5,9,23,32,12,16,16,9,10,6,3,83,KS AZS AWF Katowice,Sezon 2008/2009
2009-01-31 18:30,KS Sudety Jelenia Góra(w),86 : 74P,74,18,29,62.1,11,25,44.0,29,54,53.7,5,9,55.6,3,11,14,15,15,14,12,12,1,0,75,KS AZS AWF Katowice,Sezon 2008/2009
2009-02-04 18:30,MKS Dąbrowa Górnicza(d),64 : 72P,64,17,32,53.1,7,28,25.0,24,60,40.0,9,13,69.2,5,17,22,13,20,16,15,5,5,1,54,KS AZS AWF Katowice,Sezon 2008/2009
2009-02-08 17:00,Zastal Intermarche Zielona Góra(w),112 : 57P,57,13,34,38.2,6,19,31.6,19,53,35.8,13,20,65.0,7,10,17,10,12,23,14,6,1,1,36,KS AZS AWF Katowice,Sezon 2008/2009
2009-02-14 17:00,Stal Stalowa Wola(w),94 : 75P,75,18,34,52.9,7,17,41.2,25,51,49.0,18,28,64.3,4,9,13,7,25,26,13,8,1,4,55,KS AZS AWF Katowice,Sezon 2008/2009
2009-02-21 18:00,Resovia Rzeszów(d),67 : 70P,67,18,32,56.3,8,25,32.0,26,57,45.6,7,15,46.7,12,22,34,15,20,16,17,7,1,3,68,KS AZS AWF Katowice,Sezon 2008/2009
2009-02-25 16:00,Asseco Prokom 2 Gdynia(w),56 : 65W,65,23,44,52.3,5,20,25.0,28,64,43.8,4,8,50.0,10,30,40,13,11,15,13,10,0,5,75,KS AZS AWF Katowice,Sezon 2008/2009
2009-02-28 18:00,Miasto Szkła Krosno(d),66 : 93P,66,14,32,43.8,7,23,30.4,21,55,38.2,17,29,58.6,10,18,28,7,19,19,16,10,4,1,53,KS AZS AWF Katowice,Sezon 2008/2009
2009-03-04 18:00,Znicz Basket Pruszków(w),59 : 55P,55,15,40,37.5,5,15,33.3,20,55,36.4,10,15,66.7,13,16,29,8,18,17,14,12,2,5,52,KS AZS AWF Katowice,Sezon 2008/2009
2009-03-14 18:00,AZS PWSZ Kalisz(d),82 : 58W,82,25,34,73.5,8,14,57.1,33,48,68.8,8,10,80.0,5,20,25,17,11,10,13,9,3,0,106,KS AZS AWF Katowice,Sezon 2008/2009
2009-03-21 17:30,AZS PWSZ Kalisz(w),57 : 63W,63,12,23,52.2,6,19,31.6,18,42,42.9,21,32,65.6,7,23,30,7,19,28,12,6,1,0,60,KS AZS AWF Katowice,Sezon 2008/2009
2009-03-22 16:30,AZS PWSZ Kalisz(w),69 : 62P,62,13,34,38.2,10,27,37.0,23,61,37.7,6,13,46.2,9,19,28,13,18,16,12,5,1,4,52,KS AZS AWF Katowice,Sezon 2008/2009
2009-03-28 18:00,AZS PWSZ Kalisz(d),66 : 58W,66,16,35,45.7,8,28,28.6,24,63,38.1,10,16,62.5,10,23,33,10,24,19,10,4,2,4,60,KS AZS AWF Katowice,Sezon 2008/2009
2009-03-29 18:00,AZS PWSZ Kalisz(d),70 : 68W,70,12,27,44.4,12,38,31.6,24,65,36.9,10,15,66.7,13,29,42,12,19,15,13,11,2,2,78,KS AZS AWF Katowice,Sezon 2008/2009
2008-09-21 18:00,Resovia Rzeszów(w),62 : 76W,76,26,40,65.0,2,19,10.5,28,59,47.5,18,27,66.7,12,22,34,11,22,26,20,9,4,0,74,Znicz Basket Pruszków,Sezon 2008/2009
2008-09-27 18:00,Asseco Prokom 2 Gdynia(d),92 : 63W,92,28,45,62.2,7,19,36.8,35,64,54.7,15,18,83.3,11,23,34,18,20,21,21,18,2,1,111,Znicz Basket Pruszków,Sezon 2008/2009
2008-10-04 18:00,Miasto Szkła Krosno(w),88 : 62P,62,19,37,51.4,4,16,25.0,23,53,43.4,12,18,66.7,7,20,27,8,22,20,18,6,2,0,51,Znicz Basket Pruszków,Sezon 2008/2009
2008-10-08 18:00,Zastal Intermarche Zielona Góra(w),87 : 73P,73,19,40,47.5,7,23,30.4,26,63,41.3,14,18,77.8,6,18,24,12,25,16,12,8,2,1,66,Znicz Basket Pruszków,Sezon 2008/2009
2008-10-11 18:00,AZS PWSZ Kalisz(d),77 : 81P,77,24,39,61.5,5,21,23.8,29,60,48.3,14,21,66.7,8,30,38,12,19,24,21,7,4,3,79,Znicz Basket Pruszków,Sezon 2008/2009
2008-10-19 18:00,Żubry Białystok(w),91 : 69P,69,21,44,47.7,6,22,27.3,27,66,40.9,9,13,69.2,10,20,30,11,22,16,9,1,3,4,62,Znicz Basket Pruszków,Sezon 2008/2009
2008-10-26 17:00,GKS Tychy(d),80 : 76W,80,15,33,45.5,11,23,47.8,26,56,46.4,17,22,77.3,9,20,29,14,33,22,14,11,0,3,85,Znicz Basket Pruszków,Sezon 2008/2009
2008-10-29 18:00,Siarka Tarnobrzeg(w),84 : 77P,77,26,46,56.5,4,17,23.5,30,63,47.6,13,16,81.3,7,18,25,6,28,21,16,16,2,4,74,Znicz Basket Pruszków,Sezon 2008/2009
2008-11-09 17:00,PTG Sokół Łańcut(d),68 : 75P,68,19,48,39.6,6,21,28.6,25,69,36.2,12,15,80.0,15,25,40,7,25,17,11,6,1,7,64,Znicz Basket Pruszków,Sezon 2008/2009
2008-11-16 16:00,ŁKS Łódź(w),92 : 83P,83,19,41,46.3,12,22,54.5,31,63,49.2,9,12,75.0,9,18,27,14,29,21,15,6,0,1,80,Znicz Basket Pruszków,Sezon 2008/2009
2008-11-22 15:00,Polonia 2011 Warszawa(w),89 : 70P,70,19,41,46.3,7,22,31.8,26,63,41.3,11,20,55.0,10,26,36,10,25,21,19,8,3,6,62,Znicz Basket Pruszków,Sezon 2008/2009
2008-11-26 18:30,KS Sudety Jelenia Góra(w),74 : 85W,85,17,28,60.7,11,27,40.7,28,55,50.9,18,19,94.7,7,17,24,18,21,16,7,11,1,0,104,Znicz Basket Pruszków,Sezon 2008/2009
2008-11-29 18:00,MKS Dąbrowa Górnicza(d),68 : 82P,68,19,41,46.3,3,18,16.7,22,59,37.3,21,28,75.0,13,19,32,7,22,26,18,10,1,3,56,Znicz Basket Pruszków,Sezon 2008/2009
2008-12-06 18:30,KS AZS AWF Katowice(w),67 : 71W,71,18,37,48.6,6,16,37.5,24,53,45.3,17,23,73.9,8,19,27,7,25,20,16,7,1,4,62,Znicz Basket Pruszków,Sezon 2008/2009
2008-12-13 17:00,Stal Stalowa Wola(w),78 : 68P,68,24,40,60.0,3,14,21.4,27,54,50.0,11,17,64.7,8,20,28,10,24,23,18,9,4,4,68,Znicz Basket Pruszków,Sezon 2008/2009
2008-12-20 18:00,Resovia Rzeszów(d),85 : 73W,85,29,41,70.7,5,11,45.5,34,52,65.4,12,16,75.0,9,24,33,18,14,17,20,9,2,3,105,Znicz Basket Pruszków,Sezon 2008/2009
2009-01-04 15:45,Asseco Prokom 2 Gdynia(w),76 : 62P,62,17,40,42.5,6,21,28.6,23,61,37.7,10,12,83.3,6,19,25,11,22,18,16,11,0,3,53,Znicz Basket Pruszków,Sezon 2008/2009
2009-01-14 18:00,Zastal Intermarche Zielona Góra(d),75 : 81P,75,17,32,53.1,6,21,28.6,23,53,43.4,23,38,60.5,6,20,26,8,29,31,13,8,0,0,59,Znicz Basket Pruszków,Sezon 2008/2009
2009-01-17 17:30,AZS PWSZ Kalisz(w),75 : 65P,65,22,41,53.7,4,20,20.0,26,61,42.6,9,12,75.0,8,19,27,7,23,19,12,3,4,0,56,Znicz Basket Pruszków,Sezon 2008/2009
2009-01-21 19:00,Miasto Szkła Krosno(d),91 : 87W,91,20,40,50.0,9,25,36.0,29,65,44.6,24,34,70.6,5,38,43,11,26,29,17,2,7,0,91,Znicz Basket Pruszków,Sezon 2008/2009
2009-01-25 17:00,Żubry Białystok(d),64 : 59W,64,17,38,44.7,5,15,33.3,22,53,41.5,15,26,57.7,5,28,33,11,22,22,17,11,4,2,64,Znicz Basket Pruszków,Sezon 2008/2009
2009-01-31 18:00,GKS Tychy(w),91 : 79P,79,21,46,45.7,6,17,35.3,27,63,42.9,19,24,79.2,15,15,30,11,15,21,14,7,2,2,74,Znicz Basket Pruszków,Sezon 2008/2009
2009-02-04 19:00,Siarka Tarnobrzeg(d),92 : 66W,92,23,33,69.7,8,18,44.4,31,51,60.8,22,30,73.3,9,22,31,10,26,23,17,10,3,0,101,Znicz Basket Pruszków,Sezon 2008/2009
2009-02-07 17:30,PTG Sokół Łańcut(w),81 : 58P,58,16,39,41.0,6,16,37.5,22,55,40.0,8,17,47.1,3,18,21,13,25,20,14,10,4,2,50,Znicz Basket Pruszków,Sezon 2008/2009
2009-02-11 19:00,ŁKS Łódź(d),77 : 72W,77,20,37,54.1,6,19,31.6,26,56,46.4,19,23,82.6,6,21,27,15,22,26,13,11,0,1,83,Znicz Basket Pruszków,Sezon 2008/2009
2009-02-17 19:00,Polonia 2011 Warszawa(d),82 : 80W,82,19,34,55.9,7,22,31.8,26,56,46.4,23,29,79.3,4,21,25,12,17,26,16,13,2,4,82,Znicz Basket Pruszków,Sezon 2008/2009
2009-02-25 18:00,KS Sudety Jelenia Góra(d),71 : 74P,71,21,44,47.7,4,17,23.5,25,61,41.0,17,19,89.5,8,22,30,12,23,21,12,11,1,1,75,Znicz Basket Pruszków,Sezon 2008/2009
2009-02-28 18:00,MKS Dąbrowa Górnicza(w),83 : 54P,54,12,34,35.3,4,25,16.0,16,59,27.1,18,27,66.7,13,15,28,4,21,26,17,7,2,2,26,Znicz Basket Pruszków,Sezon 2008/2009
2009-03-04 18:00,KS AZS AWF Katowice(d),59 : 55W,59,20,35,57.1,3,15,20.0,23,50,46.0,10,14,71.4,11,21,32,12,17,18,19,10,5,2,68,Znicz Basket Pruszków,Sezon 2008/2009
2009-03-14 18:00,Stal Stalowa Wola(d),97 : 72W,97,24,47,51.1,11,19,57.9,35,66,53.0,16,20,80.0,9,22,31,19,26,21,17,12,2,1,109,Znicz Basket Pruszków,Sezon 2008/2009
2009-03-21 16:00,Asseco Prokom 2 Gdynia(d),74 : 72W,74,17,33,51.5,6,23,26.1,23,56,41.1,22,26,84.6,12,18,30,12,20,19,12,12,2,4,81,Znicz Basket Pruszków,Sezon 2008/2009
2009-03-22 18:00,Asseco Prokom 2 Gdynia(d),83 : 58W,83,26,41,63.4,9,20,45.0,35,61,57.4,4,6,66.7,7,28,35,21,23,8,16,13,2,3,110,Znicz Basket Pruszków,Sezon 2008/2009
2009-03-28 15:45,Asseco Prokom 2 Gdynia(w),78 : 76P,76,8,19,42.1,13,26,50.0,21,45,46.7,21,27,77.8,7,22,29,7,23,22,19,6,1,5,70,Znicz Basket Pruszków,Sezon 2008/2009
2009-03-29 15:45,Asseco Prokom 2 Gdynia(w),82 : 71P,71,20,44,45.5,6,26,23.1,26,70,37.1,13,24,54.2,19,22,41,9,38,26,21,5,0,3,50,Znicz Basket Pruszków,Sezon 2008/2009
2009-04-01 19:00,Asseco Prokom 2 Gdynia(d),71 : 69W,71,19,40,47.5,7,22,31.8,26,62,41.9,12,16,75.0,10,18,28,15,23,16,7,9,4,3,80,Znicz Basket Pruszków,Sezon 2008/2009
2008-09-20 19:00,Asseco Prokom 2 Gdynia(d),90 : 63W,90,29,44,65.9,4,18,22.2,33,62,53.2,20,29,69.0,9,23,32,13,26,7,14,17,0,0,100,Miasto Szkła Krosno,Sezon 2008/2009
2008-09-27 18:00,Zastal Intermarche Zielona Góra(w),75 : 77W,77,19,39,48.7,7,20,35.0,26,59,44.1,18,27,66.7,11,22,33,15,21,20,6,11,1,0,89,Miasto Szkła Krosno,Sezon 2008/2009
2008-10-04 18:00,Znicz Basket Pruszków(d),88 : 62W,88,29,51,56.9,5,14,35.7,34,65,52.3,15,22,68.2,8,22,30,21,24,14,12,13,0,0,102,Miasto Szkła Krosno,Sezon 2008/2009
2008-10-08 18:30,AZS PWSZ Kalisz(w),58 : 91W,91,31,51,60.8,6,15,40.0,37,66,56.1,11,17,64.7,7,39,46,17,15,16,10,7,4,2,120,Miasto Szkła Krosno,Sezon 2008/2009
2008-10-11 18:00,Żubry Białystok(d),69 : 64W,69,19,42,45.2,8,19,42.1,27,61,44.3,7,13,53.8,6,20,26,20,26,17,11,12,4,7,80,Miasto Szkła Krosno,Sezon 2008/2009
2008-10-18 18:00,GKS Tychy(w),79 : 70P,70,20,43,46.5,5,17,29.4,25,60,41.7,15,17,88.2,10,15,25,6,16,15,14,7,0,5,57,Miasto Szkła Krosno,Sezon 2008/2009
2008-10-25 18:00,Siarka Tarnobrzeg(d),73 : 59W,73,16,40,40.0,7,16,43.8,23,56,41.1,20,27,74.1,8,20,28,14,27,21,13,8,2,2,72,Miasto Szkła Krosno,Sezon 2008/2009
2008-10-29 18:00,PTG Sokół Łańcut(w),71 : 74W,74,17,33,51.5,7,21,33.3,24,54,44.4,19,26,73.1,9,16,25,12,19,23,14,16,3,4,79,Miasto Szkła Krosno,Sezon 2008/2009
2008-11-09 18:00,ŁKS Łódź(d),80 : 69W,80,20,35,57.1,7,23,30.4,27,58,46.6,19,25,76.0,7,29,36,19,28,22,17,11,7,0,99,Miasto Szkła Krosno,Sezon 2008/2009
2008-11-15 15:00,Polonia 2011 Warszawa(w),96 : 77P,77,19,38,50.0,7,25,28.0,26,63,41.3,18,25,72.0,7,20,27,12,20,23,20,14,0,5,66,Miasto Szkła Krosno,Sezon 2008/2009
2008-11-23 18:00,KS Sudety Jelenia Góra(d),71 : 68W,71,19,39,48.7,8,19,42.1,27,58,46.6,9,13,69.2,7,26,33,12,15,19,13,8,3,0,79,Miasto Szkła Krosno,Sezon 2008/2009
2008-11-26 18:00,MKS Dąbrowa Górnicza(d),78 : 77W,78,24,48,50.0,7,20,35.0,31,68,45.6,9,12,75.0,9,18,27,16,18,15,6,13,2,5,90,Miasto Szkła Krosno,Sezon 2008/2009
2008-11-29 18:00,KS AZS AWF Katowice(d),85 : 74W,85,25,39,64.1,7,18,38.9,32,57,56.1,14,19,73.7,9,25,34,21,23,16,15,5,5,0,105,Miasto Szkła Krosno,Sezon 2008/2009
2008-12-06 17:00,Stal Stalowa Wola(w),62 : 63W,63,21,40,52.5,4,16,25.0,25,56,44.6,9,16,56.3,8,29,37,12,23,20,14,4,2,3,66,Miasto Szkła Krosno,Sezon 2008/2009
2008-12-14 18:00,Resovia Rzeszów(d),82 : 77W,82,26,44,59.1,7,19,36.8,33,63,52.4,9,11,81.8,11,26,37,19,16,21,14,10,5,1,107,Miasto Szkła Krosno,Sezon 2008/2009
2008-12-20 15:45,Asseco Prokom 2 Gdynia(w),60 : 78W,78,27,43,62.8,5,14,35.7,32,57,56.1,9,12,75.0,6,21,27,12,19,16,14,11,1,1,87,Miasto Szkła Krosno,Sezon 2008/2009
2009-01-04 18:00,Zastal Intermarche Zielona Góra(d),66 : 71P,66,23,46,50.0,2,15,13.3,25,61,41.0,14,18,77.8,7,20,27,14,27,21,11,15,2,2,73,Miasto Szkła Krosno,Sezon 2008/2009
2009-01-14 18:00,AZS PWSZ Kalisz(d),85 : 63W,85,22,42,52.4,8,23,34.8,30,65,46.2,17,22,77.3,12,29,41,19,15,18,14,10,3,3,104,Miasto Szkła Krosno,Sezon 2008/2009
2009-01-17 18:00,Żubry Białystok(w),72 : 82W,82,25,43,58.1,5,18,27.8,30,61,49.2,17,23,73.9,6,28,34,14,26,21,9,9,4,3,97,Miasto Szkła Krosno,Sezon 2008/2009
2009-01-21 19:00,Znicz Basket Pruszków(w),91 : 87P,87,20,53,37.7,10,31,32.3,30,84,35.7,17,25,68.0,9,26,35,15,29,26,8,14,0,7,81,Miasto Szkła Krosno,Sezon 2008/2009
2009-01-25 18:00,GKS Tychy(d),71 : 69W,71,22,35,62.9,7,19,36.8,29,54,53.7,6,9,66.7,5,26,31,19,24,12,15,7,0,1,85,Miasto Szkła Krosno,Sezon 2008/2009
2009-01-31 18:30,Siarka Tarnobrzeg(w),73 : 67P,67,26,44,59.1,1,24,4.2,27,68,39.7,12,16,75.0,14,20,34,7,31,19,19,12,1,6,57,Miasto Szkła Krosno,Sezon 2008/2009
2009-02-04 18:00,PTG Sokół Łańcut(d),84 : 70W,84,21,42,50.0,8,26,30.8,29,68,42.6,18,24,75.0,17,22,39,14,28,25,14,13,7,2,98,Miasto Szkła Krosno,Sezon 2008/2009
2009-02-08 17:00,ŁKS Łódź(w),94 : 82P,82,23,42,54.8,6,16,37.5,29,58,50.0,18,25,72.0,7,18,25,14,25,22,11,7,0,0,81,Miasto Szkła Krosno,Sezon 2008/2009
2009-02-11 18:00,Polonia 2011 Warszawa(d),82 : 89P,82,25,47,53.2,5,22,22.7,30,69,43.5,17,24,70.8,10,16,26,18,22,25,12,20,1,5,89,Miasto Szkła Krosno,Sezon 2008/2009
2009-02-21 18:30,KS Sudety Jelenia Góra(w),62 : 68W,68,23,40,57.5,3,19,15.8,26,59,44.1,13,16,81.3,7,26,33,10,17,12,10,5,2,0,72,Miasto Szkła Krosno,Sezon 2008/2009
2009-02-25 18:00,MKS Dąbrowa Górnicza(w),70 : 73W,73,21,42,50.0,7,19,36.8,28,61,45.9,10,14,71.4,9,24,33,16,15,14,19,13,0,10,79,Miasto Szkła Krosno,Sezon 2008/2009
2009-02-28 18:00,KS AZS AWF Katowice(w),66 : 93W,93,32,51,62.7,6,15,40.0,38,66,57.6,11,17,64.7,9,20,29,21,23,18,12,8,1,3,106,Miasto Szkła Krosno,Sezon 2008/2009
2009-03-08 18:00,Stal Stalowa Wola(d),69 : 87P,69,17,41,41.5,7,24,29.2,24,65,36.9,14,18,77.8,12,21,33,11,21,18,14,13,0,6,67,Miasto Szkła Krosno,Sezon 2008/2009
2009-03-15 18:00,Resovia Rzeszów(w),61 : 69W,69,18,42,42.9,6,16,37.5,24,58,41.4,15,22,68.2,10,30,40,10,22,21,18,7,2,0,69,Miasto Szkła Krosno,Sezon 2008/2009
2009-03-21 18:00,Stal Stalowa Wola(d),65 : 77P,65,21,45,46.7,5,15,33.3,26,60,43.3,8,14,57.1,10,19,29,11,19,18,13,9,2,5,63,Miasto Szkła Krosno,Sezon 2008/2009
2009-03-22 18:00,Stal Stalowa Wola(d),74 : 73W,74,12,27,44.4,8,24,33.3,20,51,39.2,26,31,83.9,7,22,29,12,24,24,13,9,1,3,76,Miasto Szkła Krosno,Sezon 2008/2009
2009-03-27 18:00,Stal Stalowa Wola(w),68 : 61P,61,10,26,38.5,11,29,37.9,21,55,38.2,8,12,66.7,6,19,25,12,21,20,18,10,1,2,53,Miasto Szkła Krosno,Sezon 2008/2009
2009-03-28 16:00,Stal Stalowa Wola(w),60 : 64W,64,17,32,53.1,8,24,33.3,25,56,44.6,6,9,66.7,8,18,26,13,27,16,17,12,6,0,70,Miasto Szkła Krosno,Sezon 2008/2009
2009-04-01 18:00,Stal Stalowa Wola(d),65 : 72P,65,19,36,52.8,2,21,9.5,21,57,36.8,21,29,72.4,11,19,30,11,25,24,12,10,2,1,62,Miasto Szkła Krosno,Sezon 2008/2009
2008-09-20 18:30,Siarka Tarnobrzeg(d),76 : 58W,76,25,37,67.6,4,12,33.3,29,49,59.2,14,22,63.6,7,21,28,13,22,26,17,9,2,0,83,KS Sudety Jelenia Góra,Sezon 2008/2009
2008-09-27 17:30,PTG Sokół Łańcut(w),73 : 62P,62,15,37,40.5,6,19,31.6,21,56,37.5,14,19,73.7,8,23,31,9,19,23,12,11,5,8,66,KS Sudety Jelenia Góra,Sezon 2008/2009
2008-10-04 18:30,ŁKS Łódź(d),74 : 75P,74,19,32,59.4,4,18,22.2,23,50,46.0,24,30,80.0,7,17,24,14,24,26,15,7,6,0,77,KS Sudety Jelenia Góra,Sezon 2008/2009
2008-10-08 18:00,Polonia 2011 Warszawa(w),82 : 91W,91,25,45,55.6,4,10,40.0,29,55,52.7,29,42,69.0,5,21,26,15,20,32,13,14,0,4,94,KS Sudety Jelenia Góra,Sezon 2008/2009
2008-10-11 18:30,Zastal Intermarche Zielona Góra(d),77 : 71W,77,19,36,52.8,4,11,36.4,23,47,48.9,27,36,75.0,9,16,25,13,23,30,9,11,3,0,87,KS Sudety Jelenia Góra,Sezon 2008/2009
2008-10-18 18:30,MKS Dąbrowa Górnicza(d),59 : 69P,59,18,39,46.2,2,10,20.0,20,49,40.8,17,21,81.0,7,24,31,11,23,20,15,8,2,0,63,KS Sudety Jelenia Góra,Sezon 2008/2009
2008-10-25 18:00,KS AZS AWF Katowice(w),80 : 75P,75,23,42,54.8,2,10,20.0,25,52,48.1,23,29,79.3,9,25,34,7,19,23,19,4,0,0,68,KS Sudety Jelenia Góra,Sezon 2008/2009
2008-10-29 18:30,Stal Stalowa Wola(d),66 : 59W,66,23,41,56.1,2,11,18.2,25,52,48.1,14,19,73.7,8,23,31,7,15,19,9,8,3,0,74,KS Sudety Jelenia Góra,Sezon 2008/2009
2008-11-09 18:00,Resovia Rzeszów(w),65 : 75W,75,20,38,52.6,5,17,29.4,25,55,45.5,20,27,74.1,12,32,44,18,23,22,16,8,3,0,95,KS Sudety Jelenia Góra,Sezon 2008/2009
2008-11-15 18:30,Asseco Prokom 2 Gdynia(d),62 : 71P,62,19,34,55.9,6,20,30.0,25,54,46.3,6,12,50.0,7,21,28,17,17,17,11,10,1,0,72,KS Sudety Jelenia Góra,Sezon 2008/2009
2008-11-23 18:00,Miasto Szkła Krosno(w),71 : 68P,68,22,44,50.0,5,23,21.7,27,67,40.3,9,11,81.8,11,22,33,9,19,15,8,7,0,3,67,KS Sudety Jelenia Góra,Sezon 2008/2009
2008-11-26 18:30,Znicz Basket Pruszków(d),74 : 85P,74,15,26,57.7,7,24,29.2,22,50,44.0,23,26,88.5,10,22,32,16,19,19,17,5,4,0,83,KS Sudety Jelenia Góra,Sezon 2008/2009
2008-11-30 16:30,AZS PWSZ Kalisz(w),67 : 76W,76,16,32,50.0,8,19,42.1,24,51,47.1,20,26,76.9,4,25,29,11,19,19,8,9,2,2,86,KS Sudety Jelenia Góra,Sezon 2008/2009
2008-12-06 18:30,Żubry Białystok(d),74 : 54W,74,22,36,61.1,7,17,41.2,29,53,54.7,9,10,90.0,5,21,26,19,16,15,10,12,1,0,97,KS Sudety Jelenia Góra,Sezon 2008/2009
2008-12-13 18:00,GKS Tychy(w),77 : 65P,65,19,40,47.5,4,22,18.2,23,62,37.1,15,20,75.0,8,16,24,8,14,17,13,6,2,3,48,KS Sudety Jelenia Góra,Sezon 2008/2009
2008-12-20 18:00,Siarka Tarnobrzeg(w),77 : 70P,70,25,44,56.8,3,13,23.1,28,57,49.1,11,13,84.6,8,22,30,10,30,21,23,7,8,4,71,KS Sudety Jelenia Góra,Sezon 2008/2009
2009-01-03 18:30,PTG Sokół Łańcut(d),62 : 64P,62,19,40,47.5,4,17,23.5,23,57,40.4,12,19,63.2,9,22,31,8,22,16,9,12,1,0,64,KS Sudety Jelenia Góra,Sezon 2008/2009
2009-01-10 18:00,ŁKS Łódź(w),78 : 60P,60,18,35,51.4,6,15,40.0,24,50,48.0,6,10,60.0,6,19,25,8,21,16,20,8,2,2,53,KS Sudety Jelenia Góra,Sezon 2008/2009
2009-01-13 18:30,Polonia 2011 Warszawa(d),73 : 84P,73,18,31,58.1,9,25,36.0,27,56,48.2,10,14,71.4,7,17,24,14,23,21,16,12,1,0,75,KS Sudety Jelenia Góra,Sezon 2008/2009
2009-01-17 18:00,Zastal Intermarche Zielona Góra(w),63 : 60P,60,16,38,42.1,5,14,35.7,21,52,40.4,13,26,50.0,6,20,26,8,21,24,9,12,7,2,60,KS Sudety Jelenia Góra,Sezon 2008/2009
2009-01-25 17:00,MKS Dąbrowa Górnicza(w),77 : 84W,84,23,43,53.5,7,15,46.7,30,58,51.7,17,23,73.9,6,17,23,12,25,22,12,9,1,5,83,KS Sudety Jelenia Góra,Sezon 2008/2009
2009-01-31 18:30,KS AZS AWF Katowice(d),86 : 74W,86,31,46,67.4,6,11,54.5,37,57,64.9,6,12,50.0,13,21,34,15,15,15,16,9,3,0,105,KS Sudety Jelenia Góra,Sezon 2008/2009
2009-02-04 18:00,Stal Stalowa Wola(w),81 : 70P,70,17,35,48.6,6,12,50.0,23,47,48.9,18,24,75.0,8,18,26,8,26,20,20,6,3,6,63,KS Sudety Jelenia Góra,Sezon 2008/2009
2009-02-07 18:30,Resovia Rzeszów(d),90 : 60W,90,27,42,64.3,8,16,50.0,35,58,60.3,12,17,70.6,8,33,41,22,25,16,13,7,2,0,121,KS Sudety Jelenia Góra,Sezon 2008/2009
2009-02-11 13:00,Asseco Prokom 2 Gdynia(w),68 : 76W,76,19,42,45.2,9,17,52.9,28,59,47.5,11,17,64.7,6,22,28,12,18,19,14,13,1,1,79,KS Sudety Jelenia Góra,Sezon 2008/2009
2009-02-21 18:30,Miasto Szkła Krosno(d),62 : 68P,62,14,35,40.0,7,26,26.9,21,61,34.4,13,19,68.4,9,23,32,9,14,16,10,8,1,0,56,KS Sudety Jelenia Góra,Sezon 2008/2009
2009-02-25 18:00,Znicz Basket Pruszków(w),71 : 74W,74,19,36,52.8,8,22,36.4,27,58,46.6,12,21,57.1,10,21,31,15,21,23,18,9,1,1,72,KS Sudety Jelenia Góra,Sezon 2008/2009
2009-02-28 18:30,AZS PWSZ Kalisz(d),73 : 58W,73,24,33,72.7,4,20,20.0,28,53,52.8,13,18,72.2,8,29,37,18,17,18,15,8,2,0,93,KS Sudety Jelenia Góra,Sezon 2008/2009
2009-03-07 18:00,Żubry Białystok(w),85 : 68P,68,22,46,47.8,3,11,27.3,25,57,43.9,15,18,83.3,7,24,31,11,20,20,20,6,1,4,62,KS Sudety Jelenia Góra,Sezon 2008/2009
2009-03-14 18:30,GKS Tychy(d),67 : 64W,67,14,39,35.9,9,21,42.9,23,60,38.3,12,19,63.2,12,25,37,13,17,17,11,9,2,0,73,KS Sudety Jelenia Góra,Sezon 2008/2009
2009-03-21 18:00,Resovia Rzeszów(d),80 : 71W,80,23,42,54.8,5,13,38.5,28,55,50.9,19,20,95.0,12,24,36,13,23,20,10,7,0,0,98,KS Sudety Jelenia Góra,Sezon 2008/2009
2009-03-22 18:00,Resovia Rzeszów(d),64 : 55W,64,18,31,58.1,6,19,31.6,24,50,48.0,10,14,71.4,7,23,30,16,18,16,16,7,3,0,74,KS Sudety Jelenia Góra,Sezon 2008/2009
2009-03-28 18:00,Resovia Rzeszów(w),79 : 80W,80,24,43,55.8,6,15,40.0,30,58,51.7,14,16,87.5,5,26,31,17,27,15,11,8,3,0,98,KS Sudety Jelenia Góra,Sezon 2008/2009
2008-09-20 18:00,GKS Tychy(d),64 : 75P,64,15,33,45.5,7,25,28.0,22,58,37.9,13,19,68.4,12,21,33,7,17,18,15,7,2,1,56,MKS Dąbrowa Górnicza,Sezon 2008/2009
2008-09-27 18:30,Siarka Tarnobrzeg(w),67 : 73W,73,18,30,60.0,6,16,37.5,24,46,52.2,19,31,61.3,4,27,31,10,27,26,23,7,3,3,67,MKS Dąbrowa Górnicza,Sezon 2008/2009
2008-10-04 18:00,PTG Sokół Łańcut(d),69 : 54W,69,18,45,40.0,8,21,38.1,26,66,39.4,9,13,69.2,12,19,31,17,12,13,12,5,2,6,68,MKS Dąbrowa Górnicza,Sezon 2008/2009
2008-10-09 18:00,ŁKS Łódź(w),76 : 73P,73,18,35,51.4,8,25,32.0,26,60,43.3,13,21,61.9,3,22,25,12,29,25,9,11,1,1,71,MKS Dąbrowa Górnicza,Sezon 2008/2009
2008-10-12 18:00,Polonia 2011 Warszawa(d),74 : 64W,74,24,46,52.2,5,18,27.8,29,64,45.3,11,13,84.6,11,17,28,12,23,18,14,10,1,2,74,MKS Dąbrowa Górnicza,Sezon 2008/2009
2008-10-18 18:30,KS Sudety Jelenia Góra(w),59 : 69W,69,16,35,45.7,3,13,23.1,19,48,39.6,28,36,77.8,9,20,29,7,21,22,8,8,2,0,70,MKS Dąbrowa Górnicza,Sezon 2008/2009
2008-10-26 18:00,Zastal Intermarche Zielona Góra(d),61 : 55W,61,23,43,53.5,1,10,10.0,24,53,45.3,12,14,85.7,7,21,28,6,20,21,12,4,3,1,59,MKS Dąbrowa Górnicza,Sezon 2008/2009
2008-10-29 18:00,KS AZS AWF Katowice(d),72 : 74P,72,15,24,62.5,8,23,34.8,23,47,48.9,18,22,81.8,6,16,22,16,18,22,18,11,6,1,81,MKS Dąbrowa Górnicza,Sezon 2008/2009
2008-11-08 17:00,Stal Stalowa Wola(w),74 : 46P,46,14,35,40.0,4,18,22.2,18,53,34.0,6,10,60.0,4,19,23,10,15,15,17,6,3,5,32,MKS Dąbrowa Górnicza,Sezon 2008/2009
2008-11-15 18:00,Resovia Rzeszów(d),91 : 57W,91,28,40,70.0,7,21,33.3,35,61,57.4,14,23,60.9,11,29,40,20,18,23,18,13,7,3,118,MKS Dąbrowa Górnicza,Sezon 2008/2009
2008-11-22 15:45,Asseco Prokom 2 Gdynia(w),78 : 87W,87,17,35,48.6,11,25,44.0,28,60,46.7,20,26,76.9,8,32,40,14,15,23,20,8,4,5,95,MKS Dąbrowa Górnicza,Sezon 2008/2009
2008-11-26 18:00,Miasto Szkła Krosno(w),78 : 77P,77,15,32,46.9,10,13,76.9,25,45,55.6,17,22,77.3,5,24,29,14,16,18,17,4,5,2,87,MKS Dąbrowa Górnicza,Sezon 2008/2009
2008-11-29 18:00,Znicz Basket Pruszków(w),68 : 82W,82,26,40,65.0,5,18,27.8,31,58,53.4,15,21,71.4,8,24,32,16,26,22,16,11,3,1,95,MKS Dąbrowa Górnicza,Sezon 2008/2009
2008-12-06 18:00,AZS PWSZ Kalisz(d),54 : 57P,54,19,45,42.2,3,18,16.7,22,63,34.9,7,16,43.8,5,29,34,7,24,19,13,8,7,2,47,MKS Dąbrowa Górnicza,Sezon 2008/2009
2008-12-13 18:00,Żubry Białystok(w),73 : 80W,80,22,28,78.6,6,20,30.0,28,48,58.3,18,26,69.2,4,25,29,20,23,23,24,14,5,0,96,MKS Dąbrowa Górnicza,Sezon 2008/2009
2008-12-20 18:00,GKS Tychy(w),79 : 70P,70,22,41,53.7,5,16,31.3,27,57,47.4,11,14,78.6,10,18,28,11,13,15,21,10,1,4,66,MKS Dąbrowa Górnicza,Sezon 2008/2009
2009-01-04 18:00,Siarka Tarnobrzeg(d),69 : 79P,69,17,40,42.5,7,16,43.8,24,56,42.9,14,20,70.0,7,16,23,13,27,22,21,9,3,3,58,MKS Dąbrowa Górnicza,Sezon 2008/2009
2009-01-10 18:00,PTG Sokół Łańcut(w),53 : 80W,80,24,43,55.8,8,24,33.3,32,67,47.8,8,11,72.7,8,28,36,16,16,12,9,12,4,5,101,MKS Dąbrowa Górnicza,Sezon 2008/2009
2009-01-14 18:00,ŁKS Łódź(d),68 : 74P,68,18,37,48.6,8,20,40.0,26,57,45.6,8,11,72.7,5,13,18,15,25,17,13,12,2,2,68,MKS Dąbrowa Górnicza,Sezon 2008/2009
2009-01-17 15:00,Polonia 2011 Warszawa(w),62 : 66W,66,20,49,40.8,5,17,29.4,25,66,37.9,11,16,68.8,9,22,31,9,13,20,17,15,3,7,61,MKS Dąbrowa Górnicza,Sezon 2008/2009
2009-01-25 17:00,KS Sudety Jelenia Góra(d),77 : 84P,77,21,43,48.8,4,18,22.2,25,61,41.0,23,31,74.2,15,21,36,6,22,25,15,8,5,1,73,MKS Dąbrowa Górnicza,Sezon 2008/2009
2009-01-31 16:00,Zastal Intermarche Zielona Góra(w),90 : 50P,50,11,37,29.7,5,11,45.5,16,48,33.3,13,21,61.9,8,21,29,6,21,20,29,11,4,5,31,MKS Dąbrowa Górnicza,Sezon 2008/2009
2009-02-04 18:30,KS AZS AWF Katowice(w),64 : 72W,72,16,40,40.0,7,16,43.8,23,56,41.1,19,25,76.0,12,26,38,12,18,18,17,6,1,5,73,MKS Dąbrowa Górnicza,Sezon 2008/2009
2009-02-09 18:00,Stal Stalowa Wola(d),64 : 74P,64,17,36,47.2,5,23,21.7,22,59,37.3,15,19,78.9,11,15,26,10,24,20,12,8,2,4,57,MKS Dąbrowa Górnicza,Sezon 2008/2009
2009-02-15 18:00,Resovia Rzeszów(w),63 : 76W,76,21,41,51.2,5,13,38.5,26,54,48.1,19,27,70.4,8,26,34,8,20,26,16,7,5,0,78,MKS Dąbrowa Górnicza,Sezon 2008/2009
2009-02-18 18:00,Asseco Prokom 2 Gdynia(d),117 : 69W,117,39,54,72.2,11,23,47.8,50,77,64.9,6,12,50.0,8,30,38,38,20,13,10,16,2,1,168,MKS Dąbrowa Górnicza,Sezon 2008/2009
2009-02-25 18:00,Miasto Szkła Krosno(d),70 : 73P,70,13,33,39.4,11,26,42.3,24,59,40.7,11,21,52.4,12,21,33,15,14,14,15,13,9,0,80,MKS Dąbrowa Górnicza,Sezon 2008/2009
2009-02-28 18:00,Znicz Basket Pruszków(d),83 : 54W,83,24,39,61.5,6,18,33.3,30,57,52.6,17,25,68.0,11,29,40,20,26,21,13,12,2,2,109,MKS Dąbrowa Górnicza,Sezon 2008/2009
2009-03-07 17:30,AZS PWSZ Kalisz(w),69 : 86W,86,21,34,61.8,11,25,44.0,32,59,54.2,11,26,42.3,8,17,25,15,21,28,10,12,0,1,86,MKS Dąbrowa Górnicza,Sezon 2008/2009
2009-03-14 18:00,Żubry Białystok(d),56 : 66P,56,10,39,25.6,7,20,35.0,17,59,28.8,15,19,78.9,8,16,24,10,19,22,22,12,3,4,37,MKS Dąbrowa Górnicza,Sezon 2008/2009
2008-09-20 15:00,PTG Sokół Łańcut(d),75 : 58W,75,20,40,50.0,6,28,21.4,26,68,38.2,17,25,68.0,17,26,43,10,28,24,25,20,7,0,80,Polonia 2011 Warszawa,Sezon 2008/2009
2008-09-27 17:00,ŁKS Łódź(w),67 : 98W,98,26,48,54.2,7,18,38.9,33,66,50.0,25,33,75.8,11,17,28,10,25,26,9,10,2,0,98,Polonia 2011 Warszawa,Sezon 2008/2009
2008-10-04 15:00,Zastal Intermarche Zielona Góra(d),95 : 108P,95,27,60,45.0,9,30,30.0,36,90,40.0,14,27,51.9,15,22,37,19,27,25,18,19,3,3,88,Polonia 2011 Warszawa,Sezon 2008/2009
2008-10-08 18:00,KS Sudety Jelenia Góra(d),82 : 91P,82,19,37,51.4,10,33,30.3,29,70,41.4,14,16,87.5,12,20,32,20,32,20,24,9,4,0,80,Polonia 2011 Warszawa,Sezon 2008/2009
2008-10-12 18:00,MKS Dąbrowa Górnicza(w),74 : 64P,64,16,30,53.3,5,18,27.8,21,48,43.8,17,28,60.7,8,19,27,14,18,23,17,8,2,1,60,Polonia 2011 Warszawa,Sezon 2008/2009
2008-10-18 15:00,KS AZS AWF Katowice(d),91 : 71W,91,30,57,52.6,4,20,20.0,34,77,44.2,19,26,73.1,16,29,45,20,26,22,13,15,5,4,113,Polonia 2011 Warszawa,Sezon 2008/2009
2008-10-25 17:00,Stal Stalowa Wola(w),57 : 67W,67,22,49,44.9,2,14,14.3,24,63,38.1,17,22,77.3,13,29,42,8,19,15,13,10,0,5,70,Polonia 2011 Warszawa,Sezon 2008/2009
2008-10-29 18:00,Resovia Rzeszów(d),107 : 49W,107,25,40,62.5,13,20,65.0,38,60,63.3,18,25,72.0,11,30,41,30,27,21,23,14,8,2,148,Polonia 2011 Warszawa,Sezon 2008/2009
2008-11-09 15:00,Asseco Prokom 2 Gdynia(w),93 : 92P,92,27,43,62.8,9,32,28.1,36,75,48.0,11,21,52.4,15,22,37,10,24,25,19,10,1,1,82,Polonia 2011 Warszawa,Sezon 2008/2009
2008-11-15 15:00,Miasto Szkła Krosno(d),96 : 77W,96,24,44,54.5,10,27,37.0,34,71,47.9,18,23,78.3,16,23,39,22,23,20,22,12,5,0,110,Polonia 2011 Warszawa,Sezon 2008/2009
2008-11-22 15:00,Znicz Basket Pruszków(d),89 : 70W,89,22,42,52.4,8,30,26.7,30,72,41.7,21,33,63.6,17,28,45,20,21,25,15,11,6,3,102,Polonia 2011 Warszawa,Sezon 2008/2009
2008-11-26 18:00,AZS PWSZ Kalisz(d),92 : 67W,92,23,40,57.5,12,31,38.7,35,71,49.3,10,18,55.6,14,26,40,18,16,21,16,11,3,3,104,Polonia 2011 Warszawa,Sezon 2008/2009
2008-11-29 18:00,Żubry Białystok(w),87 : 78P,78,24,51,47.1,6,22,27.3,30,73,41.1,12,15,80.0,15,19,34,13,26,16,14,10,6,4,81,Polonia 2011 Warszawa,Sezon 2008/2009
2008-12-06 15:00,GKS Tychy(d),88 : 79W,88,28,51,54.9,5,19,26.3,33,70,47.1,17,23,73.9,13,31,44,19,22,23,17,10,1,2,102,Polonia 2011 Warszawa,Sezon 2008/2009
2008-12-13 18:00,Siarka Tarnobrzeg(w),82 : 84W,84,25,38,65.8,8,27,29.6,33,65,50.8,10,12,83.3,11,18,29,9,26,19,19,7,2,2,78,Polonia 2011 Warszawa,Sezon 2008/2009
2008-12-20 17:30,PTG Sokół Łańcut(w),58 : 66W,66,20,39,51.3,6,28,21.4,26,67,38.8,8,12,66.7,11,27,38,12,20,18,16,11,4,2,70,Polonia 2011 Warszawa,Sezon 2008/2009
2009-01-03 15:00,ŁKS Łódź(d),81 : 80W,81,13,36,36.1,7,26,26.9,20,62,32.3,34,48,70.8,16,26,42,13,32,37,22,13,4,3,75,Polonia 2011 Warszawa,Sezon 2008/2009
2009-01-11 17:00,Zastal Intermarche Zielona Góra(w),80 : 87W,87,22,39,56.4,9,17,52.9,31,56,55.4,16,22,72.7,11,17,28,13,23,25,14,13,2,2,98,Polonia 2011 Warszawa,Sezon 2008/2009
2009-01-13 18:30,KS Sudety Jelenia Góra(w),73 : 84W,84,23,34,67.6,7,24,29.2,30,58,51.7,17,21,81.0,9,19,28,11,21,22,14,12,1,0,90,Polonia 2011 Warszawa,Sezon 2008/2009
2009-01-17 15:00,MKS Dąbrowa Górnicza(d),62 : 66P,62,12,34,35.3,11,23,47.8,23,57,40.4,5,8,62.5,7,30,37,15,20,13,28,10,7,3,66,Polonia 2011 Warszawa,Sezon 2008/2009
2009-01-24 18:00,KS AZS AWF Katowice(w),78 : 84W,84,21,43,48.8,11,21,52.4,32,64,50.0,9,14,64.3,8,25,33,19,19,13,12,5,4,5,96,Polonia 2011 Warszawa,Sezon 2008/2009
2009-01-31 15:00,Stal Stalowa Wola(d),82 : 77W,82,26,38,68.4,7,21,33.3,33,59,55.9,9,14,64.3,9,27,36,17,24,17,24,11,3,3,94,Polonia 2011 Warszawa,Sezon 2008/2009
2009-02-04 18:00,Resovia Rzeszów(w),62 : 92W,92,30,51,58.8,8,18,44.4,38,69,55.1,8,19,42.1,15,33,48,26,21,21,17,10,2,0,119,Polonia 2011 Warszawa,Sezon 2008/2009
2009-02-07 15:00,Asseco Prokom 2 Gdynia(d),80 : 65W,80,23,57,40.4,5,24,20.8,28,81,34.6,19,22,86.4,23,29,52,18,18,18,18,22,3,3,101,Polonia 2011 Warszawa,Sezon 2008/2009
2009-02-11 18:00,Miasto Szkła Krosno(w),82 : 89W,89,24,37,64.9,8,21,38.1,32,58,55.2,17,21,81.0,5,28,33,17,24,19,22,9,5,1,101,Polonia 2011 Warszawa,Sezon 2008/2009
2009-02-17 19:00,Znicz Basket Pruszków(w),82 : 80P,80,17,41,41.5,11,25,44.0,28,66,42.4,13,15,86.7,11,25,36,13,26,17,19,12,4,2,86,Polonia 2011 Warszawa,Sezon 2008/2009
2009-02-25 18:00,AZS PWSZ Kalisz(w),74 : 95W,95,23,31,74.2,12,29,41.4,35,60,58.3,13,19,68.4,8,25,33,18,22,18,13,10,4,1,116,Polonia 2011 Warszawa,Sezon 2008/2009
2009-02-28 15:00,Żubry Białystok(d),79 : 59W,79,18,39,46.2,9,26,34.6,27,65,41.5,16,22,72.7,16,26,42,19,22,19,14,12,5,5,99,Polonia 2011 Warszawa,Sezon 2008/2009
2009-03-11 18:00,GKS Tychy(w),80 : 87W,87,26,43,60.5,7,22,31.8,33,65,50.8,14,16,87.5,7,24,31,16,19,16,13,9,1,2,97,Polonia 2011 Warszawa,Sezon 2008/2009
2009-03-15 15:00,Siarka Tarnobrzeg(d),65 : 76P,65,20,49,40.8,3,22,13.6,23,71,32.4,16,22,72.7,15,25,40,11,20,22,21,15,3,5,59,Polonia 2011 Warszawa,Sezon 2008/2009
2009-03-21 15:00,Żubry Białystok(d),70 : 61W,70,24,49,49.0,3,20,15.0,27,69,39.1,13,15,86.7,18,32,50,12,25,22,19,8,5,3,82,Polonia 2011 Warszawa,Sezon 2008/2009
2009-03-22 15:00,Żubry Białystok(d),91 : 88W,91,26,55,47.3,7,28,25.0,33,83,39.8,18,21,85.7,26,24,50,16,22,17,15,11,3,0,103,Polonia 2011 Warszawa,Sezon 2008/2009
2009-03-28 18:00,Żubry Białystok(w),91 : 98W,98,20,44,45.5,12,26,46.2,32,70,45.7,22,25,88.0,11,32,43,16,18,27,27,7,4,8,100,Polonia 2011 Warszawa,Sezon 2008/2009
2009-04-18 15:00,Zastal Intermarche Zielona Góra(d),79 : 54W,79,20,38,52.6,9,28,32.1,29,66,43.9,12,16,75.0,10,33,43,16,26,17,16,9,3,1,93,Polonia 2011 Warszawa,Sezon 2008/2009
2009-04-19 15:00,Zastal Intermarche Zielona Góra(d),85 : 89P,85,20,42,47.6,10,34,29.4,30,76,39.5,15,18,83.3,9,25,34,16,23,20,20,14,7,0,87,Polonia 2011 Warszawa,Sezon 2008/2009
2009-04-25 18:00,Zastal Intermarche Zielona Góra(w),69 : 86W,86,20,31,64.5,8,20,40.0,28,51,54.9,22,29,75.9,8,20,28,13,23,25,14,14,0,0,97,Polonia 2011 Warszawa,Sezon 2008/2009
2009-04-26 17:00,Zastal Intermarche Zielona Góra(w),66 : 70W,70,14,29,48.3,8,23,34.8,22,52,42.3,18,24,75.0,9,25,34,11,24,21,12,11,1,1,79,Polonia 2011 Warszawa,Sezon 2008/2009
2009-05-09 18:00,Stal Stalowa Wola(w),94 : 94P,94,23,48,47.9,13,35,37.1,36,83,43.4,9,12,75.0,12,21,33,24,17,8,7,13,3,1,110,Polonia 2011 Warszawa,Sezon 2008/2009
2009-05-13 18:00,Stal Stalowa Wola(d),78 : 73W,78,16,33,48.5,10,29,34.5,26,62,41.9,16,25,64.0,12,27,39,15,16,23,19,16,6,1,90,Polonia 2011 Warszawa,Sezon 2008/2009
2008-09-20 18:30,KS Sudety Jelenia Góra(w),76 : 58P,58,15,35,42.9,4,7,57.1,19,42,45.2,16,22,72.7,7,15,22,5,25,21,11,13,1,0,59,Siarka Tarnobrzeg,Sezon 2008/2009
2008-09-27 18:30,MKS Dąbrowa Górnicza(d),67 : 73P,67,17,43,39.5,5,21,23.8,22,64,34.4,18,30,60.0,17,19,36,10,26,27,13,12,3,3,61,Siarka Tarnobrzeg,Sezon 2008/2009
2008-10-04 18:00,KS AZS AWF Katowice(w),75 : 71P,71,22,37,59.5,1,14,7.1,23,51,45.1,24,31,77.4,6,25,31,10,18,28,10,1,2,0,70,Siarka Tarnobrzeg,Sezon 2008/2009
2008-10-08 18:00,Stal Stalowa Wola(d),79 : 60W,79,25,44,56.8,4,13,30.8,29,57,50.9,17,22,77.3,11,22,33,14,23,19,21,16,5,2,93,Siarka Tarnobrzeg,Sezon 2008/2009
2008-10-12 18:00,Resovia Rzeszów(w),70 : 82W,82,25,42,59.5,3,13,23.1,28,55,50.9,23,29,79.3,16,21,37,17,26,25,23,10,2,0,92,Siarka Tarnobrzeg,Sezon 2008/2009
2008-10-18 18:30,Asseco Prokom 2 Gdynia(d),97 : 75W,97,36,56,64.3,5,15,33.3,41,71,57.7,10,20,50.0,11,27,38,28,26,19,14,17,2,5,128,Siarka Tarnobrzeg,Sezon 2008/2009
2008-10-25 18:00,Miasto Szkła Krosno(w),73 : 59P,59,19,41,46.3,1,15,6.7,20,56,35.7,18,32,56.3,10,21,31,11,26,22,16,6,2,2,43,Siarka Tarnobrzeg,Sezon 2008/2009
2008-10-29 18:00,Znicz Basket Pruszków(d),84 : 77W,84,15,29,51.7,8,18,44.4,23,47,48.9,30,34,88.2,6,24,30,14,21,28,19,14,4,2,99,Siarka Tarnobrzeg,Sezon 2008/2009
2008-11-09 16:00,AZS PWSZ Kalisz(w),73 : 75W,75,16,38,42.1,8,21,38.1,24,59,40.7,19,24,79.2,9,19,28,16,21,24,11,3,3,1,74,Siarka Tarnobrzeg,Sezon 2008/2009
2008-11-15 18:30,Żubry Białystok(d),72 : 68W,72,20,38,52.6,4,19,21.1,24,57,42.1,20,37,54.1,15,30,45,16,27,29,19,8,2,0,74,Siarka Tarnobrzeg,Sezon 2008/2009
2008-11-22 18:00,GKS Tychy(w),99 : 89P,89,18,39,46.2,10,22,45.5,28,61,45.9,23,30,76.7,11,13,24,17,25,28,16,9,0,7,83,Siarka Tarnobrzeg,Sezon 2008/2009
2008-11-26 18:00,Zastal Intermarche Zielona Góra(w),70 : 64P,64,16,31,51.6,6,21,28.6,22,52,42.3,14,31,45.2,9,21,30,14,23,30,16,18,7,2,70,Siarka Tarnobrzeg,Sezon 2008/2009
2008-11-29 18:30,PTG Sokół Łańcut(d),66 : 59W,66,13,40,32.5,8,26,30.8,21,66,31.8,16,31,51.6,17,21,38,11,29,28,11,6,0,8,50,Siarka Tarnobrzeg,Sezon 2008/2009
2008-12-06 17:30,ŁKS Łódź(w),72 : 76W,76,21,40,52.5,6,17,35.3,27,57,47.4,16,23,69.6,7,25,32,18,22,26,14,9,8,2,92,Siarka Tarnobrzeg,Sezon 2008/2009
2008-12-13 18:00,Polonia 2011 Warszawa(d),82 : 84P,82,17,34,50.0,9,25,36.0,26,59,44.1,21,25,84.0,11,19,30,13,19,26,14,11,2,2,87,Siarka Tarnobrzeg,Sezon 2008/2009
2008-12-20 18:00,KS Sudety Jelenia Góra(d),77 : 70W,77,17,35,48.6,6,19,31.6,23,54,42.6,25,32,78.1,9,20,29,12,21,30,16,15,4,8,83,Siarka Tarnobrzeg,Sezon 2008/2009
2009-01-04 18:00,MKS Dąbrowa Górnicza(w),69 : 79W,79,16,29,55.2,9,23,39.1,25,52,48.1,20,30,66.7,10,16,26,14,22,27,15,14,3,3,84,Siarka Tarnobrzeg,Sezon 2008/2009
2009-01-10 18:30,KS AZS AWF Katowice(d),72 : 67W,72,19,41,46.3,4,18,22.2,23,59,39.0,22,30,73.3,19,21,40,9,25,26,20,15,6,2,78,Siarka Tarnobrzeg,Sezon 2008/2009
2009-01-14 18:00,Stal Stalowa Wola(w),64 : 52P,52,18,39,46.2,2,20,10.0,20,59,33.9,10,15,66.7,7,19,26,11,20,17,13,7,3,5,42,Siarka Tarnobrzeg,Sezon 2008/2009
2009-01-17 18:00,Resovia Rzeszów(d),98 : 59W,98,28,43,65.1,9,17,52.9,37,60,61.7,15,20,75.0,6,22,28,20,25,22,18,19,5,1,124,Siarka Tarnobrzeg,Sezon 2008/2009
2009-01-24 15:45,Asseco Prokom 2 Gdynia(w),66 : 78W,78,20,49,40.8,8,20,40.0,28,69,40.6,14,19,73.7,16,28,44,20,24,23,20,14,1,4,91,Siarka Tarnobrzeg,Sezon 2008/2009
2009-01-31 18:30,Miasto Szkła Krosno(d),73 : 67W,73,16,45,35.6,6,17,35.3,22,62,35.5,23,35,65.7,21,26,47,15,20,31,16,15,6,1,88,Siarka Tarnobrzeg,Sezon 2008/2009
2009-02-04 19:00,Znicz Basket Pruszków(w),92 : 66P,66,18,34,52.9,5,19,26.3,23,53,43.4,15,25,60.0,10,12,22,15,23,26,18,9,0,3,54,Siarka Tarnobrzeg,Sezon 2008/2009
2009-02-07 18:00,AZS PWSZ Kalisz(d),90 : 62W,90,22,44,50.0,13,28,46.4,35,72,48.6,7,14,50.0,21,23,44,23,22,18,16,9,3,1,109,Siarka Tarnobrzeg,Sezon 2008/2009
2009-02-14 18:00,Żubry Białystok(w),68 : 74W,74,15,37,40.5,11,28,39.3,26,65,40.0,11,14,78.6,13,17,30,14,18,20,17,16,7,6,82,Siarka Tarnobrzeg,Sezon 2008/2009
2009-02-21 18:00,GKS Tychy(d),88 : 79W,88,25,46,54.3,10,28,35.7,35,74,47.3,8,16,50.0,15,22,37,21,20,16,13,17,3,4,106,Siarka Tarnobrzeg,Sezon 2008/2009
2009-02-25 18:00,Zastal Intermarche Zielona Góra(d),92 : 70W,92,23,40,57.5,8,19,42.1,31,59,52.5,22,27,81.5,11,26,37,17,23,22,15,15,3,3,116,Siarka Tarnobrzeg,Sezon 2008/2009
2009-02-28 17:30,PTG Sokół Łańcut(w),66 : 55P,55,14,38,36.8,6,28,21.4,20,66,30.3,9,12,75.0,11,18,29,9,19,20,13,13,1,3,45,Siarka Tarnobrzeg,Sezon 2008/2009
2009-03-07 18:30,ŁKS Łódź(d),81 : 74W,81,12,40,30.0,11,29,37.9,23,69,33.3,24,35,68.6,14,31,45,21,23,24,14,11,6,0,93,Siarka Tarnobrzeg,Sezon 2008/2009
2009-03-15 15:00,Polonia 2011 Warszawa(w),65 : 76W,76,21,39,53.8,7,25,28.0,28,64,43.8,13,22,59.1,10,25,35,15,22,20,22,14,5,3,78,Siarka Tarnobrzeg,Sezon 2008/2009
2009-03-21 18:00,Zastal Intermarche Zielona Góra(d),70 : 82P,70,16,26,61.5,9,24,37.5,25,50,50.0,11,19,57.9,5,14,19,12,28,18,19,7,3,0,59,Siarka Tarnobrzeg,Sezon 2008/2009
2009-03-22 17:00,Zastal Intermarche Zielona Góra(d),65 : 66P,65,12,25,48.0,7,23,30.4,19,48,39.6,20,29,69.0,7,30,37,11,15,22,21,7,3,0,64,Siarka Tarnobrzeg,Sezon 2008/2009
2009-03-28 18:00,Zastal Intermarche Zielona Góra(w),66 : 52P,52,15,34,44.1,5,21,23.8,20,55,36.4,7,15,46.7,6,20,26,7,19,20,11,10,4,2,45,Siarka Tarnobrzeg,Sezon 2008/2009
2008-09-21 17:00,AZS PWSZ Kalisz(d),69 : 62W,69,17,37,45.9,7,21,33.3,24,58,41.4,14,19,73.7,7,27,34,9,20,20,8,9,4,6,78,Stal Stalowa Wola,Sezon 2008/2009
2008-09-27 15:00,Żubry Białystok(w),66 : 71W,71,17,41,41.5,9,16,56.3,26,57,45.6,10,12,83.3,10,20,30,12,20,16,15,8,1,0,74,Stal Stalowa Wola,Sezon 2008/2009
2008-10-04 17:00,GKS Tychy(d),74 : 81P,74,19,42,45.2,8,25,32.0,27,67,40.3,12,23,52.2,15,19,34,11,15,23,9,9,3,3,71,Stal Stalowa Wola,Sezon 2008/2009
2008-10-08 18:00,Siarka Tarnobrzeg(w),79 : 60P,60,19,45,42.2,3,19,15.8,22,64,34.4,13,18,72.2,13,17,30,9,20,23,21,12,2,6,45,Stal Stalowa Wola,Sezon 2008/2009
2008-10-12 17:30,PTG Sokół Łańcut(w),69 : 63P,63,14,31,45.2,9,31,29.0,23,62,37.1,8,14,57.1,12,17,29,8,14,18,9,12,2,2,60,Stal Stalowa Wola,Sezon 2008/2009
2008-10-17 18:00,ŁKS Łódź(w),84 : 69P,69,18,41,43.9,9,28,32.1,27,69,39.1,6,14,42.9,7,15,22,11,19,17,6,8,1,3,55,Stal Stalowa Wola,Sezon 2008/2009
2008-10-25 17:00,Polonia 2011 Warszawa(d),57 : 67P,57,12,31,38.7,7,28,25.0,19,59,32.2,12,15,80.0,7,24,31,7,17,19,13,8,5,0,52,Stal Stalowa Wola,Sezon 2008/2009
2008-10-29 18:30,KS Sudety Jelenia Góra(w),66 : 59P,59,12,23,52.2,8,25,32.0,20,48,41.7,11,18,61.1,3,15,18,8,20,13,10,5,4,0,49,Stal Stalowa Wola,Sezon 2008/2009
2008-11-08 17:00,MKS Dąbrowa Górnicza(d),74 : 46W,74,22,40,55.0,7,25,28.0,29,65,44.6,9,13,69.2,16,29,45,14,15,15,12,12,5,3,98,Stal Stalowa Wola,Sezon 2008/2009
2008-11-16 18:00,KS AZS AWF Katowice(w),79 : 62P,62,18,36,50.0,5,20,25.0,23,56,41.1,11,14,78.6,6,16,22,8,15,12,21,5,2,2,42,Stal Stalowa Wola,Sezon 2008/2009
2008-11-22 17:00,Zastal Intermarche Zielona Góra(d),69 : 62W,69,16,33,48.5,9,19,47.4,25,52,48.1,10,20,50.0,7,26,33,14,19,18,7,6,2,3,80,Stal Stalowa Wola,Sezon 2008/2009
2008-11-26 18:00,Resovia Rzeszów(d),80 : 82P,80,16,35,45.7,11,27,40.7,27,62,43.5,15,22,68.2,12,18,30,13,26,23,16,9,2,1,76,Stal Stalowa Wola,Sezon 2008/2009
2008-11-29 15:45,Asseco Prokom 2 Gdynia(w),77 : 74P,74,16,42,38.1,8,32,25.0,24,74,32.4,18,24,75.0,14,29,43,11,23,30,21,8,8,5,67,Stal Stalowa Wola,Sezon 2008/2009
2008-12-06 17:00,Miasto Szkła Krosno(d),62 : 63P,62,17,44,38.6,5,19,26.3,22,63,34.9,13,16,81.3,11,26,37,14,20,23,10,10,3,2,72,Stal Stalowa Wola,Sezon 2008/2009
2008-12-13 17:00,Znicz Basket Pruszków(d),78 : 68W,78,25,48,52.1,2,12,16.7,27,60,45.0,22,30,73.3,10,22,32,13,23,24,10,14,4,4,90,Stal Stalowa Wola,Sezon 2008/2009
2009-01-03 17:00,Żubry Białystok(d),69 : 68W,69,21,42,50.0,5,19,26.3,26,61,42.6,12,20,60.0,11,19,30,13,19,23,15,13,1,1,68,Stal Stalowa Wola,Sezon 2008/2009
2009-01-10 18:00,GKS Tychy(w),77 : 81W,81,21,38,55.3,9,18,50.0,30,56,53.6,12,17,70.6,7,19,26,15,13,17,19,18,2,4,92,Stal Stalowa Wola,Sezon 2008/2009
2009-01-14 18:00,Siarka Tarnobrzeg(d),64 : 52W,64,22,46,47.8,3,14,21.4,25,60,41.7,11,15,73.3,14,30,44,14,17,20,12,9,5,3,85,Stal Stalowa Wola,Sezon 2008/2009
2009-01-18 17:00,PTG Sokół Łańcut(d),84 : 56W,84,22,42,52.4,11,22,50.0,33,64,51.6,7,7,100.0,9,23,32,17,15,13,9,12,2,1,107,Stal Stalowa Wola,Sezon 2008/2009
2009-01-21 18:00,AZS PWSZ Kalisz(w),65 : 82W,82,21,36,58.3,7,16,43.8,28,52,53.8,19,21,90.5,5,31,36,16,13,21,21,6,1,0,94,Stal Stalowa Wola,Sezon 2008/2009
2009-01-25 17:00,ŁKS Łódź(d),75 : 72W,75,17,32,53.1,8,21,38.1,25,53,47.2,17,31,54.8,11,18,29,14,15,28,13,10,9,0,82,Stal Stalowa Wola,Sezon 2008/2009
2009-01-31 15:00,Polonia 2011 Warszawa(w),82 : 77P,77,21,40,52.5,5,28,17.9,26,68,38.2,20,26,76.9,13,14,27,10,17,24,15,16,3,2,70,Stal Stalowa Wola,Sezon 2008/2009
2009-02-04 18:00,KS Sudety Jelenia Góra(d),81 : 70W,81,20,35,57.1,8,19,42.1,28,54,51.9,17,23,73.9,6,16,22,17,21,26,8,16,6,3,102,Stal Stalowa Wola,Sezon 2008/2009
2009-02-09 18:00,MKS Dąbrowa Górnicza(w),64 : 74W,74,17,30,56.7,9,23,39.1,26,53,49.1,13,18,72.2,10,21,31,12,20,24,15,10,4,2,84,Stal Stalowa Wola,Sezon 2008/2009
2009-02-14 17:00,KS AZS AWF Katowice(d),94 : 75W,94,28,38,73.7,7,14,50.0,35,52,67.3,17,21,81.0,7,23,30,19,26,25,20,10,4,1,116,Stal Stalowa Wola,Sezon 2008/2009
2009-02-18 18:00,Zastal Intermarche Zielona Góra(w),72 : 57P,57,17,36,47.2,2,14,14.3,19,50,38.0,17,22,77.3,5,24,29,9,17,22,14,6,5,3,56,Stal Stalowa Wola,Sezon 2008/2009
2009-02-25 18:00,Resovia Rzeszów(w),50 : 107W,107,35,54,64.8,8,12,66.7,43,66,65.2,13,18,72.2,11,34,45,27,19,18,11,9,5,0,154,Stal Stalowa Wola,Sezon 2008/2009
2009-03-01 17:00,Asseco Prokom 2 Gdynia(d),90 : 65W,90,25,45,55.6,12,29,41.4,37,74,50.0,4,10,40.0,11,30,41,23,13,17,13,18,7,4,123,Stal Stalowa Wola,Sezon 2008/2009
2009-03-08 18:00,Miasto Szkła Krosno(w),69 : 87W,87,16,37,43.2,14,23,60.9,30,60,50.0,13,22,59.1,9,25,34,13,18,21,16,9,6,0,94,Stal Stalowa Wola,Sezon 2008/2009
2009-03-14 18:00,Znicz Basket Pruszków(w),97 : 72P,72,16,33,48.5,8,20,40.0,24,53,45.3,16,29,55.2,8,18,26,7,22,26,21,10,1,2,53,Stal Stalowa Wola,Sezon 2008/2009
2009-03-21 18:00,Miasto Szkła Krosno(w),65 : 77W,77,22,36,61.1,6,17,35.3,28,53,52.8,15,21,71.4,6,24,30,14,18,19,14,9,5,2,90,Stal Stalowa Wola,Sezon 2008/2009
2009-03-22 18:00,Miasto Szkła Krosno(w),74 : 73P,73,20,37,54.1,7,24,29.2,27,61,44.3,12,19,63.2,12,23,35,11,24,24,12,11,3,1,80,Stal Stalowa Wola,Sezon 2008/2009
2009-03-27 18:00,Miasto Szkła Krosno(d),68 : 61W,68,17,34,50.0,8,24,33.3,25,58,43.1,10,19,52.6,13,25,38,16,20,21,17,11,2,1,76,Stal Stalowa Wola,Sezon 2008/2009
2009-03-28 16:00,Miasto Szkła Krosno(d),60 : 64P,60,11,25,44.0,5,19,26.3,16,44,36.4,23,32,71.9,9,20,29,6,16,26,19,12,0,6,51,Stal Stalowa Wola,Sezon 2008/2009
2009-04-01 18:00,Miasto Szkła Krosno(w),65 : 72W,72,18,37,48.6,6,19,31.6,24,56,42.9,18,26,69.2,12,29,41,11,24,25,12,6,1,2,79,Stal Stalowa Wola,Sezon 2008/2009
2009-04-18 19:00,GKS Tychy(w),67 : 69W,69,23,45,51.1,4,16,25.0,27,61,44.3,11,19,57.9,10,21,31,12,21,18,14,12,2,2,70,Stal Stalowa Wola,Sezon 2008/2009
2009-04-19 19:00,GKS Tychy(w),92 : 82P,82,25,46,54.3,4,16,25.0,29,62,46.8,20,25,80.0,13,17,30,6,22,21,18,8,2,0,72,Stal Stalowa Wola,Sezon 2008/2009
2009-04-25 20:00,GKS Tychy(d),67 : 69P,67,20,34,58.8,4,19,21.1,24,53,45.3,15,15,100.0,7,22,29,13,24,20,10,8,0,1,78,Stal Stalowa Wola,Sezon 2008/2009
2009-04-26 18:30,GKS Tychy(d),50 : 44W,50,9,28,32.1,3,17,17.6,12,45,26.7,23,27,85.2,8,32,40,3,17,21,15,7,2,4,50,Stal Stalowa Wola,Sezon 2008/2009
2009-04-29 19:00,GKS Tychy(w),63 : 85W,85,25,43,58.1,4,12,33.3,29,55,52.7,23,33,69.7,10,25,35,8,16,29,15,12,2,2,91,Stal Stalowa Wola,Sezon 2008/2009
2009-05-09 18:00,Polonia 2011 Warszawa(d),94 : 94P,94,25,42,59.5,9,21,42.9,34,63,54.0,17,22,77.3,9,32,41,22,8,17,18,5,1,3,111,Stal Stalowa Wola,Sezon 2008/2009
2009-05-13 18:00,Polonia 2011 Warszawa(w),78 : 73P,73,23,42,54.8,5,23,21.7,28,65,43.1,12,17,70.6,10,26,36,16,23,16,20,6,1,6,70,Stal Stalowa Wola,Sezon 2008/2009
2008-09-20 18:00,ŁKS Łódź(w),90 : 91W,91,19,34,55.9,10,23,43.5,29,57,50.9,23,32,71.9,9,25,34,15,19,28,11,7,3,1,102,Zastal Intermarche Zielona Góra,Sezon 2008/2009
2008-09-27 18:00,Miasto Szkła Krosno(d),75 : 77P,75,16,31,51.6,10,29,34.5,26,60,43.3,13,21,61.9,11,26,37,14,20,20,14,5,1,1,76,Zastal Intermarche Zielona Góra,Sezon 2008/2009
2008-10-04 15:00,Polonia 2011 Warszawa(w),95 : 108W,108,23,38,60.5,11,24,45.8,34,62,54.8,29,37,78.4,5,38,43,18,25,27,32,11,3,3,115,Zastal Intermarche Zielona Góra,Sezon 2008/2009
2008-10-08 18:00,Znicz Basket Pruszków(d),87 : 73W,87,25,41,61.0,6,19,31.6,31,60,51.7,19,32,59.4,12,26,38,16,16,25,10,9,3,2,101,Zastal Intermarche Zielona Góra,Sezon 2008/2009
2008-10-11 18:30,KS Sudety Jelenia Góra(w),77 : 71P,71,18,28,64.3,9,24,37.5,27,52,51.9,8,16,50.0,9,17,26,12,31,22,10,5,2,0,73,Zastal Intermarche Zielona Góra,Sezon 2008/2009
2008-10-19 17:00,AZS PWSZ Kalisz(d),57 : 44W,57,16,32,50.0,4,20,20.0,20,52,38.5,13,23,56.5,13,27,40,9,21,22,17,7,2,2,56,Zastal Intermarche Zielona Góra,Sezon 2008/2009
2008-10-26 18:00,MKS Dąbrowa Górnicza(w),61 : 55P,55,15,42,35.7,4,16,25.0,19,58,32.8,13,24,54.2,17,20,37,7,21,20,13,6,1,3,43,Zastal Intermarche Zielona Góra,Sezon 2008/2009
2008-10-29 18:00,Żubry Białystok(d),69 : 72P,69,20,41,48.8,6,12,50.0,26,53,49.1,11,22,50.0,10,31,41,12,25,25,16,9,0,6,77,Zastal Intermarche Zielona Góra,Sezon 2008/2009
2008-11-09 18:30,KS AZS AWF Katowice(w),78 : 72P,72,18,29,62.1,6,24,25.0,24,53,45.3,18,23,78.3,7,21,28,13,26,22,17,0,2,4,64,Zastal Intermarche Zielona Góra,Sezon 2008/2009
2008-11-15 18:00,GKS Tychy(d),51 : 62P,51,15,31,48.4,4,21,19.0,19,52,36.5,9,11,81.8,8,20,28,10,13,17,11,9,2,2,54,Zastal Intermarche Zielona Góra,Sezon 2008/2009
2008-11-22 17:00,Stal Stalowa Wola(w),69 : 62P,62,14,33,42.4,8,23,34.8,22,56,39.3,10,17,58.8,11,24,35,11,18,19,11,3,3,2,62,Zastal Intermarche Zielona Góra,Sezon 2008/2009
2008-11-26 18:00,Siarka Tarnobrzeg(d),70 : 64W,70,15,30,50.0,10,27,37.0,25,57,43.9,10,22,45.5,10,26,36,15,30,23,19,15,2,7,75,Zastal Intermarche Zielona Góra,Sezon 2008/2009
2008-11-30 18:00,Resovia Rzeszów(w),61 : 74W,74,19,31,61.3,7,19,36.8,26,50,52.0,15,20,75.0,9,23,32,15,21,24,21,10,5,0,86,Zastal Intermarche Zielona Góra,Sezon 2008/2009
2008-12-06 19:00,PTG Sokół Łańcut(d),78 : 51W,78,21,44,47.7,11,21,52.4,32,65,49.2,3,11,27.3,11,17,28,19,15,15,11,18,2,5,93,Zastal Intermarche Zielona Góra,Sezon 2008/2009
2008-12-13 13:00,Asseco Prokom 2 Gdynia(w),53 : 76W,76,16,31,51.6,10,30,33.3,26,61,42.6,14,20,70.0,13,23,36,15,19,22,18,14,0,3,82,Zastal Intermarche Zielona Góra,Sezon 2008/2009
2008-12-20 19:00,ŁKS Łódź(d),61 : 64P,61,17,40,42.5,5,20,25.0,22,60,36.7,12,15,80.0,6,19,25,14,16,18,8,13,0,1,64,Zastal Intermarche Zielona Góra,Sezon 2008/2009
2009-01-04 18:00,Miasto Szkła Krosno(w),66 : 71W,71,17,32,53.1,8,21,38.1,25,53,47.2,13,25,52.0,9,25,34,10,21,27,17,7,2,2,67,Zastal Intermarche Zielona Góra,Sezon 2008/2009
2009-01-11 17:00,Polonia 2011 Warszawa(d),80 : 87P,80,18,32,56.3,9,19,47.4,27,51,52.9,17,24,70.8,7,17,24,13,25,23,17,11,2,2,82,Zastal Intermarche Zielona Góra,Sezon 2008/2009
2009-01-14 18:00,Znicz Basket Pruszków(w),75 : 81W,81,19,31,61.3,7,16,43.8,26,47,55.3,22,38,57.9,6,25,31,14,31,29,12,7,1,0,85,Zastal Intermarche Zielona Góra,Sezon 2008/2009
2009-01-17 18:00,KS Sudety Jelenia Góra(d),63 : 60W,63,14,34,41.2,9,24,37.5,23,58,39.7,8,13,61.5,12,26,38,15,24,20,15,6,3,7,70,Zastal Intermarche Zielona Góra,Sezon 2008/2009
2009-01-24 17:30,AZS PWSZ Kalisz(w),35 : 70W,70,10,29,34.5,12,28,42.9,22,57,38.6,14,18,77.8,8,33,41,12,19,12,9,10,0,1,85,Zastal Intermarche Zielona Góra,Sezon 2008/2009
2009-01-31 16:00,MKS Dąbrowa Górnicza(d),90 : 50W,90,27,44,61.4,8,18,44.4,35,62,56.5,12,19,63.2,4,22,26,18,20,20,11,28,5,4,122,Zastal Intermarche Zielona Góra,Sezon 2008/2009
2009-02-04 18:00,Żubry Białystok(w),63 : 84W,84,21,40,52.5,12,20,60.0,33,60,55.0,6,11,54.5,6,20,26,14,22,17,13,10,2,4,91,Zastal Intermarche Zielona Góra,Sezon 2008/2009
2009-02-08 17:00,KS AZS AWF Katowice(d),112 : 57W,112,35,49,71.4,11,14,78.6,46,63,73.0,9,12,75.0,7,31,38,28,23,12,11,13,2,2,162,Zastal Intermarche Zielona Góra,Sezon 2008/2009
2009-02-14 18:00,GKS Tychy(w),75 : 69P,69,13,32,40.6,9,18,50.0,22,50,44.0,16,20,80.0,7,17,24,7,18,20,14,10,0,5,64,Zastal Intermarche Zielona Góra,Sezon 2008/2009
2009-02-18 18:00,Stal Stalowa Wola(d),72 : 57W,72,18,44,40.9,8,19,42.1,26,63,41.3,12,13,92.3,9,26,35,11,22,16,10,12,3,5,85,Zastal Intermarche Zielona Góra,Sezon 2008/2009
2009-02-25 18:00,Siarka Tarnobrzeg(w),92 : 70P,70,19,32,59.4,6,26,23.1,25,58,43.1,14,18,77.8,7,13,20,13,23,23,18,5,3,3,56,Zastal Intermarche Zielona Góra,Sezon 2008/2009
2009-03-01 17:00,Resovia Rzeszów(d),101 : 41W,101,36,48,75.0,6,18,33.3,42,66,63.6,11,19,57.9,10,33,43,31,17,14,14,20,7,1,156,Zastal Intermarche Zielona Góra,Sezon 2008/2009
2009-03-08 17:30,PTG Sokół Łańcut(w),51 : 88W,88,22,34,64.7,12,24,50.0,34,58,58.6,8,12,66.7,7,22,29,18,18,15,10,14,0,5,111,Zastal Intermarche Zielona Góra,Sezon 2008/2009
2009-03-21 18:00,Siarka Tarnobrzeg(w),70 : 82W,82,23,33,69.7,7,21,33.3,30,54,55.6,15,24,62.5,11,23,34,13,19,28,17,15,0,3,94,Zastal Intermarche Zielona Góra,Sezon 2008/2009
2009-03-22 17:00,Siarka Tarnobrzeg(w),65 : 66W,66,16,35,45.7,9,26,34.6,25,61,41.0,7,15,46.7,7,24,31,10,24,15,12,5,0,3,56,Zastal Intermarche Zielona Góra,Sezon 2008/2009
2009-03-28 18:00,Siarka Tarnobrzeg(d),66 : 52W,66,18,38,47.4,7,22,31.8,25,60,41.7,9,13,69.2,13,31,44,19,20,19,12,11,2,4,91,Zastal Intermarche Zielona Góra,Sezon 2008/2009
2009-04-18 15:00,Polonia 2011 Warszawa(w),79 : 54P,54,15,47,31.9,2,19,10.5,17,66,25.8,18,27,66.7,12,23,35,9,17,26,11,12,1,3,42,Zastal Intermarche Zielona Góra,Sezon 2008/2009
2009-04-19 15:00,Polonia 2011 Warszawa(w),85 : 89W,89,18,43,41.9,13,29,44.8,31,72,43.1,14,21,66.7,11,29,40,19,20,23,19,15,0,7,96,Zastal Intermarche Zielona Góra,Sezon 2008/2009
2009-04-25 18:00,Polonia 2011 Warszawa(d),69 : 86P,69,17,31,54.8,6,26,23.1,23,57,40.4,17,23,73.9,12,17,29,14,25,23,15,11,0,0,68,Zastal Intermarche Zielona Góra,Sezon 2008/2009
2009-04-26 17:00,Polonia 2011 Warszawa(d),66 : 70P,66,9,23,39.1,11,30,36.7,20,53,37.7,15,26,57.7,12,21,33,14,21,24,14,12,1,1,68,Zastal Intermarche Zielona Góra,Sezon 2008/2009
2007-09-22 17:30,Polonia 2011 Warszawa(d),81 : 73W,81,27,44,61.4,5,16,31.3,32,60,53.3,12,16,75.0,6,19,25,17,21,0,15,15,3,0,94,PTG Sokół Łańcut,Sezon 2007/2008
2007-09-30 17:00,Siarka Tarnobrzeg(w),67 : 79W,79,27,44,61.4,4,20,20.0,31,64,48.4,13,18,72.2,16,15,31,20,17,21,10,10,1,0,93,PTG Sokół Łańcut,Sezon 2007/2008
2007-10-06 17:30,Znicz Jarosław(d),79 : 55W,79,23,47,48.9,8,18,44.4,31,65,47.7,9,9,100.0,8,18,26,17,16,18,15,21,2,0,96,PTG Sokół Łańcut,Sezon 2007/2008
2007-10-10 18:00,GKS Tychy(w),65 : 82W,82,23,45,51.1,9,22,40.9,32,67,47.8,9,10,90.0,10,24,34,16,15,12,11,7,0,8,92,PTG Sokół Łańcut,Sezon 2007/2008
2007-10-13 17:30,Żubry Białystok(d),71 : 53W,71,20,44,45.5,7,24,29.2,27,68,39.7,10,14,71.4,17,27,44,18,16,16,16,13,6,0,91,PTG Sokół Łańcut,Sezon 2007/2008
2007-10-20 18:00,PBG Basket Poznań(w),92 : 86P,86,25,46,54.3,9,20,45.0,34,66,51.5,9,14,64.3,4,12,16,8,26,17,4,11,5,0,85,PTG Sokół Łańcut,Sezon 2007/2008
2007-10-27 17:30,MKS Start AZS Lublin(d),105 : 65W,105,27,49,55.1,11,23,47.8,38,72,52.8,18,26,69.2,14,26,40,31,19,21,8,14,2,1,142,PTG Sokół Łańcut,Sezon 2007/2008
2007-11-03 17:30,Znicz Basket Pruszków(d),71 : 63W,71,15,40,37.5,7,16,43.8,22,56,39.3,20,22,90.9,9,27,36,12,20,20,9,8,1,2,83,PTG Sokół Łańcut,Sezon 2007/2008
2007-11-10 18:00,Resovia Rzeszów(w),81 : 88W,88,26,49,53.1,7,21,33.3,33,70,47.1,15,17,88.2,15,21,36,13,18,21,12,5,2,0,93,PTG Sokół Łańcut,Sezon 2007/2008
2007-11-17 17:30,Asseco Prokom 2 Gdynia(d),84 : 66W,84,19,36,52.8,11,24,45.8,30,60,50.0,13,19,68.4,10,21,31,27,15,14,16,18,2,6,110,PTG Sokół Łańcut,Sezon 2007/2008
2007-11-24 18:00,Wiecko Zastal Zielona Góra(w),67 : 58P,58,14,37,37.8,6,23,26.1,20,60,33.3,12,15,80.0,8,18,26,8,22,17,12,12,2,1,51,PTG Sokół Łańcut,Sezon 2007/2008
2007-12-01 17:30,MKKS Rybnik(d),97 : 75W,97,29,44,65.9,7,22,31.8,36,66,54.5,18,24,75.0,12,25,37,25,17,20,9,14,2,1,130,PTG Sokół Łańcut,Sezon 2007/2008
2007-12-08 18:00,Sportino Inowrocław(w),86 : 59P,59,16,41,39.0,6,20,30.0,22,61,36.1,9,15,60.0,9,11,20,16,20,18,7,11,0,0,54,PTG Sokół Łańcut,Sezon 2007/2008
2007-12-15 17:30,Tarnovia Tarnowo Podgórne(d),74 : 59W,74,27,45,60.0,4,21,19.0,31,66,47.0,8,14,57.1,11,22,33,22,14,18,8,14,5,3,99,PTG Sokół Łańcut,Sezon 2007/2008
2007-12-19 18:00,Stal Stalowa Wola(w),80 : 90W,90,26,40,65.0,9,21,42.9,35,61,57.4,11,15,73.3,10,23,33,18,16,15,13,5,0,1,103,PTG Sokół Łańcut,Sezon 2007/2008
2008-01-05 17:30,Siarka Tarnobrzeg(d),82 : 78W,82,21,42,50.0,3,19,15.8,24,61,39.3,31,36,86.1,11,28,39,15,28,27,11,8,5,1,96,PTG Sokół Łańcut,Sezon 2007/2008
2008-01-08 18:00,Polonia 2011 Warszawa(w),69 : 80W,80,18,38,47.4,9,19,47.4,27,57,47.4,17,20,85.0,10,16,26,15,21,22,15,12,1,2,86,PTG Sokół Łańcut,Sezon 2007/2008
2008-01-13 18:00,Znicz Jarosław(w),85 : 76P,76,15,35,42.9,13,27,48.1,28,62,45.2,7,9,77.8,8,16,24,14,20,13,11,11,3,1,81,PTG Sokół Łańcut,Sezon 2007/2008
2008-01-16 18:00,GKS Tychy(d),83 : 73W,83,27,42,64.3,6,13,46.2,33,55,60.0,11,17,64.7,10,21,31,23,15,17,14,11,1,3,107,PTG Sokół Łańcut,Sezon 2007/2008
2008-01-19 15:00,Żubry Białystok(w),63 : 78W,78,22,37,59.5,9,23,39.1,31,60,51.7,7,11,63.6,3,23,26,9,11,13,12,5,3,1,76,PTG Sokół Łańcut,Sezon 2007/2008
2008-01-30 17:30,PBG Basket Poznań(d),67 : 82P,67,14,42,33.3,9,30,30.0,23,72,31.9,12,16,75.0,12,18,30,14,21,21,7,10,0,1,61,PTG Sokół Łańcut,Sezon 2007/2008
2008-02-03 17:00,MKS Start AZS Lublin(w),69 : 87W,87,16,31,51.6,11,23,47.8,27,54,50.0,22,30,73.3,7,20,27,13,22,25,20,13,3,2,88,PTG Sokół Łańcut,Sezon 2007/2008
2008-02-09 18:00,Znicz Basket Pruszków(w),83 : 89W,89,15,29,51.7,14,29,48.3,29,58,50.0,17,28,60.7,11,15,26,13,21,26,14,11,0,2,85,PTG Sokół Łańcut,Sezon 2007/2008
2008-02-16 17:30,Resovia Rzeszów(d),94 : 70W,94,21,34,61.8,10,24,41.7,31,58,53.4,22,28,78.6,8,25,33,21,24,20,16,11,2,2,112,PTG Sokół Łańcut,Sezon 2007/2008
2008-02-24 15:00,Asseco Prokom 2 Gdynia(w),79 : 80W,80,25,50,50.0,5,31,16.1,30,81,37.0,15,24,62.5,22,27,49,7,13,23,18,11,0,4,69,PTG Sokół Łańcut,Sezon 2007/2008
2008-03-08 17:00,MKKS Rybnik(w),76 : 84W,84,27,44,61.4,2,20,10.0,29,64,45.3,24,32,75.0,10,29,39,18,19,0,13,11,2,0,98,PTG Sokół Łańcut,Sezon 2007/2008
2008-03-14 16:30,Wiecko Zastal Zielona Góra(d),69 : 63W,69,15,34,44.1,7,25,28.0,22,59,37.3,18,24,75.0,13,23,36,17,14,24,10,9,4,3,82,PTG Sokół Łańcut,Sezon 2007/2008
2008-03-16 17:30,Sportino Inowrocław(d),74 : 62W,74,13,28,46.4,8,21,38.1,21,49,42.9,24,27,88.9,5,18,23,14,20,0,9,15,0,0,86,PTG Sokół Łańcut,Sezon 2007/2008
2008-03-30 16:00,Tarnovia Tarnowo Podgórne(w),41 : 71W,71,17,37,45.9,6,19,31.6,23,56,41.1,19,26,73.1,13,24,37,11,15,11,11,9,0,2,77,PTG Sokół Łańcut,Sezon 2007/2008
2008-04-02 18:00,Stal Stalowa Wola(d),94 : 73W,94,26,49,53.1,6,13,46.2,32,62,51.6,24,31,77.4,7,30,37,21,17,23,11,15,3,2,122,PTG Sokół Łańcut,Sezon 2007/2008
2008-04-05 17:30,Resovia Rzeszów(d),86 : 63W,86,26,43,60.5,6,23,26.1,32,66,48.5,16,22,72.7,13,25,38,15,26,19,19,15,3,1,98,PTG Sokół Łańcut,Sezon 2007/2008
2008-04-06 17:30,Resovia Rzeszów(d),65 : 56W,65,17,33,51.5,4,17,23.5,21,50,42.0,19,23,82.6,9,20,29,10,18,22,16,12,5,0,72,PTG Sokół Łańcut,Sezon 2007/2008
2008-04-12 17:00,Resovia Rzeszów(w),92 : 69P,69,17,35,48.6,6,23,26.1,23,58,39.7,17,19,89.5,10,16,26,11,23,19,15,6,3,0,63,PTG Sokół Łańcut,Sezon 2007/2008
2008-04-13 18:00,Resovia Rzeszów(w),55 : 69W,69,22,39,56.4,6,16,37.5,28,55,50.9,7,13,53.8,5,15,20,13,19,16,9,13,1,0,74,PTG Sokół Łańcut,Sezon 2007/2008
2008-04-19 17:30,Sportino Inowrocław(d),74 : 66W,74,17,32,53.1,7,17,41.2,24,49,49.0,19,26,73.1,6,23,29,14,16,25,10,7,3,2,85,PTG Sokół Łańcut,Sezon 2007/2008
2008-04-20 17:30,Sportino Inowrocław(d),55 : 63P,55,18,33,54.5,2,16,12.5,20,49,40.8,13,19,68.4,7,21,28,4,21,22,14,11,3,0,52,PTG Sokół Łańcut,Sezon 2007/2008
2008-04-26 18:00,Sportino Inowrocław(w),68 : 53P,53,17,35,48.6,4,17,23.5,21,52,40.4,7,16,43.8,11,24,35,10,21,22,16,6,2,1,50,PTG Sokół Łańcut,Sezon 2007/2008
2008-04-27 18:00,Sportino Inowrocław(w),66 : 54P,54,13,33,39.4,5,18,27.8,18,51,35.3,13,19,68.4,13,25,38,10,24,23,19,8,1,2,53,PTG Sokół Łańcut,Sezon 2007/2008
2007-09-22 17:00,Znicz Jarosław(d),89 : 92P,89,31,47,66.0,5,24,20.8,36,71,50.7,12,19,63.2,12,8,20,15,20,0,7,7,1,0,83,Żubry Białystok,Sezon 2007/2008
2007-09-29 18:00,GKS Tychy(w),82 : 71P,71,16,31,51.6,6,28,21.4,22,59,37.3,21,25,84.0,8,16,24,12,23,22,9,10,1,0,68,Żubry Białystok,Sezon 2007/2008
2007-10-06 17:00,MKS Start AZS Lublin(d),83 : 68W,83,19,27,70.4,8,20,40.0,27,47,57.4,21,36,58.3,3,15,18,17,25,30,14,11,3,0,83,Żubry Białystok,Sezon 2007/2008
2007-10-10 17:00,PBG Basket Poznań(d),75 : 90P,75,18,36,50.0,7,32,21.9,25,68,36.8,18,29,62.1,10,17,27,15,23,26,15,9,1,4,58,Żubry Białystok,Sezon 2007/2008
2007-10-13 17:30,PTG Sokół Łańcut(w),71 : 53P,53,13,28,46.4,5,24,20.8,18,52,34.6,12,23,52.2,10,22,32,6,19,15,17,7,4,0,40,Żubry Białystok,Sezon 2007/2008
2007-10-20 17:00,Znicz Basket Pruszków(d),79 : 73W,79,24,43,55.8,4,19,21.1,28,62,45.2,19,28,67.9,15,27,42,14,25,24,9,6,5,1,94,Żubry Białystok,Sezon 2007/2008
2007-10-27 18:00,Resovia Rzeszów(w),74 : 80W,80,17,35,48.6,8,23,34.8,25,58,43.1,22,34,64.7,14,30,44,17,35,26,14,4,2,0,88,Żubry Białystok,Sezon 2007/2008
2007-11-03 17:00,Asseco Prokom 2 Gdynia(d),82 : 66W,82,23,45,51.1,9,26,34.6,32,71,45.1,9,13,69.2,16,24,40,25,14,11,9,10,4,5,109,Żubry Białystok,Sezon 2007/2008
2007-11-11 17:00,Wiecko Zastal Zielona Góra(w),59 : 54P,54,9,24,37.5,8,25,32.0,17,49,34.7,12,26,46.2,10,29,39,9,20,24,11,8,3,2,56,Żubry Białystok,Sezon 2007/2008
2007-11-17 15:00,MKKS Rybnik(d),80 : 78W,80,18,41,43.9,10,23,43.5,28,64,43.8,14,18,77.8,12,26,38,13,17,17,10,5,3,3,89,Żubry Białystok,Sezon 2007/2008
2007-11-24 18:00,Sportino Inowrocław(w),64 : 59P,59,14,30,46.7,6,17,35.3,20,47,42.6,13,24,54.2,6,23,29,11,26,19,17,7,2,2,53,Żubry Białystok,Sezon 2007/2008
2007-12-01 15:00,Tarnovia Tarnowo Podgórne(d),73 : 60W,73,23,51,45.1,4,20,20.0,27,71,38.0,15,36,41.7,16,28,44,14,19,28,8,12,5,3,75,Żubry Białystok,Sezon 2007/2008
2007-12-08 17:00,Stal Stalowa Wola(w),101 : 70P,70,18,44,40.9,8,25,32.0,26,69,37.7,10,19,52.6,15,17,32,11,15,21,10,6,2,4,59,Żubry Białystok,Sezon 2007/2008
2007-12-15 17:00,Polonia 2011 Warszawa(d),63 : 53W,63,17,36,47.2,6,21,28.6,23,57,40.4,11,22,50.0,9,16,25,10,25,23,9,8,2,0,54,Żubry Białystok,Sezon 2007/2008
2007-12-19 18:00,Siarka Tarnobrzeg(w),71 : 96W,96,23,43,53.5,11,22,50.0,34,65,52.3,17,25,68.0,5,17,22,23,21,21,11,14,4,3,109,Żubry Białystok,Sezon 2007/2008
2008-01-05 15:00,GKS Tychy(d),79 : 65W,79,19,42,45.2,11,21,52.4,30,63,47.6,8,14,57.1,9,19,28,20,15,17,12,13,4,4,93,Żubry Białystok,Sezon 2007/2008
2008-01-09 18:00,Znicz Jarosław(w),86 : 74P,74,14,38,36.8,14,29,48.3,28,67,41.8,4,9,44.4,11,10,21,16,17,14,11,11,2,4,69,Żubry Białystok,Sezon 2007/2008
2008-01-12 16:00,MKS Start AZS Lublin(w),56 : 71W,71,16,32,50.0,8,26,30.8,24,58,41.4,15,25,60.0,11,28,39,14,19,23,17,11,4,3,78,Żubry Białystok,Sezon 2007/2008
2008-01-16 18:00,PBG Basket Poznań(w),93 : 78P,78,19,47,40.4,7,27,25.9,26,74,35.1,19,31,61.3,18,19,37,12,21,24,8,14,1,0,74,Żubry Białystok,Sezon 2007/2008
2008-01-19 15:00,PTG Sokół Łańcut(d),63 : 78P,63,14,40,35.0,9,27,33.3,23,67,34.3,8,12,66.7,13,23,36,15,14,11,9,7,1,3,65,Żubry Białystok,Sezon 2007/2008
2008-01-26 19:15,Znicz Basket Pruszków(w),79 : 71P,71,15,41,36.6,8,19,42.1,23,60,38.3,17,32,53.1,9,17,26,12,15,29,8,6,0,2,55,Żubry Białystok,Sezon 2007/2008
2008-02-02 17:00,Resovia Rzeszów(d),69 : 77P,69,14,37,37.8,9,28,32.1,23,65,35.4,14,19,73.7,9,22,31,11,19,19,12,9,2,2,63,Żubry Białystok,Sezon 2007/2008
2008-02-10 15:00,Asseco Prokom 2 Gdynia(w),75 : 85W,85,18,38,47.4,9,25,36.0,27,63,42.9,22,36,61.1,11,17,28,15,18,30,16,15,2,5,79,Żubry Białystok,Sezon 2007/2008
2008-02-16 17:00,Wiecko Zastal Zielona Góra(d),62 : 75P,62,18,30,60.0,5,22,22.7,23,52,44.2,11,22,50.0,9,18,27,10,15,19,14,3,0,1,48,Żubry Białystok,Sezon 2007/2008
2008-02-23 17:00,MKKS Rybnik(w),95 : 79P,79,22,39,56.4,5,22,22.7,27,61,44.3,20,37,54.1,9,18,27,9,29,23,22,11,1,1,54,Żubry Białystok,Sezon 2007/2008
2008-03-01 17:00,Sportino Inowrocław(d),71 : 75P,71,17,41,41.5,7,17,41.2,24,58,41.4,16,23,69.6,8,20,28,7,17,19,13,4,6,5,62,Żubry Białystok,Sezon 2007/2008
2008-03-09 16:00,Tarnovia Tarnowo Podgórne(w),70 : 85W,85,28,50,56.0,8,16,50.0,36,66,54.5,5,11,45.5,15,27,42,20,20,4,18,7,2,2,102,Żubry Białystok,Sezon 2007/2008
2008-03-15 17:00,Stal Stalowa Wola(d),71 : 76P,71,21,38,55.3,5,24,20.8,26,62,41.9,14,26,53.8,12,25,37,11,30,22,14,12,6,4,75,Żubry Białystok,Sezon 2007/2008
2008-03-29 19:00,Polonia 2011 Warszawa(w),80 : 83W,83,26,44,59.1,6,23,26.1,32,67,47.8,13,21,61.9,20,21,41,14,16,24,20,7,4,1,86,Żubry Białystok,Sezon 2007/2008
2008-04-02 17:00,Siarka Tarnobrzeg(d),103 : 83W,103,31,45,68.9,9,25,36.0,40,70,57.1,14,16,87.5,10,29,39,26,25,18,14,7,4,2,133,Żubry Białystok,Sezon 2007/2008
2007-09-23 18:30,Siarka Tarnobrzeg(d),78 : 70W,78,25,44,56.8,3,9,33.3,28,53,52.8,19,29,65.5,12,21,33,16,25,0,7,8,0,0,93,PBG Basket Poznań,Sezon 2007/2008
2007-09-29 18:00,Znicz Jarosław(w),83 : 76P,76,25,43,58.1,6,14,42.9,31,57,54.4,8,11,72.7,6,15,21,15,24,10,17,12,2,0,80,PBG Basket Poznań,Sezon 2007/2008
2007-10-06 15:00,GKS Tychy(d),83 : 59W,83,19,27,70.4,13,26,50.0,32,53,60.4,6,13,46.2,7,25,32,23,23,14,20,8,2,0,100,PBG Basket Poznań,Sezon 2007/2008
2007-10-10 17:00,Żubry Białystok(w),75 : 90W,90,28,40,70.0,6,17,35.3,34,57,59.6,16,30,53.3,5,29,34,20,26,23,11,8,4,1,108,PBG Basket Poznań,Sezon 2007/2008
2007-10-14 18:00,MKS Start AZS Lublin(d),97 : 71W,97,31,51,60.8,4,18,22.2,35,69,50.7,23,31,74.2,19,17,36,25,17,26,22,17,0,2,111,PBG Basket Poznań,Sezon 2007/2008
2007-10-20 18:00,PTG Sokół Łańcut(d),92 : 86W,92,22,45,48.9,7,11,63.6,29,56,51.8,27,32,84.4,8,24,32,17,17,25,15,4,2,3,100,PBG Basket Poznań,Sezon 2007/2008
2007-10-27 18:00,Znicz Basket Pruszków(w),81 : 83W,83,22,41,53.7,7,17,41.2,29,58,50.0,18,28,64.3,11,30,41,15,24,24,20,7,5,3,92,PBG Basket Poznań,Sezon 2007/2008
2007-11-03 15:00,Resovia Rzeszów(d),57 : 69P,57,15,41,36.6,5,27,18.5,20,68,29.4,12,20,60.0,15,28,43,10,24,22,25,13,2,0,44,PBG Basket Poznań,Sezon 2007/2008
2007-11-11 15:00,Asseco Prokom 2 Gdynia(w),51 : 88W,88,23,41,56.1,7,18,38.9,30,59,50.8,21,33,63.6,10,28,38,18,21,29,19,17,3,4,104,PBG Basket Poznań,Sezon 2007/2008
2007-11-17 15:30,Wiecko Zastal Zielona Góra(d),62 : 66P,62,22,38,57.9,1,21,4.8,23,59,39.0,15,27,55.6,10,28,38,18,24,27,11,12,4,0,75,PBG Basket Poznań,Sezon 2007/2008
2007-11-24 16:30,MKKS Rybnik(w),83 : 89W,89,26,45,57.8,4,17,23.5,30,62,48.4,25,43,58.1,12,35,47,10,23,25,13,4,1,1,88,PBG Basket Poznań,Sezon 2007/2008
2007-12-02 18:30,Sportino Inowrocław(d),65 : 73P,65,12,26,46.2,8,18,44.4,20,44,45.5,17,25,68.0,2,19,21,14,26,23,21,12,2,0,61,PBG Basket Poznań,Sezon 2007/2008
2007-12-09 16:00,Tarnovia Tarnowo Podgórne(w),67 : 84W,84,21,47,44.7,5,16,31.3,26,63,41.3,27,31,87.1,12,31,43,11,18,0,12,5,0,2,90,PBG Basket Poznań,Sezon 2007/2008
2007-12-14 18:00,Stal Stalowa Wola(d),95 : 85W,95,25,42,59.5,8,23,34.8,33,65,50.8,21,27,77.8,15,24,39,14,23,25,14,10,4,0,110,PBG Basket Poznań,Sezon 2007/2008
2007-12-19 18:00,Polonia 2011 Warszawa(w),86 : 78P,78,27,49,55.1,6,21,28.6,33,70,47.1,6,13,46.2,16,28,44,14,29,20,20,8,2,2,82,PBG Basket Poznań,Sezon 2007/2008
2008-01-05 18:00,Znicz Jarosław(d),68 : 66W,68,19,37,51.4,6,24,25.0,25,61,41.0,12,24,50.0,14,27,41,9,21,20,12,9,2,0,69,PBG Basket Poznań,Sezon 2007/2008
2008-01-09 18:00,Siarka Tarnobrzeg(w),99 : 93P,93,27,49,55.1,5,16,31.3,32,65,49.2,24,29,82.8,14,24,38,15,31,24,26,8,1,2,91,PBG Basket Poznań,Sezon 2007/2008
2008-01-12 17:00,GKS Tychy(w),87 : 82P,82,28,50,56.0,4,17,23.5,32,67,47.8,14,20,70.0,15,24,39,12,28,25,17,7,2,5,84,PBG Basket Poznań,Sezon 2007/2008
2008-01-16 18:00,Żubry Białystok(d),93 : 78W,93,20,37,54.1,12,27,44.4,32,64,50.0,17,22,77.3,10,32,42,18,24,21,20,7,2,0,105,PBG Basket Poznań,Sezon 2007/2008
2008-01-19 17:00,MKS Start AZS Lublin(w),69 : 82W,82,19,37,51.4,10,27,37.0,29,64,45.3,14,20,70.0,12,19,31,14,22,24,15,11,5,0,87,PBG Basket Poznań,Sezon 2007/2008
2008-01-30 17:30,PTG Sokół Łańcut(w),67 : 82W,82,23,38,60.5,5,19,26.3,28,57,49.1,21,26,80.8,11,31,42,14,21,21,13,5,1,0,97,PBG Basket Poznań,Sezon 2007/2008
2008-02-03 18:00,Znicz Basket Pruszków(d),78 : 69W,78,22,44,50.0,6,17,35.3,28,61,45.9,16,25,64.0,8,33,41,13,22,23,16,10,5,3,89,PBG Basket Poznań,Sezon 2007/2008
2008-02-09 18:00,Resovia Rzeszów(w),67 : 70W,70,20,37,54.1,6,23,26.1,26,60,43.3,12,18,66.7,12,27,39,12,16,18,18,11,1,0,75,PBG Basket Poznań,Sezon 2007/2008
2008-02-16 18:00,Asseco Prokom 2 Gdynia(d),84 : 61W,84,25,46,54.3,6,16,37.5,31,62,50.0,16,26,61.5,8,30,38,20,14,22,12,17,2,2,108,PBG Basket Poznań,Sezon 2007/2008
2008-02-23 18:00,Wiecko Zastal Zielona Góra(w),71 : 56P,56,21,40,52.5,2,22,9.1,23,62,37.1,8,13,61.5,11,15,26,9,19,18,15,10,2,4,44,PBG Basket Poznań,Sezon 2007/2008
2008-03-01 18:00,MKKS Rybnik(d),111 : 102W,111,30,43,69.8,7,17,41.2,37,60,61.7,30,37,81.1,9,25,34,21,25,27,15,5,3,0,129,PBG Basket Poznań,Sezon 2007/2008
2008-03-08 18:00,Sportino Inowrocław(w),74 : 90W,90,26,45,57.8,7,18,38.9,33,63,52.4,17,30,56.7,8,31,39,23,20,27,18,7,7,4,105,PBG Basket Poznań,Sezon 2007/2008
2008-03-16 18:00,Tarnovia Tarnowo Podgórne(d),77 : 63W,77,27,54,50.0,4,18,22.2,31,72,43.1,11,16,68.8,18,29,47,13,15,16,14,10,3,1,90,PBG Basket Poznań,Sezon 2007/2008
2008-03-29 17:00,Stal Stalowa Wola(w),81 : 72P,72,17,44,38.6,8,20,40.0,25,64,39.1,14,16,87.5,10,26,36,15,16,18,12,5,8,4,83,PBG Basket Poznań,Sezon 2007/2008
2008-04-02 18:00,Polonia 2011 Warszawa(d),88 : 76W,88,19,38,50.0,12,26,46.2,31,64,48.4,14,25,56.0,11,37,48,17,22,32,17,2,0,1,94,PBG Basket Poznań,Sezon 2007/2008
2008-04-05 18:00,Znicz Jarosław(w),75 : 67P,67,10,26,38.5,11,35,31.4,21,61,34.4,14,19,73.7,9,19,28,13,22,16,13,7,3,5,60,PBG Basket Poznań,Sezon 2007/2008
2008-04-06 18:00,Znicz Jarosław(w),63 : 67W,67,13,27,48.1,9,26,34.6,22,53,41.5,14,22,63.6,7,24,31,14,16,19,12,6,0,2,67,PBG Basket Poznań,Sezon 2007/2008
2008-04-12 18:00,Znicz Jarosław(d),89 : 67W,89,23,43,53.5,10,23,43.5,33,66,50.0,13,14,92.9,10,26,36,20,19,17,11,8,2,5,110,PBG Basket Poznań,Sezon 2007/2008
2008-04-13 18:00,Znicz Jarosław(d),86 : 104P,86,19,41,46.3,11,25,44.0,30,66,45.5,15,17,88.2,13,21,34,15,31,18,12,3,0,2,88,PBG Basket Poznań,Sezon 2007/2008
2008-04-16 18:00,Znicz Jarosław(w),101 : 79P,79,20,32,62.5,10,26,38.5,30,58,51.7,9,11,81.8,15,25,40,13,23,11,28,6,1,3,81,PBG Basket Poznań,Sezon 2007/2008
2007-09-22 17:00,Tarnovia Tarnowo Podgórne(d),81 : 67W,81,22,38,57.9,6,17,35.3,28,55,50.9,19,22,86.4,10,31,41,19,20,0,10,9,4,0,114,Resovia Rzeszów,Sezon 2007/2008
2007-09-29 17:00,Stal Stalowa Wola(w),77 : 58P,58,14,36,38.9,3,15,20.0,17,51,33.3,21,29,72.4,12,18,30,5,24,24,12,6,1,0,46,Resovia Rzeszów,Sezon 2007/2008
2007-10-06 18:00,Polonia 2011 Warszawa(d),64 : 58W,64,19,26,73.1,5,28,17.9,24,54,44.4,11,21,52.4,13,26,39,14,26,20,18,10,6,0,75,Resovia Rzeszów,Sezon 2007/2008
2007-10-10 18:00,Siarka Tarnobrzeg(w),65 : 101W,101,25,38,65.8,12,22,54.5,37,60,61.7,15,20,75.0,11,18,29,21,27,23,15,12,3,0,123,Resovia Rzeszów,Sezon 2007/2008
2007-10-13 18:00,Znicz Jarosław(d),59 : 79P,59,20,42,47.6,2,17,11.8,22,59,37.3,13,16,81.3,13,20,33,20,14,16,15,11,6,0,74,Resovia Rzeszów,Sezon 2007/2008
2007-10-20 18:00,GKS Tychy(w),79 : 78P,78,29,48,60.4,5,24,20.8,34,72,47.2,5,7,71.4,11,19,30,20,20,15,15,13,2,5,88,Resovia Rzeszów,Sezon 2007/2008
2007-10-27 18:00,Żubry Białystok(d),74 : 80P,74,14,38,36.8,7,24,29.2,21,62,33.9,25,36,69.4,11,22,33,16,26,33,9,7,5,0,74,Resovia Rzeszów,Sezon 2007/2008
2007-11-03 15:00,PBG Basket Poznań(w),57 : 69W,69,17,33,51.5,6,26,23.1,23,59,39.0,17,21,81.0,8,31,39,11,23,24,21,17,4,0,79,Resovia Rzeszów,Sezon 2007/2008
2007-11-10 18:00,PTG Sokół Łańcut(d),81 : 88P,81,24,41,58.5,6,18,33.3,30,59,50.8,15,20,75.0,7,15,22,23,22,18,10,10,3,0,95,Resovia Rzeszów,Sezon 2007/2008
2007-11-17 18:00,Znicz Basket Pruszków(d),96 : 75W,96,18,31,58.1,17,32,53.1,35,63,55.6,9,18,50.0,7,23,30,26,20,22,17,12,3,0,113,Resovia Rzeszów,Sezon 2007/2008
2007-11-24 17:00,MKS Start AZS Lublin(d),82 : 54W,82,25,41,61.0,6,19,31.6,31,60,51.7,14,22,63.6,11,24,35,21,20,27,11,16,3,0,109,Resovia Rzeszów,Sezon 2007/2008
2007-12-01 18:00,Asseco Prokom 2 Gdynia(d),94 : 57W,94,24,47,51.1,8,17,47.1,32,64,50.0,22,30,73.3,7,24,31,28,15,23,13,27,2,0,129,Resovia Rzeszów,Sezon 2007/2008
2007-12-08 18:00,Wiecko Zastal Zielona Góra(w),71 : 60P,60,14,29,48.3,6,18,33.3,20,47,42.6,14,26,53.8,7,20,27,7,21,28,16,7,1,4,47,Resovia Rzeszów,Sezon 2007/2008
2007-12-15 18:00,MKKS Rybnik(d),105 : 97W,105,28,46,60.9,8,20,40.0,36,66,54.5,25,36,69.4,13,30,43,22,32,29,18,8,3,0,122,Resovia Rzeszów,Sezon 2007/2008
2007-12-19 18:00,Sportino Inowrocław(w),75 : 49P,49,13,32,40.6,5,18,27.8,18,50,36.0,8,13,61.5,9,23,32,11,17,13,17,7,3,5,48,Resovia Rzeszów,Sezon 2007/2008
2008-01-05 18:00,Stal Stalowa Wola(d),84 : 66W,84,21,42,50.0,7,20,35.0,28,62,45.2,21,27,77.8,10,24,34,20,21,19,14,7,7,0,98,Resovia Rzeszów,Sezon 2007/2008
2008-01-09 18:00,Tarnovia Tarnowo Podgórne(w),69 : 78W,78,18,36,50.0,7,27,25.9,25,63,39.7,21,29,72.4,12,23,35,13,17,24,14,8,2,3,76,Resovia Rzeszów,Sezon 2007/2008
2008-01-12 15:00,Polonia 2011 Warszawa(w),77 : 73P,73,14,35,40.0,10,25,40.0,24,60,40.0,15,23,65.2,9,23,32,11,24,24,19,11,4,5,68,Resovia Rzeszów,Sezon 2007/2008
2008-01-16 17:30,Siarka Tarnobrzeg(d),71 : 55W,71,23,39,59.0,3,19,15.8,26,58,44.8,16,31,51.6,15,25,40,21,29,26,21,5,4,0,73,Resovia Rzeszów,Sezon 2007/2008
2008-01-19 18:00,Znicz Jarosław(w),86 : 64P,64,16,39,41.0,5,15,33.3,21,54,38.9,17,24,70.8,11,19,30,10,17,18,21,8,4,3,55,Resovia Rzeszów,Sezon 2007/2008
2008-01-26 19:05,GKS Tychy(d),84 : 64W,81,25,32,78.1,8,13,61.5,33,45,73.3,7,18,38.9,1,24,25,34,17,10,7,5,2,0,117,Resovia Rzeszów,Sezon 2007/2008
2008-02-02 17:00,Żubry Białystok(w),69 : 77W,77,21,35,60.0,8,28,28.6,29,63,46.0,11,17,64.7,10,28,38,8,21,18,12,9,2,2,82,Resovia Rzeszów,Sezon 2007/2008
2008-02-09 18:00,PBG Basket Poznań(d),67 : 70P,67,16,40,40.0,8,29,27.6,24,69,34.8,11,12,91.7,18,16,34,15,19,16,17,13,8,0,74,Resovia Rzeszów,Sezon 2007/2008
2008-02-16 17:30,PTG Sokół Łańcut(w),94 : 70P,70,15,38,39.5,5,22,22.7,20,60,33.3,25,30,83.3,10,18,28,8,22,24,16,14,2,2,61,Resovia Rzeszów,Sezon 2007/2008
2008-02-23 18:00,Znicz Basket Pruszków(w),73 : 78W,78,22,44,50.0,5,16,31.3,27,60,45.0,19,23,82.6,11,17,28,19,18,23,15,13,4,1,90,Resovia Rzeszów,Sezon 2007/2008
2008-03-01 17:00,MKS Start AZS Lublin(w),61 : 52P,52,9,36,25.0,6,30,20.0,15,66,22.7,16,30,53.3,12,17,29,7,20,31,13,14,2,5,26,Resovia Rzeszów,Sezon 2007/2008
2008-03-08 15:00,Asseco Prokom 2 Gdynia(w),75 : 81W,81,19,32,59.4,8,23,34.8,27,55,49.1,19,27,70.4,9,21,30,15,20,25,19,13,3,6,87,Resovia Rzeszów,Sezon 2007/2008
2008-03-15 19:00,Wiecko Zastal Zielona Góra(d),64 : 73P,64,8,20,40.0,10,23,43.5,18,43,41.9,18,27,66.7,8,28,36,20,19,27,23,9,0,0,72,Resovia Rzeszów,Sezon 2007/2008
2008-03-29 17:00,MKKS Rybnik(w),75 : 84W,84,24,34,70.6,9,22,40.9,33,56,58.9,9,10,90.0,4,18,22,18,20,13,25,14,8,3,97,Resovia Rzeszów,Sezon 2007/2008
2008-04-02 17:30,Sportino Inowrocław(d),54 : 62P,54,15,27,55.6,1,19,5.3,16,46,34.8,21,25,84.0,5,23,28,15,14,22,20,11,3,0,57,Resovia Rzeszów,Sezon 2007/2008
2008-04-05 17:30,PTG Sokół Łańcut(w),86 : 63P,63,21,42,50.0,1,20,5.0,22,62,35.5,18,24,75.0,14,20,34,10,20,26,22,17,1,3,57,Resovia Rzeszów,Sezon 2007/2008
2008-04-06 17:30,PTG Sokół Łańcut(w),65 : 56P,56,13,27,48.1,7,23,30.4,20,50,40.0,9,12,75.0,10,18,28,9,23,18,19,11,0,5,52,Resovia Rzeszów,Sezon 2007/2008
2008-04-12 17:00,PTG Sokół Łańcut(d),92 : 69W,92,19,32,59.4,11,22,50.0,30,54,55.6,21,25,84.0,5,24,29,30,19,21,10,8,4,0,125,Resovia Rzeszów,Sezon 2007/2008
2008-04-13 18:00,PTG Sokół Łańcut(d),55 : 69P,55,14,32,43.8,5,13,38.5,19,45,42.2,12,15,80.0,13,21,34,5,16,18,21,4,1,0,49,Resovia Rzeszów,Sezon 2007/2008
2007-09-23 17:00,Wiecko Zastal Zielona Góra(w),84 : 60P,60,10,33,30.3,7,25,28.0,17,58,29.3,19,25,76.0,7,18,25,12,29,0,13,11,0,0,48,MKKS Rybnik,Sezon 2007/2008
2007-09-29 18:00,MKS Start AZS Lublin(w),45 : 63W,63,13,33,39.4,10,25,40.0,23,58,39.7,7,12,58.3,5,18,23,13,18,23,8,16,2,0,69,MKKS Rybnik,Sezon 2007/2008
2007-10-06 17:00,Sportino Inowrocław(d),69 : 67W,69,15,29,51.7,10,24,41.7,25,53,47.2,9,19,47.4,4,20,24,16,21,19,8,9,4,0,76,MKKS Rybnik,Sezon 2007/2008
2007-10-10 18:00,Tarnovia Tarnowo Podgórne(w),80 : 83W,83,20,44,45.5,6,18,33.3,26,62,41.9,25,35,71.4,6,20,26,6,22,28,10,13,0,1,72,MKKS Rybnik,Sezon 2007/2008
2007-10-13 17:00,Stal Stalowa Wola(d),71 : 86P,71,19,34,55.9,8,24,33.3,27,58,46.6,9,17,52.9,4,19,23,13,20,18,13,7,1,2,63,MKKS Rybnik,Sezon 2007/2008
2007-10-20 15:00,Polonia 2011 Warszawa(w),86 : 78P,78,18,35,51.4,10,28,35.7,28,63,44.4,12,17,70.6,6,20,26,17,27,20,20,16,0,5,77,MKKS Rybnik,Sezon 2007/2008
2007-10-27 16:30,Siarka Tarnobrzeg(d),54 : 67P,54,19,37,51.4,4,24,16.7,23,61,37.7,4,8,50.0,8,20,28,11,32,17,13,5,1,0,44,MKKS Rybnik,Sezon 2007/2008
2007-11-03 18:00,Znicz Jarosław(w),71 : 77W,77,19,36,52.8,9,25,36.0,28,61,45.9,12,19,63.2,6,15,21,14,18,12,9,11,1,0,75,MKKS Rybnik,Sezon 2007/2008
2007-11-10 17:00,GKS Tychy(d),61 : 73P,61,14,31,45.2,10,31,32.3,24,62,38.7,3,4,75.0,7,15,22,20,20,8,3,4,2,1,67,MKKS Rybnik,Sezon 2007/2008
2007-11-17 15:00,Żubry Białystok(w),80 : 78P,78,21,33,63.6,9,29,31.0,30,62,48.4,9,11,81.8,4,19,23,13,17,17,6,5,3,3,82,MKKS Rybnik,Sezon 2007/2008
2007-11-24 16:30,PBG Basket Poznań(d),83 : 89P,83,13,28,46.4,13,39,33.3,26,67,38.8,18,26,69.2,6,22,28,15,30,22,9,7,2,1,77,MKKS Rybnik,Sezon 2007/2008
2007-12-01 17:30,PTG Sokół Łańcut(w),97 : 75P,75,16,33,48.5,11,29,37.9,27,62,43.5,10,14,71.4,8,18,26,11,21,16,15,6,1,2,65,MKKS Rybnik,Sezon 2007/2008
2007-12-08 16:30,Znicz Basket Pruszków(d),94 : 102P,94,23,40,57.5,12,29,41.4,35,69,50.7,12,22,54.5,10,19,29,14,26,21,14,13,1,3,93,MKKS Rybnik,Sezon 2007/2008
2007-12-15 18:00,Resovia Rzeszów(w),105 : 97P,97,18,38,47.4,12,35,34.3,30,73,41.1,25,34,73.5,17,17,34,16,29,31,12,10,1,0,94,MKKS Rybnik,Sezon 2007/2008
2007-12-19 17:00,Asseco Prokom 2 Gdynia(d),82 : 74W,82,21,35,60.0,8,21,38.1,29,56,51.8,16,27,59.3,7,22,29,16,16,24,21,17,1,2,86,MKKS Rybnik,Sezon 2007/2008
2008-01-05 16:30,MKS Start AZS Lublin(d),93 : 72W,93,19,39,48.7,14,29,48.3,33,68,48.5,13,18,72.2,2,25,27,24,23,18,9,18,2,4,115,MKKS Rybnik,Sezon 2007/2008
2008-01-09 17:00,Wiecko Zastal Zielona Góra(d),71 : 75P,71,16,30,53.3,10,24,41.7,26,54,48.1,9,15,60.0,5,21,26,16,15,18,10,12,2,0,83,MKKS Rybnik,Sezon 2007/2008
2008-01-12 18:00,Sportino Inowrocław(w),70 : 65P,65,16,33,48.5,7,15,46.7,23,48,47.9,12,15,80.0,2,24,26,14,21,19,17,5,0,2,65,MKKS Rybnik,Sezon 2007/2008
2008-01-16 17:00,Tarnovia Tarnowo Podgórne(d),108 : 104W,108,34,48,70.8,7,14,50.0,41,62,66.1,19,28,67.9,6,14,20,21,21,22,12,10,1,0,118,MKKS Rybnik,Sezon 2007/2008
2008-01-19 17:00,Stal Stalowa Wola(w),106 : 83P,83,25,47,53.2,7,22,31.8,32,69,46.4,12,18,66.7,8,18,26,16,23,19,6,9,1,2,86,MKKS Rybnik,Sezon 2007/2008
2008-01-30 17:00,Polonia 2011 Warszawa(d),69 : 84P,69,22,41,53.7,2,23,8.7,24,64,37.5,19,29,65.5,13,21,34,7,30,24,12,14,0,2,62,MKKS Rybnik,Sezon 2007/2008
2008-02-02 17:00,Siarka Tarnobrzeg(w),61 : 70W,70,19,35,54.3,4,22,18.2,23,57,40.4,20,23,87.0,5,27,32,16,23,23,16,11,0,1,76,MKKS Rybnik,Sezon 2007/2008
2008-02-09 17:00,Znicz Jarosław(d),63 : 93P,63,17,29,58.6,7,29,24.1,24,58,41.4,8,12,66.7,5,10,15,12,24,17,11,13,1,0,55,MKKS Rybnik,Sezon 2007/2008
2008-02-16 18:00,GKS Tychy(w),82 : 72P,72,19,38,50.0,8,23,34.8,27,61,44.3,10,16,62.5,8,16,24,11,24,17,13,8,0,5,62,MKKS Rybnik,Sezon 2007/2008
2008-02-23 17:00,Żubry Białystok(d),95 : 79W,95,27,41,65.9,7,20,35.0,34,61,55.7,20,24,83.3,6,26,32,19,28,26,15,20,1,1,121,MKKS Rybnik,Sezon 2007/2008
2008-03-01 18:00,PBG Basket Poznań(w),111 : 102P,102,22,39,56.4,12,33,36.4,34,72,47.2,22,27,81.5,11,13,24,17,27,25,10,13,0,3,103,MKKS Rybnik,Sezon 2007/2008
2008-03-08 17:00,PTG Sokół Łańcut(d),76 : 84P,76,21,45,46.7,6,17,35.3,27,62,43.5,16,19,84.2,7,23,30,16,27,0,18,15,1,0,82,MKKS Rybnik,Sezon 2007/2008
2008-03-15 18:00,Znicz Basket Pruszków(w),79 : 87W,87,29,49,59.2,5,14,35.7,34,63,54.0,14,27,51.9,8,25,33,19,26,28,16,14,0,3,95,MKKS Rybnik,Sezon 2007/2008
2008-03-29 17:00,Resovia Rzeszów(d),75 : 84P,75,18,35,51.4,9,21,42.9,27,56,48.2,12,16,75.0,8,15,23,17,15,16,23,21,3,8,83,MKKS Rybnik,Sezon 2007/2008
2008-04-02 16:00,Asseco Prokom 2 Gdynia(w),102 : 77P,77,23,50,46.0,8,19,42.1,31,69,44.9,7,14,50.0,9,18,27,14,27,21,16,11,2,9,70,MKKS Rybnik,Sezon 2007/2008
2007-09-22 17:00,Resovia Rzeszów(w),81 : 67P,67,17,38,44.7,6,27,22.2,23,65,35.4,15,18,83.3,11,19,30,11,20,0,8,4,2,0,61,Tarnovia Tarnowo Podgórne,Sezon 2007/2008
2007-09-29 17:00,Asseco Prokom 2 Gdynia(d),83 : 86P,83,13,33,39.4,12,25,48.0,25,58,43.1,21,29,72.4,9,16,25,8,25,20,11,3,0,2,67,Tarnovia Tarnowo Podgórne,Sezon 2007/2008
2007-10-06 16:00,Wiecko Zastal Zielona Góra(w),87 : 50P,50,13,45,28.9,6,27,22.2,19,72,26.4,6,16,37.5,13,18,31,5,21,17,10,5,5,7,23,Tarnovia Tarnowo Podgórne,Sezon 2007/2008
2007-10-10 18:00,MKKS Rybnik(d),80 : 83P,80,13,35,37.1,11,27,40.7,24,62,38.7,21,25,84.0,12,31,43,9,31,19,17,9,1,0,83,Tarnovia Tarnowo Podgórne,Sezon 2007/2008
2007-10-13 18:00,Sportino Inowrocław(w),85 : 61P,61,18,32,56.3,7,19,36.8,25,51,49.0,4,7,57.1,7,11,18,4,20,5,14,6,2,0,48,Tarnovia Tarnowo Podgórne,Sezon 2007/2008
2007-10-19 16:30,MKS Start AZS Lublin(w),69 : 88W,88,19,37,51.4,9,24,37.5,28,61,45.9,23,35,65.7,9,23,32,10,24,30,10,9,3,3,87,Tarnovia Tarnowo Podgórne,Sezon 2007/2008
2007-10-28 16:00,Stal Stalowa Wola(d),76 : 87P,76,23,46,50.0,8,28,28.6,31,74,41.9,6,11,54.5,10,19,29,11,22,15,6,7,6,2,75,Tarnovia Tarnowo Podgórne,Sezon 2007/2008
2007-11-03 15:00,Polonia 2011 Warszawa(w),111 : 74P,74,21,44,47.7,6,17,35.3,27,61,44.3,14,22,63.6,13,18,31,9,22,21,24,9,1,4,58,Tarnovia Tarnowo Podgórne,Sezon 2007/2008
2007-11-11 16:00,Siarka Tarnobrzeg(d),81 : 82P,81,23,37,62.2,8,20,40.0,31,57,54.4,11,19,57.9,5,25,30,11,25,0,15,6,4,0,83,Tarnovia Tarnowo Podgórne,Sezon 2007/2008
2007-11-17 18:00,Znicz Jarosław(w),100 : 64P,64,19,49,38.8,8,25,32.0,27,74,36.5,2,3,66.7,11,16,27,8,19,10,11,6,2,2,48,Tarnovia Tarnowo Podgórne,Sezon 2007/2008
2007-11-25 16:00,GKS Tychy(d),75 : 77P,75,20,47,42.6,8,26,30.8,28,73,38.4,11,14,78.6,15,21,36,11,21,13,12,9,4,4,75,Tarnovia Tarnowo Podgórne,Sezon 2007/2008
2007-12-01 15:00,Żubry Białystok(w),73 : 60P,60,15,34,44.1,7,25,28.0,22,59,37.3,9,17,52.9,7,31,38,7,28,19,18,5,3,5,50,Tarnovia Tarnowo Podgórne,Sezon 2007/2008
2007-12-09 16:00,PBG Basket Poznań(d),67 : 84P,67,14,36,38.9,9,28,32.1,23,64,35.9,12,21,57.1,6,18,24,12,25,0,10,10,3,0,56,Tarnovia Tarnowo Podgórne,Sezon 2007/2008
2007-12-15 17:30,PTG Sokół Łańcut(w),74 : 59P,59,24,43,55.8,1,12,8.3,25,55,45.5,8,13,61.5,7,22,29,12,18,14,17,5,3,5,56,Tarnovia Tarnowo Podgórne,Sezon 2007/2008
2007-12-19 18:00,Znicz Basket Pruszków(d),77 : 99P,77,20,47,42.6,7,19,36.8,27,66,40.9,16,24,66.7,12,22,34,11,28,18,18,9,2,4,68,Tarnovia Tarnowo Podgórne,Sezon 2007/2008
2008-01-05 18:30,Asseco Prokom 2 Gdynia(w),77 : 95W,95,26,44,59.1,10,18,55.6,36,62,58.1,13,14,92.9,10,17,27,10,17,17,16,6,1,3,96,Tarnovia Tarnowo Podgórne,Sezon 2007/2008
2008-01-09 18:00,Resovia Rzeszów(d),69 : 78P,69,20,44,45.5,7,23,30.4,27,67,40.3,8,17,47.1,14,25,39,18,27,17,9,11,5,1,84,Tarnovia Tarnowo Podgórne,Sezon 2007/2008
2008-01-13 16:00,Wiecko Zastal Zielona Góra(d),61 : 69P,61,15,38,39.5,4,19,21.1,19,57,33.3,19,27,70.4,9,19,28,8,17,17,5,9,2,5,57,Tarnovia Tarnowo Podgórne,Sezon 2007/2008
2008-01-16 17:00,MKKS Rybnik(w),108 : 104P,104,29,42,69.0,10,19,52.6,39,61,63.9,16,22,72.7,7,20,27,12,24,21,18,6,0,0,103,Tarnovia Tarnowo Podgórne,Sezon 2007/2008
2008-01-20 16:00,Sportino Inowrocław(d),56 : 68P,56,16,46,34.8,5,12,41.7,21,58,36.2,9,18,50.0,9,22,31,9,22,14,14,10,1,2,47,Tarnovia Tarnowo Podgórne,Sezon 2007/2008
2008-01-30 18:00,MKS Start AZS Lublin(d),73 : 75P,73,27,51,52.9,4,24,16.7,31,75,41.3,7,15,46.7,16,22,38,13,24,7,16,13,3,2,72,Tarnovia Tarnowo Podgórne,Sezon 2007/2008
2008-02-02 17:00,Stal Stalowa Wola(w),83 : 77P,77,15,33,45.5,9,17,52.9,24,50,48.0,20,22,90.9,5,32,37,9,22,22,21,3,4,3,81,Tarnovia Tarnowo Podgórne,Sezon 2007/2008
2008-02-10 16:00,Polonia 2011 Warszawa(d),82 : 85P,82,20,40,50.0,9,20,45.0,29,60,48.3,15,19,78.9,9,22,31,16,25,14,19,9,4,3,88,Tarnovia Tarnowo Podgórne,Sezon 2007/2008
2008-02-16 17:00,Siarka Tarnobrzeg(w),87 : 70P,70,17,39,43.6,10,23,43.5,27,62,43.5,6,13,46.2,8,18,26,10,16,20,15,8,2,5,59,Tarnovia Tarnowo Podgórne,Sezon 2007/2008
2008-02-24 16:00,Znicz Jarosław(d),61 : 74P,61,17,46,37.0,7,23,30.4,24,69,34.8,6,8,75.0,11,17,28,12,9,5,10,12,1,2,57,Tarnovia Tarnowo Podgórne,Sezon 2007/2008
2008-03-01 18:00,GKS Tychy(w),97 : 66P,66,16,33,48.5,8,20,40.0,24,53,45.3,10,15,66.7,10,14,24,15,16,15,12,4,1,3,64,Tarnovia Tarnowo Podgórne,Sezon 2007/2008
2008-03-09 16:00,Żubry Białystok(d),70 : 85P,70,14,34,41.2,9,20,45.0,23,54,42.6,15,19,78.9,3,14,17,7,13,12,13,12,2,3,60,Tarnovia Tarnowo Podgórne,Sezon 2007/2008
2008-03-16 18:00,PBG Basket Poznań(w),77 : 63P,63,20,44,45.5,6,22,27.3,26,66,39.4,5,9,55.6,8,22,30,12,16,14,13,9,1,3,58,Tarnovia Tarnowo Podgórne,Sezon 2007/2008
2008-03-30 16:00,PTG Sokół Łańcut(d),41 : 71P,41,10,35,28.6,5,25,20.0,15,60,25.0,6,13,46.2,19,16,35,5,21,7,14,5,2,0,22,Tarnovia Tarnowo Podgórne,Sezon 2007/2008
2008-04-02 18:00,Znicz Basket Pruszków(w),76 : 61P,61,16,40,40.0,3,25,12.0,19,65,29.2,20,29,69.0,15,23,38,6,18,24,12,10,1,3,49,Tarnovia Tarnowo Podgórne,Sezon 2007/2008
2008-04-05 18:00,Znicz Basket Pruszków(w),84 : 63P,63,19,40,47.5,5,18,27.8,24,58,41.4,10,14,71.4,8,13,21,7,18,18,23,12,2,6,44,Tarnovia Tarnowo Podgórne,Sezon 2007/2008
2008-04-06 18:00,Znicz Basket Pruszków(w),69 : 80W,80,21,43,48.8,6,16,37.5,27,59,45.8,20,27,74.1,9,19,28,13,19,24,11,4,3,6,78,Tarnovia Tarnowo Podgórne,Sezon 2007/2008
2008-04-12 16:00,Znicz Basket Pruszków(d),80 : 93P,80,20,41,48.8,9,23,39.1,29,64,45.3,13,21,61.9,9,9,18,12,18,10,16,16,0,2,67,Tarnovia Tarnowo Podgórne,Sezon 2007/2008
2008-04-13 16:00,Znicz Basket Pruszków(d),86 : 72W,86,12,34,35.3,13,29,44.8,25,63,39.7,23,34,67.6,10,17,27,12,21,10,4,14,1,2,87,Tarnovia Tarnowo Podgórne,Sezon 2007/2008
2008-04-16 18:00,Znicz Basket Pruszków(w),87 : 75P,75,23,43,53.5,6,23,26.1,29,66,43.9,11,18,61.1,9,20,29,8,40,24,14,8,2,1,64,Tarnovia Tarnowo Podgórne,Sezon 2007/2008
2007-09-22 18:00,GKS Tychy(w),100 : 74P,74,17,29,58.6,7,20,35.0,24,49,49.0,19,21,90.5,5,13,18,13,24,0,21,9,0,0,66,MKS Start AZS Lublin,Sezon 2007/2008
2007-09-29 18:00,MKKS Rybnik(d),45 : 63P,45,17,35,48.6,1,19,5.3,18,54,33.3,8,13,61.5,8,23,31,8,25,15,19,7,2,0,33,MKS Start AZS Lublin,Sezon 2007/2008
2007-10-06 17:00,Żubry Białystok(w),83 : 68P,68,20,42,47.6,4,17,23.5,24,59,40.7,16,24,66.7,16,18,34,7,30,25,17,10,2,0,61,MKS Start AZS Lublin,Sezon 2007/2008
2007-10-10 17:00,Sportino Inowrocław(d),46 : 83P,46,17,41,41.5,3,21,14.3,20,62,32.3,3,4,75.0,14,20,34,8,14,10,21,9,3,2,36,MKS Start AZS Lublin,Sezon 2007/2008
2007-10-14 18:00,PBG Basket Poznań(w),97 : 71P,71,18,35,51.4,9,22,40.9,27,57,47.4,8,13,61.5,9,16,25,12,27,17,24,6,2,0,57,MKS Start AZS Lublin,Sezon 2007/2008
2007-10-19 16:30,Tarnovia Tarnowo Podgórne(d),69 : 88P,69,24,44,54.5,1,11,9.1,25,55,45.5,18,27,66.7,10,24,34,8,30,24,15,7,3,3,67,MKS Start AZS Lublin,Sezon 2007/2008
2007-10-27 17:30,PTG Sokół Łańcut(w),105 : 65P,65,17,40,42.5,6,18,33.3,23,58,39.7,13,18,72.2,7,21,28,13,22,17,20,6,1,2,53,MKS Start AZS Lublin,Sezon 2007/2008
2007-11-03 17:00,Stal Stalowa Wola(d),57 : 61P,57,19,49,38.8,4,15,26.7,23,64,35.9,7,11,63.6,10,28,38,11,21,19,15,10,4,4,60,MKS Start AZS Lublin,Sezon 2007/2008
2007-11-10 18:00,Znicz Basket Pruszków(w),94 : 67P,67,15,40,37.5,8,18,44.4,23,58,39.7,13,18,72.2,11,27,38,11,32,16,25,9,4,4,64,MKS Start AZS Lublin,Sezon 2007/2008
2007-11-17 18:00,Polonia 2011 Warszawa(d),78 : 93P,78,20,41,48.8,7,22,31.8,27,63,42.9,17,25,68.0,9,19,28,15,29,24,20,12,3,3,72,MKS Start AZS Lublin,Sezon 2007/2008
2007-11-24 17:00,Resovia Rzeszów(w),82 : 54P,54,19,36,52.8,3,15,20.0,22,51,43.1,7,16,43.8,6,19,25,15,27,20,20,12,5,0,53,MKS Start AZS Lublin,Sezon 2007/2008
2007-12-01 18:00,Siarka Tarnobrzeg(d),69 : 85P,69,21,42,50.0,3,23,13.0,24,65,36.9,18,30,60.0,14,22,36,13,29,31,14,8,0,2,59,MKS Start AZS Lublin,Sezon 2007/2008
2007-12-08 17:00,Asseco Prokom 2 Gdynia(w),78 : 52P,52,19,55,34.5,1,12,8.3,20,67,29.9,11,25,44.0,13,28,41,3,24,26,23,10,5,8,27,MKS Start AZS Lublin,Sezon 2007/2008
2007-12-16 17:00,Znicz Jarosław(d),86 : 101P,86,17,40,42.5,9,25,36.0,26,65,40.0,25,31,80.6,9,14,23,17,22,21,8,7,2,4,82,MKS Start AZS Lublin,Sezon 2007/2008
2007-12-19 18:00,Wiecko Zastal Zielona Góra(w),93 : 64P,64,17,34,50.0,5,16,31.3,22,50,44.0,15,21,71.4,6,19,25,12,17,22,20,11,0,5,58,MKS Start AZS Lublin,Sezon 2007/2008
2008-01-05 16:30,MKKS Rybnik(w),93 : 72P,72,22,48,45.8,3,14,21.4,25,62,40.3,19,29,65.5,13,32,45,11,21,20,27,6,4,2,64,MKS Start AZS Lublin,Sezon 2007/2008
2008-01-09 18:00,GKS Tychy(d),50 : 72P,50,17,48,35.4,2,7,28.6,19,55,34.5,10,17,58.8,5,20,25,10,21,19,16,14,2,7,42,MKS Start AZS Lublin,Sezon 2007/2008
2008-01-12 16:00,Żubry Białystok(d),56 : 71P,56,15,37,40.5,4,24,16.7,19,61,31.1,14,19,73.7,13,18,31,8,23,19,19,14,3,4,46,MKS Start AZS Lublin,Sezon 2007/2008
2008-01-16 18:00,Sportino Inowrocław(w),71 : 54P,54,14,32,43.8,4,23,17.4,18,55,32.7,14,16,87.5,9,31,40,14,21,16,17,7,0,0,59,MKS Start AZS Lublin,Sezon 2007/2008
2008-01-19 17:00,PBG Basket Poznań(d),69 : 82P,69,17,41,41.5,6,20,30.0,23,61,37.7,17,27,63.0,14,21,35,7,24,22,15,10,0,5,58,MKS Start AZS Lublin,Sezon 2007/2008
2008-01-30 18:00,Tarnovia Tarnowo Podgórne(w),73 : 75W,75,21,36,58.3,5,21,23.8,26,57,45.6,18,30,60.0,11,26,37,12,17,14,20,10,2,3,73,MKS Start AZS Lublin,Sezon 2007/2008
2008-02-03 17:00,PTG Sokół Łańcut(d),69 : 87P,69,18,36,50.0,5,17,29.4,23,53,43.4,18,23,78.3,5,14,19,10,25,22,19,8,2,3,54,MKS Start AZS Lublin,Sezon 2007/2008
2008-02-09 17:00,Stal Stalowa Wola(w),76 : 71P,71,19,39,48.7,6,19,31.6,25,58,43.1,15,20,75.0,4,26,30,12,25,17,14,7,4,3,72,MKS Start AZS Lublin,Sezon 2007/2008
2008-02-16 17:00,Znicz Basket Pruszków(d),82 : 86P,82,24,47,51.1,6,9,66.7,30,56,53.6,16,23,69.6,7,27,34,9,29,17,21,6,3,2,80,MKS Start AZS Lublin,Sezon 2007/2008
2008-02-23 15:00,Polonia 2011 Warszawa(w),94 : 61P,61,19,47,40.4,3,13,23.1,22,60,36.7,14,20,70.0,12,22,34,10,18,20,27,17,2,8,53,MKS Start AZS Lublin,Sezon 2007/2008
2008-03-01 17:00,Resovia Rzeszów(d),61 : 52W,61,15,35,42.9,6,12,50.0,21,47,44.7,13,25,52.0,8,29,37,13,31,20,20,10,5,2,68,MKS Start AZS Lublin,Sezon 2007/2008
2008-03-08 16:30,Siarka Tarnobrzeg(w),92 : 59P,59,17,33,51.5,4,22,18.2,21,55,38.2,13,16,81.3,15,27,42,7,15,14,25,3,1,3,50,MKS Start AZS Lublin,Sezon 2007/2008
2008-03-15 17:00,Asseco Prokom 2 Gdynia(d),80 : 91P,80,30,58,51.7,4,18,22.2,34,76,44.7,8,17,47.1,15,27,42,9,31,16,26,10,1,0,65,MKS Start AZS Lublin,Sezon 2007/2008
2008-03-29 18:00,Znicz Jarosław(w),93 : 86P,86,20,48,41.7,13,28,46.4,33,76,43.4,7,14,50.0,16,14,30,14,22,15,15,11,1,9,77,MKS Start AZS Lublin,Sezon 2007/2008
2008-04-02 17:00,Wiecko Zastal Zielona Góra(d),69 : 75P,69,16,35,45.7,9,24,37.5,25,59,42.4,10,16,62.5,5,26,31,12,24,20,14,9,0,3,67,MKS Start AZS Lublin,Sezon 2007/2008
2008-04-05 00:00,Siarka Tarnobrzeg(w),93 : 86P,86,18,31,58.1,13,35,37.1,31,66,47.0,11,15,73.3,15,19,34,18,26,16,18,7,1,0,89,MKS Start AZS Lublin,Sezon 2007/2008
2008-04-06 18:00,Siarka Tarnobrzeg(w),100 : 76P,76,17,37,45.9,10,29,34.5,27,66,40.9,12,24,50.0,15,19,34,16,23,18,18,9,0,9,66,MKS Start AZS Lublin,Sezon 2007/2008
2008-04-12 17:00,Siarka Tarnobrzeg(d),87 : 58W,87,30,47,63.8,4,15,26.7,34,62,54.8,15,23,65.2,12,26,38,20,25,19,19,9,1,4,100,MKS Start AZS Lublin,Sezon 2007/2008
2008-04-13 17:00,Siarka Tarnobrzeg(d),77 : 71W,77,18,33,54.5,9,25,36.0,27,58,46.6,14,26,53.8,15,31,46,18,30,21,23,5,4,6,84,MKS Start AZS Lublin,Sezon 2007/2008
2008-04-16 18:00,Siarka Tarnobrzeg(w),94 : 73P,73,18,35,51.4,6,24,25.0,24,59,40.7,19,28,67.9,7,19,26,8,22,27,21,11,2,1,55,MKS Start AZS Lublin,Sezon 2007/2008
2007-09-22 18:00,MKS Start AZS Lublin(d),100 : 74W,100,25,40,62.5,10,27,37.0,35,67,52.2,20,26,76.9,17,17,34,17,19,0,15,11,0,0,109,GKS Tychy,Sezon 2007/2008
2007-09-29 18:00,Żubry Białystok(d),82 : 71W,82,23,44,52.3,7,18,38.9,30,62,48.4,15,19,78.9,13,29,42,14,22,23,13,5,4,1,98,GKS Tychy,Sezon 2007/2008
2007-10-06 15:00,PBG Basket Poznań(w),83 : 59P,59,16,40,40.0,3,24,12.5,19,64,29.7,18,22,81.8,13,13,26,7,14,22,10,6,0,0,39,GKS Tychy,Sezon 2007/2008
2007-10-10 18:00,PTG Sokół Łańcut(d),65 : 82P,65,18,40,45.0,6,22,27.3,24,62,38.7,11,16,68.8,10,19,29,14,12,15,10,6,8,0,69,GKS Tychy,Sezon 2007/2008
2007-10-13 18:00,Znicz Basket Pruszków(d),69 : 63W,69,16,28,57.1,7,22,31.8,23,50,46.0,16,21,76.2,10,32,42,15,19,25,23,8,3,1,82,GKS Tychy,Sezon 2007/2008
2007-10-20 18:00,Resovia Rzeszów(d),79 : 78W,79,17,32,53.1,10,23,43.5,27,55,49.1,15,21,71.4,5,24,29,13,15,20,19,11,5,2,84,GKS Tychy,Sezon 2007/2008
2007-10-27 15:00,Asseco Prokom 2 Gdynia(w),52 : 71W,71,25,51,49.0,3,13,23.1,28,64,43.8,12,20,60.0,10,28,38,8,19,22,14,8,2,5,69,GKS Tychy,Sezon 2007/2008
2007-11-03 18:00,Wiecko Zastal Zielona Góra(d),69 : 71P,69,16,35,45.7,7,19,36.8,23,54,42.6,16,19,84.2,9,28,37,13,17,17,16,6,12,3,87,GKS Tychy,Sezon 2007/2008
2007-11-10 17:00,MKKS Rybnik(w),61 : 73W,73,23,42,54.8,3,15,20.0,26,57,45.6,18,23,78.3,7,26,33,10,8,19,8,1,1,0,74,GKS Tychy,Sezon 2007/2008
2007-11-17 18:00,Sportino Inowrocław(d),71 : 61W,71,22,44,50.0,4,10,40.0,26,54,48.1,15,17,88.2,12,24,36,13,19,18,12,8,6,5,92,GKS Tychy,Sezon 2007/2008
2007-11-25 16:00,Tarnovia Tarnowo Podgórne(w),75 : 77W,77,21,44,47.7,8,20,40.0,29,64,45.3,11,17,64.7,12,25,37,10,18,16,16,10,4,5,81,GKS Tychy,Sezon 2007/2008
2007-12-01 18:00,Stal Stalowa Wola(d),87 : 76W,87,30,52,57.7,4,13,30.8,34,65,52.3,15,18,83.3,12,27,39,18,19,20,16,9,4,2,107,GKS Tychy,Sezon 2007/2008
2007-12-08 15:00,Polonia 2011 Warszawa(w),81 : 70P,70,16,32,50.0,8,19,42.1,24,51,47.1,14,21,66.7,2,22,24,10,18,0,17,10,2,0,65,GKS Tychy,Sezon 2007/2008
2007-12-15 18:00,Siarka Tarnobrzeg(d),91 : 66W,91,30,53,56.6,7,16,43.8,37,69,53.6,10,15,66.7,13,29,42,16,16,15,15,11,1,3,109,GKS Tychy,Sezon 2007/2008
2007-12-19 18:00,Znicz Jarosław(w),66 : 60P,60,14,31,45.2,7,21,33.3,21,52,40.4,11,14,78.6,7,16,23,7,22,10,15,4,5,0,50,GKS Tychy,Sezon 2007/2008
2008-01-05 15:00,Żubry Białystok(w),79 : 65P,65,21,37,56.8,5,24,20.8,26,61,42.6,8,9,88.9,11,27,38,6,17,15,19,5,4,5,63,GKS Tychy,Sezon 2007/2008
2008-01-09 18:00,MKS Start AZS Lublin(w),50 : 72W,72,18,36,50.0,9,25,36.0,27,61,44.3,9,19,47.4,13,28,41,14,19,21,18,12,7,2,84,GKS Tychy,Sezon 2007/2008
2008-01-12 17:00,PBG Basket Poznań(d),87 : 82W,87,20,39,51.3,8,24,33.3,28,63,44.4,23,32,71.9,8,13,21,16,24,28,9,14,5,1,90,GKS Tychy,Sezon 2007/2008
2008-01-16 18:00,PTG Sokół Łańcut(w),83 : 73P,73,21,32,65.6,7,22,31.8,28,54,51.9,10,13,76.9,6,13,19,17,17,14,13,9,3,1,79,GKS Tychy,Sezon 2007/2008
2008-01-19 18:00,Znicz Basket Pruszków(w),75 : 64P,64,17,39,43.6,6,22,27.3,23,61,37.7,12,18,66.7,13,21,34,11,16,21,23,13,1,1,56,GKS Tychy,Sezon 2007/2008
2008-01-26 19:05,Resovia Rzeszów(w),84 : 64P,64,21,45,46.7,3,13,23.1,24,58,41.4,13,18,72.2,9,22,31,12,16,8,6,4,1,0,67,GKS Tychy,Sezon 2007/2008
2008-02-02 18:00,Asseco Prokom 2 Gdynia(d),92 : 68W,92,29,42,69.0,9,23,39.1,38,65,58.5,7,11,63.6,6,19,25,15,19,10,10,7,5,0,103,GKS Tychy,Sezon 2007/2008
2008-02-10 17:00,Wiecko Zastal Zielona Góra(w),64 : 84W,84,20,38,52.6,7,18,38.9,27,56,48.2,23,27,85.2,11,23,34,12,22,26,9,7,1,4,96,GKS Tychy,Sezon 2007/2008
2008-02-16 18:00,MKKS Rybnik(d),82 : 72W,82,24,36,66.7,5,21,23.8,29,57,50.9,19,23,82.6,10,28,38,15,19,21,16,10,5,0,102,GKS Tychy,Sezon 2007/2008
2008-02-23 18:00,Sportino Inowrocław(w),67 : 59P,59,13,37,35.1,8,17,47.1,21,54,38.9,9,13,69.2,5,21,26,13,19,14,9,8,1,0,61,GKS Tychy,Sezon 2007/2008
2008-03-01 18:00,Tarnovia Tarnowo Podgórne(d),97 : 66W,97,29,46,63.0,9,22,40.9,38,68,55.9,12,15,80.0,14,18,32,11,15,16,6,12,3,1,116,GKS Tychy,Sezon 2007/2008
2008-03-08 17:00,Stal Stalowa Wola(w),78 : 85W,85,21,40,52.5,10,17,58.8,31,57,54.4,13,22,59.1,9,25,34,11,31,22,15,5,3,1,88,GKS Tychy,Sezon 2007/2008
2008-03-15 18:00,Polonia 2011 Warszawa(d),77 : 66W,77,28,44,63.6,3,23,13.0,31,67,46.3,12,17,70.6,14,23,37,17,18,22,11,16,4,0,99,GKS Tychy,Sezon 2007/2008
2008-03-29 17:00,Siarka Tarnobrzeg(w),85 : 77P,77,19,29,65.5,12,34,35.3,31,63,49.2,3,4,75.0,10,12,22,12,23,13,10,7,3,0,78,GKS Tychy,Sezon 2007/2008
2008-04-02 18:00,Znicz Jarosław(d),79 : 82P,79,21,36,58.3,9,26,34.6,30,62,48.4,10,13,76.9,11,18,29,15,12,17,11,6,1,2,84,GKS Tychy,Sezon 2007/2008
2008-04-05 18:00,Sportino Inowrocław(w),69 : 59P,59,19,41,46.3,3,14,21.4,22,55,40.0,12,22,54.5,9,11,20,2,15,24,8,14,4,1,48,GKS Tychy,Sezon 2007/2008
2008-04-06 18:00,Sportino Inowrocław(w),74 : 56P,56,17,37,45.9,4,16,25.0,21,53,39.6,10,26,38.5,5,21,26,9,21,24,12,9,6,2,46,GKS Tychy,Sezon 2007/2008
2008-04-12 18:00,Sportino Inowrocław(d),78 : 65W,78,19,32,59.4,6,13,46.2,25,45,55.6,22,27,81.5,7,26,33,17,14,25,18,8,2,2,95,GKS Tychy,Sezon 2007/2008
2008-04-13 17:30,Sportino Inowrocław(d),54 : 61P,54,18,31,58.1,4,12,33.3,22,43,51.2,6,9,66.7,1,23,24,11,14,12,17,8,5,3,61,GKS Tychy,Sezon 2007/2008
2007-09-22 17:00,Sportino Inowrocław(d),48 : 75P,48,9,30,30.0,8,24,33.3,17,54,31.5,6,9,66.7,11,14,25,8,30,0,16,8,2,0,35,Asseco Prokom 2 Gdynia,Sezon 2007/2008
2007-09-29 17:00,Tarnovia Tarnowo Podgórne(w),83 : 86W,86,23,44,52.3,6,13,46.2,29,57,50.9,22,30,73.3,7,16,23,6,30,16,14,10,4,0,79,Asseco Prokom 2 Gdynia,Sezon 2007/2008
2007-10-07 15:00,Stal Stalowa Wola(d),77 : 69W,77,29,44,65.9,4,21,19.0,33,65,50.8,7,10,70.0,8,25,33,8,22,21,21,14,5,6,81,Asseco Prokom 2 Gdynia,Sezon 2007/2008
2007-10-10 17:00,Polonia 2011 Warszawa(w),88 : 45P,45,14,35,40.0,3,27,11.1,17,62,27.4,8,16,50.0,9,21,30,9,21,9,17,11,4,2,29,Asseco Prokom 2 Gdynia,Sezon 2007/2008
2007-10-13 15:00,Siarka Tarnobrzeg(d),79 : 64W,79,20,35,57.1,8,16,50.0,28,51,54.9,15,24,62.5,6,32,38,13,23,24,24,7,7,4,88,Asseco Prokom 2 Gdynia,Sezon 2007/2008
2007-10-21 17:00,Znicz Jarosław(w),85 : 77P,77,26,47,55.3,6,21,28.6,32,68,47.1,7,12,58.3,6,18,24,11,22,11,13,12,1,0,71,Asseco Prokom 2 Gdynia,Sezon 2007/2008
2007-10-27 15:00,GKS Tychy(d),52 : 71P,52,13,36,36.1,7,26,26.9,20,62,32.3,5,11,45.5,10,24,34,10,22,19,16,9,5,2,46,Asseco Prokom 2 Gdynia,Sezon 2007/2008
2007-11-03 17:00,Żubry Białystok(w),82 : 66P,66,14,33,42.4,10,26,38.5,24,59,40.7,8,14,57.1,7,23,30,9,12,14,16,4,5,4,57,Asseco Prokom 2 Gdynia,Sezon 2007/2008
2007-11-11 15:00,PBG Basket Poznań(d),51 : 88P,51,13,31,41.9,5,31,16.1,18,62,29.0,10,15,66.7,11,19,30,5,30,21,25,7,4,3,23,Asseco Prokom 2 Gdynia,Sezon 2007/2008
2007-11-17 17:30,PTG Sokół Łańcut(w),84 : 66P,66,18,37,48.6,8,21,38.1,26,58,44.8,6,9,66.7,14,18,32,9,15,12,25,12,6,2,65,Asseco Prokom 2 Gdynia,Sezon 2007/2008
2007-11-25 15:00,Znicz Basket Pruszków(d),83 : 85P,83,19,45,42.2,7,16,43.8,26,61,42.6,24,35,68.6,11,20,31,11,27,21,20,10,6,5,75,Asseco Prokom 2 Gdynia,Sezon 2007/2008
2007-12-01 18:00,Resovia Rzeszów(w),94 : 57P,57,15,30,50.0,6,23,26.1,21,53,39.6,9,15,60.0,8,23,31,13,23,15,27,7,1,0,44,Asseco Prokom 2 Gdynia,Sezon 2007/2008
2007-12-08 17:00,MKS Start AZS Lublin(d),78 : 52W,78,25,48,52.1,6,18,33.3,31,66,47.0,10,20,50.0,12,34,46,11,27,24,22,17,8,5,93,Asseco Prokom 2 Gdynia,Sezon 2007/2008
2007-12-15 17:00,Wiecko Zastal Zielona Góra(d),79 : 90P,79,20,46,43.5,11,26,42.3,31,72,43.1,6,7,85.7,12,20,32,17,23,15,14,7,2,6,81,Asseco Prokom 2 Gdynia,Sezon 2007/2008
2007-12-19 17:00,MKKS Rybnik(w),82 : 74P,74,23,37,62.2,6,28,21.4,29,65,44.6,10,16,62.5,10,22,32,10,26,13,19,16,2,1,73,Asseco Prokom 2 Gdynia,Sezon 2007/2008
2008-01-05 18:30,Tarnovia Tarnowo Podgórne(d),77 : 95P,77,25,38,65.8,5,20,25.0,30,58,51.7,12,18,66.7,10,13,23,7,17,17,15,13,4,1,75,Asseco Prokom 2 Gdynia,Sezon 2007/2008
2008-01-09 18:00,Sportino Inowrocław(w),75 : 48P,48,12,29,41.4,2,17,11.8,14,46,30.4,18,24,75.0,6,23,29,7,17,19,22,7,2,4,33,Asseco Prokom 2 Gdynia,Sezon 2007/2008
2008-01-12 17:00,Stal Stalowa Wola(w),91 : 83P,83,27,46,58.7,8,20,40.0,35,66,53.0,5,9,55.6,7,24,31,12,17,9,10,6,2,3,89,Asseco Prokom 2 Gdynia,Sezon 2007/2008
2008-01-16 17:00,Polonia 2011 Warszawa(d),78 : 72W,78,18,27,66.7,10,21,47.6,28,48,58.3,12,18,66.7,5,29,34,17,23,20,28,9,8,2,92,Asseco Prokom 2 Gdynia,Sezon 2007/2008
2008-01-19 17:00,Siarka Tarnobrzeg(w),86 : 79P,79,16,37,43.2,10,25,40.0,26,62,41.9,17,21,81.0,9,20,29,8,27,21,14,7,3,4,72,Asseco Prokom 2 Gdynia,Sezon 2007/2008
2008-01-23 18:00,Znicz Basket Pruszków(w),77 : 67P,67,16,32,50.0,8,33,24.2,24,65,36.9,11,19,57.9,8,28,36,12,26,18,17,10,5,1,64,Asseco Prokom 2 Gdynia,Sezon 2007/2008
2008-01-26 19:15,Znicz Jarosław(d),83 : 92P,83,18,34,52.9,14,34,41.2,32,68,47.1,5,9,55.6,8,18,26,15,25,16,12,7,6,1,85,Asseco Prokom 2 Gdynia,Sezon 2007/2008
2008-02-02 18:00,GKS Tychy(w),92 : 68P,68,19,36,52.8,5,17,29.4,24,53,45.3,15,18,83.3,7,22,29,7,11,18,10,6,0,4,68,Asseco Prokom 2 Gdynia,Sezon 2007/2008
2008-02-10 15:00,Żubry Białystok(d),75 : 85P,75,16,34,47.1,11,28,39.3,27,62,43.5,10,15,66.7,11,26,37,11,31,18,25,8,5,2,71,Asseco Prokom 2 Gdynia,Sezon 2007/2008
2008-02-16 18:00,PBG Basket Poznań(w),84 : 61P,61,17,37,45.9,7,35,20.0,24,72,33.3,6,12,50.0,15,23,38,14,22,14,16,10,2,2,55,Asseco Prokom 2 Gdynia,Sezon 2007/2008
2008-02-24 15:00,PTG Sokół Łańcut(d),79 : 80P,79,20,37,54.1,12,36,33.3,32,73,43.8,3,5,60.0,8,29,37,13,24,13,18,11,4,0,83,Asseco Prokom 2 Gdynia,Sezon 2007/2008
2008-03-08 15:00,Resovia Rzeszów(d),75 : 81P,75,19,29,65.5,8,34,23.5,27,63,42.9,13,19,68.4,13,27,40,14,26,19,22,14,6,3,85,Asseco Prokom 2 Gdynia,Sezon 2007/2008
2008-03-15 17:00,MKS Start AZS Lublin(w),80 : 91W,91,21,35,60.0,6,31,19.4,27,66,40.9,31,42,73.8,9,25,34,14,16,31,16,18,0,1,91,Asseco Prokom 2 Gdynia,Sezon 2007/2008
2008-03-30 17:00,Wiecko Zastal Zielona Góra(w),82 : 55P,55,17,34,50.0,5,27,18.5,22,61,36.1,6,15,40.0,5,13,18,6,26,20,11,13,2,2,35,Asseco Prokom 2 Gdynia,Sezon 2007/2008
2008-04-02 16:00,MKKS Rybnik(d),102 : 77W,102,24,42,57.1,13,27,48.1,37,69,53.6,15,30,50.0,16,30,46,23,21,27,19,13,9,2,127,Asseco Prokom 2 Gdynia,Sezon 2007/2008
2007-09-21 18:00,Stal Stalowa Wola(d),79 : 64W,79,20,37,54.1,9,26,34.6,29,63,46.0,12,18,66.7,9,26,35,12,19,0,7,5,1,0,85,Znicz Basket Pruszków,Sezon 2007/2008
2007-09-29 14:30,Polonia 2011 Warszawa(w),82 : 77P,77,17,37,45.9,8,22,36.4,25,59,42.4,19,34,55.9,9,18,27,15,28,13,13,11,1,1,69,Znicz Basket Pruszków,Sezon 2007/2008
2007-10-06 18:00,Siarka Tarnobrzeg(d),63 : 74P,63,16,30,53.3,7,27,25.9,23,57,40.4,10,12,83.3,7,27,34,15,27,17,13,9,3,2,75,Znicz Basket Pruszków,Sezon 2007/2008
2007-10-10 18:00,Znicz Jarosław(w),76 : 71P,71,18,37,48.6,6,23,26.1,24,60,40.0,17,21,81.0,7,17,24,7,24,18,9,12,3,0,68,Znicz Basket Pruszków,Sezon 2007/2008
2007-10-13 18:00,GKS Tychy(w),69 : 63P,63,20,42,47.6,4,22,18.2,24,64,37.5,11,15,73.3,5,17,22,7,21,19,12,14,1,3,51,Znicz Basket Pruszków,Sezon 2007/2008
2007-10-20 17:00,Żubry Białystok(w),79 : 73P,73,9,33,27.3,13,27,48.1,22,60,36.7,16,21,76.2,4,21,25,10,24,24,8,5,1,1,63,Znicz Basket Pruszków,Sezon 2007/2008
2007-10-27 18:00,PBG Basket Poznań(d),81 : 83P,81,12,29,41.4,12,37,32.4,24,66,36.4,21,24,87.5,7,16,23,14,25,23,14,10,3,4,72,Znicz Basket Pruszków,Sezon 2007/2008
2007-11-03 17:30,PTG Sokół Łańcut(w),71 : 63P,63,17,36,47.2,3,21,14.3,20,57,35.1,20,24,83.3,10,26,36,9,21,16,10,6,2,1,65,Znicz Basket Pruszków,Sezon 2007/2008
2007-11-10 18:00,MKS Start AZS Lublin(d),94 : 67W,94,21,45,46.7,8,22,36.4,29,67,43.3,28,33,84.8,12,24,36,19,17,31,13,19,4,4,116,Znicz Basket Pruszków,Sezon 2007/2008
2007-11-17 18:00,Resovia Rzeszów(w),96 : 75P,75,12,26,46.2,13,26,50.0,25,52,48.1,12,14,85.7,1,18,19,11,22,20,18,12,1,0,71,Znicz Basket Pruszków,Sezon 2007/2008
2007-11-25 15:00,Asseco Prokom 2 Gdynia(w),83 : 85W,85,17,37,45.9,10,26,38.5,27,63,42.9,21,28,75.0,16,22,38,11,23,26,18,16,5,6,94,Znicz Basket Pruszków,Sezon 2007/2008
2007-12-01 18:00,Wiecko Zastal Zielona Góra(d),73 : 86P,73,18,33,54.5,6,20,30.0,24,53,45.3,19,27,70.4,7,14,21,8,20,27,18,12,2,0,61,Znicz Basket Pruszków,Sezon 2007/2008
2007-12-08 16:30,MKKS Rybnik(w),94 : 102W,102,18,32,56.3,15,29,51.7,33,61,54.1,21,29,72.4,10,27,37,12,24,22,23,8,3,1,103,Znicz Basket Pruszków,Sezon 2007/2008
2007-12-15 18:00,Sportino Inowrocław(d),60 : 65P,60,11,26,42.3,8,21,38.1,19,47,40.4,14,33,42.4,4,29,33,10,24,26,13,4,1,0,48,Znicz Basket Pruszków,Sezon 2007/2008
2007-12-19 18:00,Tarnovia Tarnowo Podgórne(w),77 : 99W,99,24,41,58.5,9,22,40.9,33,63,52.4,24,30,80.0,6,26,32,15,22,21,15,15,4,2,114,Znicz Basket Pruszków,Sezon 2007/2008
2008-01-05 18:00,Polonia 2011 Warszawa(d),62 : 64P,62,16,40,40.0,5,18,27.8,21,58,36.2,15,26,57.7,3,29,32,10,17,23,20,16,3,3,55,Znicz Basket Pruszków,Sezon 2007/2008
2008-01-09 18:00,Stal Stalowa Wola(w),75 : 74P,74,17,40,42.5,9,21,42.9,26,61,42.6,13,14,92.9,8,21,29,9,23,19,17,8,2,4,69,Znicz Basket Pruszków,Sezon 2007/2008
2008-01-12 17:30,Siarka Tarnobrzeg(w),68 : 76W,76,23,38,60.5,7,29,24.1,30,67,44.8,9,12,75.0,10,22,32,10,22,19,13,6,1,4,72,Znicz Basket Pruszków,Sezon 2007/2008
2008-01-16 18:00,Znicz Jarosław(d),90 : 92P,90,13,24,54.2,20,38,52.6,33,62,53.2,4,5,80.0,7,15,22,25,22,17,15,6,1,2,99,Znicz Basket Pruszków,Sezon 2007/2008
2008-01-19 18:00,GKS Tychy(d),75 : 64W,75,24,36,66.7,6,23,26.1,30,59,50.8,9,14,64.3,6,22,28,16,21,16,20,9,1,1,75,Znicz Basket Pruszków,Sezon 2007/2008
2008-01-23 18:00,Asseco Prokom 2 Gdynia(d),77 : 67W,77,15,47,31.9,9,21,42.9,24,68,35.3,20,29,69.0,12,31,43,15,18,26,15,12,1,5,80,Znicz Basket Pruszków,Sezon 2007/2008
2008-01-26 19:15,Żubry Białystok(d),79 : 71W,79,21,34,61.8,9,26,34.6,30,60,50.0,10,12,83.3,9,33,42,14,29,14,16,3,2,0,92,Znicz Basket Pruszków,Sezon 2007/2008
2008-02-03 18:00,PBG Basket Poznań(w),78 : 69P,69,15,33,45.5,9,33,27.3,24,66,36.4,12,16,75.0,5,22,27,6,23,22,14,9,2,5,53,Znicz Basket Pruszków,Sezon 2007/2008
2008-02-09 18:00,PTG Sokół Łańcut(d),83 : 89P,83,20,33,60.6,9,21,42.9,29,54,53.7,16,20,80.0,8,18,26,12,26,21,16,7,2,0,85,Znicz Basket Pruszków,Sezon 2007/2008
2008-02-16 17:00,MKS Start AZS Lublin(w),82 : 86W,86,21,46,45.7,6,20,30.0,27,66,40.9,26,40,65.0,12,16,28,13,17,29,12,16,2,3,80,Znicz Basket Pruszków,Sezon 2007/2008
2008-02-23 18:00,Resovia Rzeszów(d),73 : 78P,73,15,34,44.1,11,26,42.3,26,60,43.3,10,14,71.4,8,20,28,16,23,18,22,10,1,4,68,Znicz Basket Pruszków,Sezon 2007/2008
2008-03-09 17:00,Wiecko Zastal Zielona Góra(w),90 : 55P,55,10,29,34.5,6,20,30.0,16,49,32.7,17,22,77.3,9,18,27,7,22,22,19,6,2,3,40,Znicz Basket Pruszków,Sezon 2007/2008
2008-03-15 18:00,MKKS Rybnik(d),79 : 87P,79,20,31,64.5,7,29,24.1,27,60,45.0,18,21,85.7,5,25,30,14,28,26,21,11,3,0,80,Znicz Basket Pruszków,Sezon 2007/2008
2008-03-29 18:00,Sportino Inowrocław(w),86 : 58P,58,15,30,50.0,5,19,26.3,20,49,40.8,13,14,92.9,5,18,23,7,25,19,19,9,2,1,50,Znicz Basket Pruszków,Sezon 2007/2008
2008-04-02 18:00,Tarnovia Tarnowo Podgórne(d),76 : 61W,76,23,45,51.1,7,14,50.0,30,59,50.8,9,16,56.3,5,26,31,15,24,18,20,6,3,1,75,Znicz Basket Pruszków,Sezon 2007/2008
2008-04-05 18:00,Tarnovia Tarnowo Podgórne(d),84 : 63W,84,28,44,63.6,8,18,44.4,36,62,58.1,4,7,57.1,9,25,34,14,18,16,20,10,6,2,99,Znicz Basket Pruszków,Sezon 2007/2008
2008-04-06 18:00,Tarnovia Tarnowo Podgórne(d),69 : 80P,69,20,36,55.6,6,26,23.1,26,62,41.9,11,12,91.7,15,18,33,19,24,19,15,4,6,3,79,Znicz Basket Pruszków,Sezon 2007/2008
2008-04-12 16:00,Tarnovia Tarnowo Podgórne(w),80 : 93W,93,29,37,78.4,6,13,46.2,35,50,70.0,17,21,81.0,4,20,24,27,19,9,22,11,2,0,116,Znicz Basket Pruszków,Sezon 2007/2008
2008-04-13 16:00,Tarnovia Tarnowo Podgórne(w),86 : 72P,72,27,39,69.2,1,9,11.1,28,48,58.3,15,23,65.2,5,30,35,10,22,8,17,4,2,1,78,Znicz Basket Pruszków,Sezon 2007/2008
2008-04-16 18:00,Tarnovia Tarnowo Podgórne(d),87 : 75W,87,20,48,41.7,4,12,33.3,24,60,40.0,35,53,66.0,17,28,45,13,24,40,13,9,1,2,88,Znicz Basket Pruszków,Sezon 2007/2008
2007-09-22 17:30,PTG Sokół Łańcut(w),81 : 73P,73,19,30,63.3,5,17,29.4,24,47,51.1,20,27,74.1,8,17,25,12,18,0,19,6,3,0,70,Polonia 2011 Warszawa,Sezon 2007/2008
2007-09-29 14:30,Znicz Basket Pruszków(d),82 : 77W,82,17,39,43.6,7,20,35.0,24,59,40.7,27,35,77.1,14,30,44,11,29,9,14,11,1,1,92,Polonia 2011 Warszawa,Sezon 2007/2008
2007-10-06 18:00,Resovia Rzeszów(w),64 : 58P,58,16,33,48.5,3,22,13.6,19,55,34.5,17,29,58.6,14,19,33,8,21,25,13,13,5,0,56,Polonia 2011 Warszawa,Sezon 2007/2008
2007-10-10 17:00,Asseco Prokom 2 Gdynia(d),88 : 45W,88,25,45,55.6,9,24,37.5,34,69,49.3,11,17,64.7,10,32,42,24,18,19,16,11,3,5,111,Polonia 2011 Warszawa,Sezon 2007/2008
2007-10-13 18:00,Wiecko Zastal Zielona Góra(w),76 : 47P,47,16,41,39.0,2,16,12.5,18,57,31.6,9,13,69.2,6,16,22,7,18,18,10,12,1,5,36,Polonia 2011 Warszawa,Sezon 2007/2008
2007-10-20 15:00,MKKS Rybnik(d),86 : 78W,86,22,39,56.4,5,14,35.7,27,53,50.9,27,37,73.0,5,26,31,22,20,24,22,12,6,0,99,Polonia 2011 Warszawa,Sezon 2007/2008
2007-10-27 18:00,Sportino Inowrocław(w),68 : 62P,62,19,38,50.0,5,17,29.4,24,55,43.6,9,13,69.2,8,22,30,13,20,15,21,13,3,2,65,Polonia 2011 Warszawa,Sezon 2007/2008
2007-11-03 15:00,Tarnovia Tarnowo Podgórne(d),111 : 74W,111,30,44,68.2,10,20,50.0,40,64,62.5,21,28,75.0,13,25,38,18,21,21,18,13,4,1,135,Polonia 2011 Warszawa,Sezon 2007/2008
2007-11-10 17:00,Stal Stalowa Wola(w),91 : 83P,83,19,39,48.7,7,20,35.0,26,59,44.1,24,31,77.4,11,18,29,11,24,23,13,9,4,0,83,Polonia 2011 Warszawa,Sezon 2007/2008
2007-11-17 18:00,MKS Start AZS Lublin(w),78 : 93W,93,25,51,49.0,7,19,36.8,32,70,45.7,22,31,71.0,13,23,36,17,25,28,15,12,3,3,99,Polonia 2011 Warszawa,Sezon 2007/2008
2007-11-24 15:00,Siarka Tarnobrzeg(d),86 : 70W,86,27,41,65.9,8,19,42.1,35,60,58.3,8,14,57.1,9,29,38,21,28,17,23,12,7,1,110,Polonia 2011 Warszawa,Sezon 2007/2008
2007-12-01 18:00,Znicz Jarosław(w),85 : 74P,74,20,38,52.6,6,25,24.0,26,63,41.3,16,22,72.7,8,17,25,8,24,19,20,9,4,3,57,Polonia 2011 Warszawa,Sezon 2007/2008
2007-12-08 15:00,GKS Tychy(d),81 : 70W,81,19,39,48.7,11,25,44.0,30,64,46.9,10,18,55.6,9,26,35,16,22,0,14,9,2,0,87,Polonia 2011 Warszawa,Sezon 2007/2008
2007-12-15 17:00,Żubry Białystok(w),63 : 53P,53,19,37,51.4,3,23,13.0,22,60,36.7,6,20,30.0,14,23,37,5,23,24,17,5,0,0,31,Polonia 2011 Warszawa,Sezon 2007/2008
2007-12-19 18:00,PBG Basket Poznań(d),86 : 78W,86,19,38,50.0,9,27,33.3,28,65,43.1,21,33,63.6,10,22,32,16,20,28,14,15,2,2,88,Polonia 2011 Warszawa,Sezon 2007/2008
2008-01-05 18:00,Znicz Basket Pruszków(w),62 : 64W,64,16,40,40.0,8,26,30.8,24,66,36.4,8,12,66.7,9,34,43,12,23,16,22,12,3,3,66,Polonia 2011 Warszawa,Sezon 2007/2008
2008-01-08 18:00,PTG Sokół Łańcut(d),69 : 80P,69,19,40,47.5,6,27,22.2,25,67,37.3,13,22,59.1,19,18,37,14,23,21,18,8,2,1,61,Polonia 2011 Warszawa,Sezon 2007/2008
2008-01-12 15:00,Resovia Rzeszów(d),77 : 73W,77,20,42,47.6,6,23,26.1,26,65,40.0,19,27,70.4,12,25,37,13,24,23,17,12,6,4,81,Polonia 2011 Warszawa,Sezon 2007/2008
2008-01-16 17:00,Asseco Prokom 2 Gdynia(w),78 : 72P,72,19,51,37.3,8,28,28.6,27,79,34.2,10,19,52.6,17,14,31,11,20,23,15,14,2,8,54,Polonia 2011 Warszawa,Sezon 2007/2008
2008-01-19 15:00,Wiecko Zastal Zielona Góra(d),75 : 78P,75,17,38,44.7,8,23,34.8,25,61,41.0,17,28,60.7,19,15,34,14,22,23,16,13,0,5,73,Polonia 2011 Warszawa,Sezon 2007/2008
2008-01-30 17:00,MKKS Rybnik(w),69 : 84W,84,20,37,54.1,8,24,33.3,28,61,45.9,20,37,54.1,18,26,44,11,25,25,17,6,2,0,80,Polonia 2011 Warszawa,Sezon 2007/2008
2008-02-02 15:00,Sportino Inowrocław(d),50 : 74P,50,12,40,30.0,3,25,12.0,15,65,23.1,17,24,70.8,15,15,30,12,30,20,13,11,1,2,34,Polonia 2011 Warszawa,Sezon 2007/2008
2008-02-10 16:00,Tarnovia Tarnowo Podgórne(w),82 : 85W,85,22,42,52.4,8,16,50.0,30,58,51.7,17,31,54.8,9,19,28,12,22,13,12,14,3,4,88,Polonia 2011 Warszawa,Sezon 2007/2008
2008-02-17 15:00,Stal Stalowa Wola(d),90 : 72W,90,22,45,48.9,11,26,42.3,33,71,46.5,13,18,72.2,16,22,38,18,23,20,19,16,2,3,102,Polonia 2011 Warszawa,Sezon 2007/2008
2008-02-23 15:00,MKS Start AZS Lublin(d),94 : 61W,94,27,59,45.8,8,21,38.1,35,80,43.8,16,24,66.7,23,28,51,21,20,18,21,16,8,2,116,Polonia 2011 Warszawa,Sezon 2007/2008
2008-03-01 17:00,Siarka Tarnobrzeg(w),87 : 79P,79,23,42,54.8,6,18,33.3,29,60,48.3,15,24,62.5,11,22,33,15,30,24,18,7,4,3,80,Polonia 2011 Warszawa,Sezon 2007/2008
2008-03-09 15:00,Znicz Jarosław(d),83 : 85P,83,18,45,40.0,11,30,36.7,29,75,38.7,14,19,73.7,18,19,37,16,21,15,15,8,3,3,81,Polonia 2011 Warszawa,Sezon 2007/2008
2008-03-15 18:00,GKS Tychy(w),77 : 66P,66,20,38,52.6,6,18,33.3,26,56,46.4,8,13,61.5,7,23,30,9,21,18,17,8,0,4,61,Polonia 2011 Warszawa,Sezon 2007/2008
2008-03-29 19:00,Żubry Białystok(d),80 : 83P,80,16,36,44.4,12,32,37.5,28,68,41.2,12,14,85.7,13,19,32,16,24,16,16,10,1,4,81,Polonia 2011 Warszawa,Sezon 2007/2008
2008-04-02 18:00,PBG Basket Poznań(w),88 : 76P,76,20,42,47.6,8,36,22.2,28,78,35.9,12,21,57.1,8,21,29,9,26,21,8,14,2,1,63,Polonia 2011 Warszawa,Sezon 2007/2008
2007-09-23 18:30,PBG Basket Poznań(w),78 : 70P,70,12,26,46.2,9,25,36.0,21,51,41.2,19,23,82.6,14,21,35,14,22,0,13,4,2,0,78,Siarka Tarnobrzeg,Sezon 2007/2008
2007-09-30 17:00,PTG Sokół Łańcut(d),67 : 79P,67,17,33,51.5,7,20,35.0,24,53,45.3,12,18,66.7,12,14,26,11,22,17,15,5,0,1,59,Siarka Tarnobrzeg,Sezon 2007/2008
2007-10-06 18:00,Znicz Basket Pruszków(w),63 : 74W,74,17,46,37.0,6,18,33.3,23,64,35.9,22,29,75.9,16,25,41,13,20,22,10,10,2,3,82,Siarka Tarnobrzeg,Sezon 2007/2008
2007-10-10 18:00,Resovia Rzeszów(d),65 : 101P,65,18,31,58.1,3,17,17.6,21,48,43.8,20,28,71.4,7,12,19,11,23,27,20,11,0,3,51,Siarka Tarnobrzeg,Sezon 2007/2008
2007-10-13 15:00,Asseco Prokom 2 Gdynia(w),79 : 64P,64,14,41,34.1,9,28,32.1,23,69,33.3,9,22,40.9,12,17,29,12,24,23,12,16,4,7,54,Siarka Tarnobrzeg,Sezon 2007/2008
2007-10-20 19:00,Wiecko Zastal Zielona Góra(d),65 : 73P,65,16,35,45.7,5,24,20.8,21,59,35.6,18,21,85.7,9,20,29,12,27,25,20,7,1,4,53,Siarka Tarnobrzeg,Sezon 2007/2008
2007-10-27 16:30,MKKS Rybnik(w),54 : 67W,67,15,32,46.9,7,16,43.8,22,48,45.8,16,36,44.4,7,26,33,8,20,31,9,4,1,0,58,Siarka Tarnobrzeg,Sezon 2007/2008
2007-11-03 19:00,Sportino Inowrocław(d),70 : 80P,70,20,38,52.6,3,15,20.0,23,53,43.4,21,25,84.0,11,21,32,9,17,22,17,7,4,0,71,Siarka Tarnobrzeg,Sezon 2007/2008
2007-11-11 16:00,Tarnovia Tarnowo Podgórne(w),81 : 82W,82,16,38,42.1,8,23,34.8,24,61,39.3,26,33,78.8,5,30,35,6,21,0,7,9,0,2,81,Siarka Tarnobrzeg,Sezon 2007/2008
2007-11-17 17:00,Stal Stalowa Wola(d),87 : 82W,87,23,42,54.8,5,14,35.7,28,56,50.0,26,29,89.7,4,22,26,11,31,25,18,13,2,6,90,Siarka Tarnobrzeg,Sezon 2007/2008
2007-11-24 15:00,Polonia 2011 Warszawa(w),86 : 70P,70,14,40,35.0,6,22,27.3,20,62,32.3,24,32,75.0,10,18,28,9,18,25,17,19,1,7,60,Siarka Tarnobrzeg,Sezon 2007/2008
2007-12-01 18:00,MKS Start AZS Lublin(w),69 : 85W,85,23,38,60.5,6,27,22.2,29,65,44.6,21,32,65.6,13,27,40,10,31,29,11,11,2,0,90,Siarka Tarnobrzeg,Sezon 2007/2008
2007-12-08 19:00,Znicz Jarosław(d),84 : 86P,84,20,38,52.6,8,27,29.6,28,65,43.1,20,29,69.0,15,20,35,12,25,29,11,7,3,0,84,Siarka Tarnobrzeg,Sezon 2007/2008
2007-12-15 18:00,GKS Tychy(w),91 : 66P,66,16,43,37.2,8,22,36.4,24,65,36.9,10,15,66.7,10,19,29,14,17,16,16,10,3,1,60,Siarka Tarnobrzeg,Sezon 2007/2008
2007-12-19 18:00,Żubry Białystok(d),71 : 96P,71,17,34,50.0,10,22,45.5,27,56,48.2,7,12,58.3,9,23,32,14,22,21,23,9,3,4,72,Siarka Tarnobrzeg,Sezon 2007/2008
2008-01-05 17:30,PTG Sokół Łańcut(w),82 : 78P,78,16,42,38.1,8,33,24.2,24,75,32.0,22,35,62.9,20,24,44,7,28,24,12,8,1,3,62,Siarka Tarnobrzeg,Sezon 2007/2008
2008-01-09 18:00,PBG Basket Poznań(d),99 : 93W,99,21,48,43.8,13,32,40.6,34,80,42.5,18,30,60.0,20,13,33,18,24,31,12,17,2,1,99,Siarka Tarnobrzeg,Sezon 2007/2008
2008-01-12 17:30,Znicz Basket Pruszków(d),68 : 76P,68,23,40,57.5,3,22,13.6,26,62,41.9,13,19,68.4,15,25,40,10,18,20,12,9,3,1,76,Siarka Tarnobrzeg,Sezon 2007/2008
2008-01-16 17:30,Resovia Rzeszów(w),71 : 55P,55,14,43,32.6,2,14,14.3,16,57,28.1,21,31,67.7,12,14,26,12,27,28,10,11,3,0,46,Siarka Tarnobrzeg,Sezon 2007/2008
2008-01-19 17:00,Asseco Prokom 2 Gdynia(d),86 : 79W,86,20,44,45.5,7,21,33.3,27,65,41.5,25,35,71.4,19,26,45,15,21,27,15,7,4,3,94,Siarka Tarnobrzeg,Sezon 2007/2008
2008-01-26 19:00,Wiecko Zastal Zielona Góra(w),70 : 52P,52,14,34,41.2,6,22,27.3,20,56,35.7,6,11,54.5,6,22,28,5,17,18,11,8,1,6,42,Siarka Tarnobrzeg,Sezon 2007/2008
2008-02-02 17:00,MKKS Rybnik(d),61 : 70P,61,14,26,53.8,5,26,19.2,19,52,36.5,18,29,62.1,8,24,32,11,24,23,17,9,1,0,53,Siarka Tarnobrzeg,Sezon 2007/2008
2008-02-09 18:00,Sportino Inowrocław(w),91 : 72P,72,22,36,61.1,5,16,31.3,27,52,51.9,13,21,61.9,7,11,18,15,22,13,15,8,2,0,67,Siarka Tarnobrzeg,Sezon 2007/2008
2008-02-16 17:00,Tarnovia Tarnowo Podgórne(d),87 : 70W,87,28,48,58.3,7,12,58.3,35,60,58.3,10,15,66.7,8,28,36,17,20,15,13,9,5,2,111,Siarka Tarnobrzeg,Sezon 2007/2008
2008-02-23 17:00,Stal Stalowa Wola(w),92 : 86P,86,26,48,54.2,6,21,28.6,32,69,46.4,16,26,61.5,16,16,32,15,24,23,12,9,3,2,86,Siarka Tarnobrzeg,Sezon 2007/2008
2008-03-01 17:00,Polonia 2011 Warszawa(d),87 : 79W,87,18,40,45.0,9,22,40.9,27,62,43.5,24,28,85.7,11,21,32,12,25,28,14,13,2,4,93,Siarka Tarnobrzeg,Sezon 2007/2008
2008-03-08 16:30,MKS Start AZS Lublin(d),92 : 59W,92,21,39,53.8,13,31,41.9,34,70,48.6,11,15,73.3,8,18,26,17,14,15,5,19,3,1,112,Siarka Tarnobrzeg,Sezon 2007/2008
2008-03-15 18:00,Znicz Jarosław(w),90 : 81P,81,23,36,63.9,6,24,25.0,29,60,48.3,17,22,77.3,11,14,25,14,18,23,14,11,2,2,83,Siarka Tarnobrzeg,Sezon 2007/2008
2008-03-29 17:00,GKS Tychy(d),85 : 77W,85,19,25,76.0,10,21,47.6,29,46,63.0,17,22,77.3,5,20,25,17,16,21,10,6,1,0,102,Siarka Tarnobrzeg,Sezon 2007/2008
2008-04-02 17:00,Żubry Białystok(w),103 : 83P,83,20,43,46.5,8,30,26.7,28,73,38.4,19,28,67.9,17,13,30,10,18,24,10,8,2,4,69,Siarka Tarnobrzeg,Sezon 2007/2008
2008-04-05 00:00,MKS Start AZS Lublin(d),93 : 86W,93,21,28,75.0,12,29,41.4,33,57,57.9,15,27,55.6,7,19,26,16,16,26,14,10,0,1,95,Siarka Tarnobrzeg,Sezon 2007/2008
2008-04-06 18:00,MKS Start AZS Lublin(d),100 : 76W,100,25,33,75.8,12,25,48.0,37,58,63.8,14,18,77.8,2,27,29,22,21,22,14,10,9,0,131,Siarka Tarnobrzeg,Sezon 2007/2008
2008-04-12 17:00,MKS Start AZS Lublin(w),87 : 58P,58,20,38,52.6,3,24,12.5,23,62,37.1,9,24,37.5,12,13,25,11,20,25,14,14,4,1,44,Siarka Tarnobrzeg,Sezon 2007/2008
2008-04-13 17:00,MKS Start AZS Lublin(w),77 : 71P,71,17,41,41.5,5,24,20.8,22,65,33.8,22,35,62.9,9,13,22,9,22,30,8,16,6,4,60,Siarka Tarnobrzeg,Sezon 2007/2008
2008-04-16 18:00,MKS Start AZS Lublin(d),94 : 73W,94,25,40,62.5,9,26,34.6,34,66,51.5,17,29,58.6,9,26,35,14,27,21,16,14,1,2,98,Siarka Tarnobrzeg,Sezon 2007/2008
2007-09-22 17:00,Asseco Prokom 2 Gdynia(w),48 : 75W,75,14,28,50.0,10,22,45.5,24,50,48.0,17,31,54.8,16,21,37,14,14,0,15,11,2,0,84,Sportino Inowrocław,Sezon 2007/2008
2007-09-30 18:00,Wiecko Zastal Zielona Góra(d),54 : 64P,54,16,36,44.4,4,21,19.0,20,57,35.1,10,16,62.5,10,23,33,13,21,23,14,8,6,5,57,Sportino Inowrocław,Sezon 2007/2008
2007-10-06 17:00,MKKS Rybnik(w),69 : 67P,67,15,32,46.9,7,19,36.8,22,51,43.1,16,21,76.2,13,22,35,10,22,20,12,6,3,0,75,Sportino Inowrocław,Sezon 2007/2008
2007-10-10 17:00,MKS Start AZS Lublin(w),46 : 83W,83,26,39,66.7,6,22,27.3,32,61,52.5,13,18,72.2,9,25,34,19,10,15,11,16,2,3,109,Sportino Inowrocław,Sezon 2007/2008
2007-10-13 18:00,Tarnovia Tarnowo Podgórne(d),85 : 61W,85,24,42,57.1,7,15,46.7,31,57,54.4,16,22,72.7,11,19,30,15,13,8,11,12,0,0,99,Sportino Inowrocław,Sezon 2007/2008
2007-10-20 17:00,Stal Stalowa Wola(w),53 : 57W,57,11,27,40.7,5,19,26.3,16,46,34.8,20,27,74.1,4,23,27,10,19,26,5,7,1,3,60,Sportino Inowrocław,Sezon 2007/2008
2007-10-27 18:00,Polonia 2011 Warszawa(d),68 : 62W,68,15,35,42.9,6,21,28.6,21,56,37.5,20,23,87.0,8,21,29,10,15,20,14,17,2,3,74,Sportino Inowrocław,Sezon 2007/2008
2007-11-03 19:00,Siarka Tarnobrzeg(w),70 : 80W,80,16,30,53.3,12,27,44.4,28,57,49.1,12,14,85.7,3,18,21,16,22,17,12,12,0,4,86,Sportino Inowrocław,Sezon 2007/2008
2007-11-10 18:00,Znicz Jarosław(d),62 : 60W,62,8,33,24.2,10,27,37.0,18,60,30.0,16,19,84.2,11,14,25,13,21,17,11,18,4,4,66,Sportino Inowrocław,Sezon 2007/2008
2007-11-17 18:00,GKS Tychy(w),71 : 61P,61,12,33,36.4,9,24,37.5,21,57,36.8,10,16,62.5,10,13,23,14,18,19,12,7,5,6,56,Sportino Inowrocław,Sezon 2007/2008
2007-11-24 18:00,Żubry Białystok(d),64 : 59W,64,15,36,41.7,5,21,23.8,20,57,35.1,19,28,67.9,14,23,37,9,20,25,15,16,2,2,67,Sportino Inowrocław,Sezon 2007/2008
2007-12-02 18:30,PBG Basket Poznań(w),65 : 73W,73,14,31,45.2,8,33,24.2,22,64,34.4,21,28,75.0,17,21,38,11,23,26,13,16,2,0,78,Sportino Inowrocław,Sezon 2007/2008
2007-12-08 18:00,PTG Sokół Łańcut(d),86 : 59W,86,18,32,56.3,10,16,62.5,28,48,58.3,20,24,83.3,8,33,41,18,22,17,18,6,4,0,113,Sportino Inowrocław,Sezon 2007/2008
2007-12-15 18:00,Znicz Basket Pruszków(w),60 : 65W,65,11,33,33.3,7,26,26.9,18,59,30.5,22,29,75.9,6,28,34,11,28,24,13,11,0,1,60,Sportino Inowrocław,Sezon 2007/2008
2007-12-19 18:00,Resovia Rzeszów(d),75 : 49W,75,19,44,43.2,10,27,37.0,29,71,40.8,7,12,58.3,16,23,39,21,13,18,9,14,6,4,99,Sportino Inowrocław,Sezon 2007/2008
2008-01-05 18:00,Wiecko Zastal Zielona Góra(w),77 : 63P,63,11,24,45.8,7,20,35.0,18,44,40.9,20,30,66.7,6,17,23,11,18,27,8,12,1,0,66,Sportino Inowrocław,Sezon 2007/2008
2008-01-09 18:00,Asseco Prokom 2 Gdynia(d),75 : 48W,75,17,38,44.7,11,32,34.4,28,70,40.0,8,11,72.7,17,19,36,18,24,12,11,15,4,2,92,Sportino Inowrocław,Sezon 2007/2008
2008-01-12 18:00,MKKS Rybnik(d),70 : 65W,70,20,34,58.8,6,27,22.2,26,61,42.6,12,18,66.7,8,21,29,14,18,21,10,14,2,0,78,Sportino Inowrocław,Sezon 2007/2008
2008-01-16 18:00,MKS Start AZS Lublin(d),71 : 54W,71,19,38,50.0,7,24,29.2,26,62,41.9,12,15,80.0,6,27,33,14,19,20,8,11,2,0,84,Sportino Inowrocław,Sezon 2007/2008
2008-01-20 16:00,Tarnovia Tarnowo Podgórne(w),56 : 68W,68,14,32,43.8,10,21,47.6,24,53,45.3,10,17,58.8,8,26,34,14,22,11,15,11,2,1,78,Sportino Inowrocław,Sezon 2007/2008
2008-02-02 15:00,Polonia 2011 Warszawa(w),50 : 74W,74,13,23,56.5,8,17,47.1,21,40,52.5,24,39,61.5,6,31,37,12,20,30,20,11,3,1,83,Sportino Inowrocław,Sezon 2007/2008
2008-02-06 18:00,Stal Stalowa Wola(d),65 : 64W,65,17,38,44.7,7,19,36.8,24,57,42.1,10,18,55.6,8,28,36,15,22,22,11,9,3,3,76,Sportino Inowrocław,Sezon 2007/2008
2008-02-09 18:00,Siarka Tarnobrzeg(d),91 : 72W,91,25,39,64.1,7,20,35.0,32,59,54.2,20,24,83.3,14,20,34,22,13,20,12,11,1,2,116,Sportino Inowrocław,Sezon 2007/2008
2008-02-16 18:00,Znicz Jarosław(w),82 : 84W,84,19,28,67.9,11,28,39.3,30,56,53.6,13,25,52.0,6,16,22,13,27,19,8,6,0,1,79,Sportino Inowrocław,Sezon 2007/2008
2008-02-23 18:00,GKS Tychy(d),67 : 59W,67,17,32,53.1,7,17,41.2,24,49,49.0,12,20,60.0,8,28,36,14,14,19,12,7,0,1,79,Sportino Inowrocław,Sezon 2007/2008
2008-03-01 17:00,Żubry Białystok(w),71 : 75W,75,18,35,51.4,8,23,34.8,26,58,44.8,15,20,75.0,10,27,37,12,20,17,12,10,5,6,90,Sportino Inowrocław,Sezon 2007/2008
2008-03-08 18:00,PBG Basket Poznań(d),74 : 90P,74,12,37,32.4,13,32,40.6,25,69,36.2,11,20,55.0,8,22,30,17,29,17,12,15,4,7,75,Sportino Inowrocław,Sezon 2007/2008
2008-03-16 17:30,PTG Sokół Łańcut(w),74 : 62P,62,14,33,42.4,9,20,45.0,23,53,43.4,7,15,46.7,9,22,31,11,22,0,18,2,0,0,50,Sportino Inowrocław,Sezon 2007/2008
2008-03-29 18:00,Znicz Basket Pruszków(d),86 : 58W,86,21,44,47.7,9,14,64.3,30,58,51.7,17,34,50.0,12,20,32,23,19,25,11,18,1,2,104,Sportino Inowrocław,Sezon 2007/2008
2008-04-02 17:30,Resovia Rzeszów(w),54 : 62W,62,17,32,53.1,6,17,35.3,23,49,46.9,10,15,66.7,4,21,25,15,22,14,19,10,1,0,63,Sportino Inowrocław,Sezon 2007/2008
2008-04-05 18:00,GKS Tychy(d),69 : 59W,69,23,35,65.7,6,14,42.9,29,49,59.2,5,7,71.4,5,26,31,14,24,15,19,7,1,4,81,Sportino Inowrocław,Sezon 2007/2008
2008-04-06 18:00,GKS Tychy(d),74 : 56W,74,15,34,44.1,9,21,42.9,24,55,43.6,17,26,65.4,13,31,44,15,24,20,13,11,2,5,93,Sportino Inowrocław,Sezon 2007/2008
2008-04-12 18:00,GKS Tychy(w),78 : 65P,65,20,40,50.0,7,21,33.3,27,61,44.3,4,6,66.7,6,14,20,15,26,14,10,14,2,2,70,Sportino Inowrocław,Sezon 2007/2008
2008-04-13 17:30,GKS Tychy(w),54 : 61W,61,13,39,33.3,8,22,36.4,21,61,34.4,11,13,84.6,11,19,30,10,12,14,11,11,3,5,62,Sportino Inowrocław,Sezon 2007/2008
2008-04-19 17:30,PTG Sokół Łańcut(w),74 : 66P,66,17,32,53.1,7,26,26.9,24,58,41.4,11,20,55.0,10,18,28,11,25,15,12,7,2,3,59,Sportino Inowrocław,Sezon 2007/2008
2008-04-20 17:30,PTG Sokół Łańcut(w),55 : 63W,63,20,40,50.0,3,18,16.7,23,58,39.7,14,21,66.7,15,21,36,11,22,21,14,8,0,3,62,Sportino Inowrocław,Sezon 2007/2008
2008-04-26 18:00,PTG Sokół Łańcut(d),68 : 53W,68,13,31,41.9,7,24,29.2,20,55,36.4,21,24,87.5,6,24,30,9,22,21,9,9,1,2,70,Sportino Inowrocław,Sezon 2007/2008
2008-04-27 18:00,PTG Sokół Łańcut(d),66 : 54W,66,12,32,37.5,9,23,39.1,21,55,38.2,15,26,57.7,13,22,35,12,23,24,12,15,2,1,73,Sportino Inowrocław,Sezon 2007/2008
2008-05-04 18:00,Znicz Jarosław(w),77 : 74P,74,20,32,62.5,9,35,25.7,29,67,43.3,7,18,38.9,14,20,34,17,27,21,11,11,1,1,77,Sportino Inowrocław,Sezon 2007/2008
2008-05-07 18:00,Znicz Jarosław(d),82 : 90P,82,17,39,43.6,9,29,31.0,26,68,38.2,21,32,65.6,15,18,33,13,21,18,12,7,1,3,71,Sportino Inowrocław,Sezon 2007/2008
2007-09-21 18:00,Znicz Basket Pruszków(w),79 : 64P,64,23,46,50.0,2,20,10.0,25,66,37.9,12,19,63.2,16,26,42,10,19,0,12,6,3,0,65,Stal Stalowa Wola,Sezon 2007/2008
2007-09-29 17:00,Resovia Rzeszów(d),77 : 58W,77,23,35,65.7,6,20,30.0,29,55,52.7,13,20,65.0,7,20,27,15,24,22,16,10,4,0,84,Stal Stalowa Wola,Sezon 2007/2008
2007-10-07 15:00,Asseco Prokom 2 Gdynia(w),77 : 69P,69,18,37,48.6,6,27,22.2,24,64,37.5,15,26,57.7,9,21,30,10,21,22,21,15,6,5,58,Stal Stalowa Wola,Sezon 2007/2008
2007-10-10 18:00,Wiecko Zastal Zielona Góra(d),55 : 76P,55,6,24,25.0,10,26,38.5,16,50,32.0,13,18,72.2,1,13,14,7,16,18,11,4,2,0,32,Stal Stalowa Wola,Sezon 2007/2008
2007-10-13 17:00,MKKS Rybnik(w),71 : 86W,86,25,36,69.4,7,21,33.3,32,57,56.1,15,20,75.0,7,27,34,9,21,17,13,6,3,0,95,Stal Stalowa Wola,Sezon 2007/2008
2007-10-20 17:00,Sportino Inowrocław(d),53 : 57P,53,14,31,45.2,7,19,36.8,21,50,42.0,4,5,80.0,2,24,26,13,26,18,10,1,3,1,56,Stal Stalowa Wola,Sezon 2007/2008
2007-10-28 16:00,Tarnovia Tarnowo Podgórne(w),76 : 87W,87,21,41,51.2,9,16,56.3,30,57,52.6,18,29,62.1,4,24,28,15,19,15,11,5,2,6,88,Stal Stalowa Wola,Sezon 2007/2008
2007-11-03 17:00,MKS Start AZS Lublin(w),57 : 61W,61,14,33,42.4,7,30,23.3,21,63,33.3,12,16,75.0,11,26,37,13,19,21,14,9,4,4,64,Stal Stalowa Wola,Sezon 2007/2008
2007-11-10 17:00,Polonia 2011 Warszawa(d),91 : 83W,91,24,38,63.2,9,25,36.0,33,63,52.4,16,20,80.0,7,20,27,14,24,23,13,10,1,3,96,Stal Stalowa Wola,Sezon 2007/2008
2007-11-17 17:00,Siarka Tarnobrzeg(w),87 : 82P,82,19,31,61.3,5,15,33.3,24,46,52.2,29,41,70.7,5,24,29,9,27,30,21,9,6,2,80,Stal Stalowa Wola,Sezon 2007/2008
2007-11-24 17:00,Znicz Jarosław(d),73 : 68W,73,20,39,51.3,7,27,25.9,27,66,40.9,12,18,66.7,14,24,38,14,17,23,10,9,5,2,84,Stal Stalowa Wola,Sezon 2007/2008
2007-12-01 18:00,GKS Tychy(w),87 : 76P,76,17,38,44.7,10,26,38.5,27,64,42.2,12,13,92.3,9,15,24,19,22,19,13,9,2,4,79,Stal Stalowa Wola,Sezon 2007/2008
2007-12-08 17:00,Żubry Białystok(d),101 : 70W,101,27,44,61.4,12,25,48.0,39,69,56.5,11,13,84.6,8,24,32,24,22,15,8,9,4,2,130,Stal Stalowa Wola,Sezon 2007/2008
2007-12-14 18:00,PBG Basket Poznań(w),95 : 85P,85,18,34,52.9,11,32,34.4,29,66,43.9,16,23,69.6,7,14,21,17,25,21,13,8,0,0,74,Stal Stalowa Wola,Sezon 2007/2008
2007-12-19 18:00,PTG Sokół Łańcut(d),80 : 90P,80,18,31,58.1,10,28,35.7,28,59,47.5,14,18,77.8,9,15,24,19,15,15,7,8,1,0,90,Stal Stalowa Wola,Sezon 2007/2008
2008-01-05 18:00,Resovia Rzeszów(w),84 : 66P,66,22,39,56.4,3,22,13.6,25,61,41.0,13,20,65.0,10,23,33,9,20,18,18,6,4,0,57,Stal Stalowa Wola,Sezon 2007/2008
2008-01-09 18:00,Znicz Basket Pruszków(d),75 : 74W,75,20,41,48.8,7,17,41.2,27,58,46.6,14,17,82.4,6,23,29,18,19,22,12,15,4,2,95,Stal Stalowa Wola,Sezon 2007/2008
2008-01-12 17:00,Asseco Prokom 2 Gdynia(d),91 : 83W,91,18,34,52.9,13,30,43.3,31,64,48.4,16,19,84.2,8,21,29,22,9,16,10,4,3,1,103,Stal Stalowa Wola,Sezon 2007/2008
2008-01-16 18:00,Wiecko Zastal Zielona Góra(w),77 : 68P,68,18,28,64.3,6,24,25.0,24,52,46.2,14,19,73.7,9,14,23,14,21,19,8,6,1,1,71,Stal Stalowa Wola,Sezon 2007/2008
2008-01-19 17:00,MKKS Rybnik(d),106 : 83W,106,23,39,59.0,13,20,65.0,36,59,61.0,21,25,84.0,4,29,33,27,19,22,9,4,2,1,136,Stal Stalowa Wola,Sezon 2007/2008
2008-02-02 17:00,Tarnovia Tarnowo Podgórne(d),83 : 77W,83,22,43,51.2,6,23,26.1,28,66,42.4,21,25,84.0,7,19,26,11,22,22,5,15,3,4,91,Stal Stalowa Wola,Sezon 2007/2008
2008-02-06 18:00,Sportino Inowrocław(w),65 : 64P,64,14,38,36.8,5,17,29.4,19,55,34.5,21,24,87.5,5,23,28,13,22,22,13,10,3,3,66,Stal Stalowa Wola,Sezon 2007/2008
2008-02-09 17:00,MKS Start AZS Lublin(d),76 : 71W,76,21,39,53.8,6,26,23.1,27,65,41.5,16,21,76.2,9,28,37,14,19,24,10,12,3,4,89,Stal Stalowa Wola,Sezon 2007/2008
2008-02-17 15:00,Polonia 2011 Warszawa(w),90 : 72P,72,18,34,52.9,5,15,33.3,23,49,46.9,21,26,80.8,6,19,25,14,20,23,23,11,3,1,71,Stal Stalowa Wola,Sezon 2007/2008
2008-02-23 17:00,Siarka Tarnobrzeg(d),92 : 86W,92,19,26,73.1,11,26,42.3,30,52,57.7,21,25,84.0,4,22,26,18,23,24,13,8,2,3,107,Stal Stalowa Wola,Sezon 2007/2008
2008-03-01 18:00,Znicz Jarosław(w),77 : 56P,56,16,31,51.6,4,25,16.0,20,56,35.7,12,19,63.2,2,19,21,9,16,19,13,13,1,2,44,Stal Stalowa Wola,Sezon 2007/2008
2008-03-08 17:00,GKS Tychy(d),78 : 85P,78,11,31,35.5,11,27,40.7,22,58,37.9,23,32,71.9,11,15,26,11,23,31,10,10,1,3,71,Stal Stalowa Wola,Sezon 2007/2008
2008-03-15 17:00,Żubry Białystok(w),71 : 76W,76,13,33,39.4,8,21,38.1,21,54,38.9,26,37,70.3,10,22,32,8,22,29,17,9,4,6,68,Stal Stalowa Wola,Sezon 2007/2008
2008-03-29 17:00,PBG Basket Poznań(d),81 : 72W,81,26,43,60.5,6,30,20.0,32,73,43.8,11,13,84.6,12,28,40,21,18,16,8,10,4,8,105,Stal Stalowa Wola,Sezon 2007/2008
2008-04-02 18:00,PTG Sokół Łańcut(w),94 : 73P,73,19,41,46.3,8,21,38.1,27,62,43.5,11,14,78.6,5,19,24,18,25,16,16,7,2,3,70,Stal Stalowa Wola,Sezon 2007/2008
2008-04-05 18:00,Wiecko Zastal Zielona Góra(w),65 : 56P,56,9,31,29.0,7,22,31.8,16,53,30.2,17,25,68.0,8,19,27,9,25,26,14,9,0,3,42,Stal Stalowa Wola,Sezon 2007/2008
2008-04-06 17:00,Wiecko Zastal Zielona Góra(w),77 : 80W,80,10,29,34.5,14,21,66.7,24,50,48.0,18,24,75.0,4,20,24,12,24,27,10,7,3,4,84,Stal Stalowa Wola,Sezon 2007/2008
2008-04-12 18:30,Wiecko Zastal Zielona Góra(d),74 : 71W,74,14,30,46.7,10,25,40.0,24,55,43.6,16,21,76.2,6,24,30,16,21,22,12,10,2,1,84,Stal Stalowa Wola,Sezon 2007/2008
2008-04-13 17:00,Wiecko Zastal Zielona Góra(d),73 : 70W,73,17,29,58.6,8,20,40.0,25,49,51.0,15,19,78.9,4,21,25,13,21,24,14,6,2,0,77,Stal Stalowa Wola,Sezon 2007/2008
2008-04-19 18:00,Znicz Jarosław(w),89 : 81P,81,19,38,50.0,7,26,26.9,26,64,40.6,22,30,73.3,9,16,25,12,20,28,9,8,6,0,77,Stal Stalowa Wola,Sezon 2007/2008
2008-04-20 18:00,Znicz Jarosław(w),99 : 102W,102,19,36,52.8,16,27,59.3,35,63,55.6,16,21,76.2,8,15,23,20,23,19,16,11,1,2,108,Stal Stalowa Wola,Sezon 2007/2008
2008-04-26 17:00,Znicz Jarosław(d),60 : 72P,60,12,29,41.4,7,24,29.2,19,53,35.8,15,30,50.0,8,20,28,11,17,23,7,7,5,3,55,Stal Stalowa Wola,Sezon 2007/2008
2008-04-27 18:30,Znicz Jarosław(d),81 : 72W,81,26,43,60.5,5,20,25.0,31,63,49.2,14,26,53.8,8,27,35,11,20,21,9,13,5,3,92,Stal Stalowa Wola,Sezon 2007/2008
2008-04-30 18:00,Znicz Jarosław(w),70 : 57P,57,16,40,40.0,7,28,25.0,23,68,33.8,4,6,66.7,8,23,31,11,25,14,13,10,1,4,50,Stal Stalowa Wola,Sezon 2007/2008
2007-09-23 17:00,MKKS Rybnik(d),84 : 60W,84,24,39,61.5,4,20,20.0,28,59,47.5,24,34,70.6,15,33,48,14,25,0,14,11,2,0,104,Wiecko Zastal Zielona Góra,Sezon 2007/2008
2007-09-30 18:00,Sportino Inowrocław(w),54 : 64W,64,10,27,37.0,9,25,36.0,19,52,36.5,17,22,77.3,6,25,31,12,23,21,10,13,5,6,77,Wiecko Zastal Zielona Góra,Sezon 2007/2008
2007-10-06 16:00,Tarnovia Tarnowo Podgórne(d),87 : 50W,87,29,51,56.9,5,12,41.7,34,63,54.0,14,24,58.3,12,36,48,10,18,21,8,8,7,5,113,Wiecko Zastal Zielona Góra,Sezon 2007/2008
2007-10-10 18:00,Stal Stalowa Wola(w),55 : 76W,76,27,45,60.0,6,19,31.6,33,64,51.6,4,7,57.1,13,30,43,11,18,15,8,8,3,0,99,Wiecko Zastal Zielona Góra,Sezon 2007/2008
2007-10-13 18:00,Polonia 2011 Warszawa(d),76 : 47W,76,26,42,61.9,6,25,24.0,32,67,47.8,6,9,66.7,15,29,44,18,18,18,13,6,5,1,98,Wiecko Zastal Zielona Góra,Sezon 2007/2008
2007-10-20 19:00,Siarka Tarnobrzeg(w),65 : 73W,73,18,36,50.0,5,17,29.4,23,53,43.4,22,29,75.9,9,24,33,5,25,26,18,7,4,1,67,Wiecko Zastal Zielona Góra,Sezon 2007/2008
2007-10-27 18:00,Znicz Jarosław(d),79 : 62W,79,30,45,66.7,5,22,22.7,35,67,52.2,4,10,40.0,13,20,33,15,13,15,5,11,2,2,97,Wiecko Zastal Zielona Góra,Sezon 2007/2008
2007-11-03 18:00,GKS Tychy(w),69 : 71W,71,16,45,35.6,10,27,37.0,26,72,36.1,9,9,100.0,10,19,29,16,17,17,8,10,2,12,74,Wiecko Zastal Zielona Góra,Sezon 2007/2008
2007-11-11 17:00,Żubry Białystok(d),59 : 54W,59,11,32,34.4,7,22,31.8,18,54,33.3,16,23,69.6,9,23,32,11,24,18,10,10,2,3,61,Wiecko Zastal Zielona Góra,Sezon 2007/2008
2007-11-17 15:30,PBG Basket Poznań(w),62 : 66W,66,8,29,27.6,10,23,43.5,18,52,34.6,20,25,80.0,8,24,32,9,27,24,12,8,3,0,67,Wiecko Zastal Zielona Góra,Sezon 2007/2008
2007-11-24 18:00,PTG Sokół Łańcut(d),67 : 58W,67,16,33,48.5,8,21,38.1,24,54,44.4,11,17,64.7,11,27,38,11,18,22,14,9,1,2,76,Wiecko Zastal Zielona Góra,Sezon 2007/2008
2007-12-01 18:00,Znicz Basket Pruszków(w),73 : 86W,86,22,39,56.4,11,18,61.1,33,57,57.9,9,14,64.3,5,21,26,19,27,20,17,13,0,2,98,Wiecko Zastal Zielona Góra,Sezon 2007/2008
2007-12-08 18:00,Resovia Rzeszów(d),71 : 60W,71,15,33,45.5,10,26,38.5,25,59,42.4,11,16,68.8,11,19,30,16,28,20,10,12,4,1,84,Wiecko Zastal Zielona Góra,Sezon 2007/2008
2007-12-15 17:00,Asseco Prokom 2 Gdynia(w),79 : 90W,90,21,34,61.8,11,27,40.7,32,61,52.5,15,22,68.2,6,24,30,18,15,23,11,8,6,2,105,Wiecko Zastal Zielona Góra,Sezon 2007/2008
2007-12-19 18:00,MKS Start AZS Lublin(d),93 : 64W,93,19,34,55.9,11,25,44.0,30,59,50.8,22,27,81.5,11,21,32,17,22,17,15,16,5,0,114,Wiecko Zastal Zielona Góra,Sezon 2007/2008
2008-01-05 18:00,Sportino Inowrocław(d),77 : 63W,77,12,24,50.0,13,25,52.0,25,49,51.0,14,15,93.3,7,24,31,14,28,18,13,5,0,1,89,Wiecko Zastal Zielona Góra,Sezon 2007/2008
2008-01-09 17:00,MKKS Rybnik(w),71 : 75W,75,16,24,66.7,9,30,30.0,25,54,46.3,16,19,84.2,9,26,35,14,20,14,15,6,3,0,86,Wiecko Zastal Zielona Góra,Sezon 2007/2008
2008-01-13 16:00,Tarnovia Tarnowo Podgórne(w),61 : 69W,69,16,35,45.7,8,23,34.8,24,58,41.4,13,18,72.2,15,24,39,14,22,15,10,2,5,2,80,Wiecko Zastal Zielona Góra,Sezon 2007/2008
2008-01-16 18:00,Stal Stalowa Wola(d),77 : 68W,77,22,40,55.0,8,20,40.0,30,60,50.0,9,13,69.2,14,19,33,15,19,21,11,6,1,1,87,Wiecko Zastal Zielona Góra,Sezon 2007/2008
2008-01-19 15:00,Polonia 2011 Warszawa(w),75 : 78W,78,17,30,56.7,9,23,39.1,26,53,49.1,17,21,81.0,9,24,33,16,23,22,18,3,5,0,86,Wiecko Zastal Zielona Góra,Sezon 2007/2008
2008-01-26 19:00,Siarka Tarnobrzeg(d),70 : 52W,70,21,42,50.0,6,19,31.6,27,61,44.3,10,11,90.9,10,27,37,17,18,17,11,10,6,1,94,Wiecko Zastal Zielona Góra,Sezon 2007/2008
2008-02-03 18:00,Znicz Jarosław(w),96 : 67P,67,13,31,41.9,10,23,43.5,23,54,42.6,11,22,50.0,8,11,19,8,22,11,12,4,5,2,49,Wiecko Zastal Zielona Góra,Sezon 2007/2008
2008-02-10 17:00,GKS Tychy(d),64 : 84P,64,13,26,50.0,7,33,21.2,20,59,33.9,17,22,77.3,14,17,31,10,26,21,15,7,4,1,57,Wiecko Zastal Zielona Góra,Sezon 2007/2008
2008-02-16 17:00,Żubry Białystok(w),62 : 75W,75,19,39,48.7,10,20,50.0,29,59,49.2,7,9,77.8,9,23,32,9,19,14,11,8,1,0,82,Wiecko Zastal Zielona Góra,Sezon 2007/2008
2008-02-23 18:00,PBG Basket Poznań(d),71 : 56W,71,18,33,54.5,8,23,34.8,26,56,46.4,11,18,61.1,14,23,37,17,19,19,18,10,4,2,84,Wiecko Zastal Zielona Góra,Sezon 2007/2008
2008-03-09 17:00,Znicz Basket Pruszków(d),90 : 55W,90,20,30,66.7,10,25,40.0,30,55,54.5,20,25,80.0,7,24,31,17,23,21,12,13,3,2,112,Wiecko Zastal Zielona Góra,Sezon 2007/2008
2008-03-14 16:30,PTG Sokół Łańcut(w),69 : 63P,63,13,24,54.2,7,26,26.9,20,50,40.0,16,19,84.2,4,26,30,9,24,14,11,6,4,4,68,Wiecko Zastal Zielona Góra,Sezon 2007/2008
2008-03-15 19:00,Resovia Rzeszów(w),64 : 73W,73,20,38,52.6,6,23,26.1,26,61,42.6,15,19,78.9,10,25,35,16,27,19,16,14,6,0,89,Wiecko Zastal Zielona Góra,Sezon 2007/2008
2008-03-30 17:00,Asseco Prokom 2 Gdynia(d),82 : 55W,82,15,30,50.0,10,27,37.0,25,57,43.9,22,28,78.6,15,33,48,18,21,26,16,8,2,2,104,Wiecko Zastal Zielona Góra,Sezon 2007/2008
2008-04-02 17:00,MKS Start AZS Lublin(w),69 : 75W,75,21,30,70.0,6,28,21.4,27,58,46.6,15,26,57.7,8,27,35,12,20,24,10,7,3,0,80,Wiecko Zastal Zielona Góra,Sezon 2007/2008
2008-04-05 18:00,Stal Stalowa Wola(d),65 : 56W,65,14,34,41.2,7,16,43.8,21,50,42.0,16,22,72.7,10,32,42,12,26,25,16,11,3,0,82,Wiecko Zastal Zielona Góra,Sezon 2007/2008
2008-04-06 17:00,Stal Stalowa Wola(d),77 : 80P,77,20,40,50.0,8,21,38.1,28,61,45.9,13,24,54.2,13,18,31,11,27,24,8,7,4,3,78,Wiecko Zastal Zielona Góra,Sezon 2007/2008
2008-04-12 18:30,Stal Stalowa Wola(w),74 : 71P,71,19,26,73.1,7,29,24.1,26,55,47.3,12,22,54.5,8,25,33,13,22,21,14,10,1,2,75,Wiecko Zastal Zielona Góra,Sezon 2007/2008
2008-04-13 17:00,Stal Stalowa Wola(w),73 : 70P,70,15,29,51.7,9,26,34.6,24,55,43.6,13,20,65.0,7,21,28,8,24,20,10,12,0,2,70,Wiecko Zastal Zielona Góra,Sezon 2007/2008
2007-09-22 17:00,Żubry Białystok(w),89 : 92W,92,24,38,63.2,10,18,55.6,34,56,60.7,14,16,87.5,6,15,21,11,20,0,9,0,0,0,91,Znicz Jarosław,Sezon 2007/2008
2007-09-29 18:00,PBG Basket Poznań(d),83 : 76W,83,19,37,51.4,10,23,43.5,29,60,48.3,15,23,65.2,11,18,29,16,13,16,15,7,2,0,83,Znicz Jarosław,Sezon 2007/2008
2007-10-06 17:30,PTG Sokół Łańcut(w),79 : 55P,55,13,27,48.1,6,19,31.6,19,46,41.3,11,17,64.7,9,23,32,12,18,14,26,10,0,0,50,Znicz Jarosław,Sezon 2007/2008
2007-10-10 18:00,Znicz Basket Pruszków(d),76 : 71W,76,16,34,47.1,9,24,37.5,25,58,43.1,17,22,77.3,9,24,33,17,23,22,17,7,1,0,79,Znicz Jarosław,Sezon 2007/2008
2007-10-13 18:00,Resovia Rzeszów(w),59 : 79W,79,15,27,55.6,11,24,45.8,26,51,51.0,16,18,88.9,9,18,27,16,17,14,11,8,3,0,95,Znicz Jarosław,Sezon 2007/2008
2007-10-21 17:00,Asseco Prokom 2 Gdynia(d),85 : 77W,85,23,43,53.5,9,14,64.3,32,57,56.1,12,22,54.5,7,26,33,23,14,17,18,9,1,0,98,Znicz Jarosław,Sezon 2007/2008
2007-10-27 18:00,Wiecko Zastal Zielona Góra(w),79 : 62P,62,19,35,54.3,6,18,33.3,25,53,47.2,6,9,66.7,5,15,20,12,15,13,13,4,2,2,56,Znicz Jarosław,Sezon 2007/2008
2007-11-03 18:00,MKKS Rybnik(d),71 : 77P,71,21,29,72.4,6,22,27.3,27,51,52.9,11,17,64.7,7,27,34,17,20,14,20,6,2,0,80,Znicz Jarosław,Sezon 2007/2008
2007-11-10 18:00,Sportino Inowrocław(w),62 : 60P,60,21,38,55.3,2,8,25.0,23,46,50.0,12,20,60.0,7,27,34,13,22,19,19,9,5,2,71,Znicz Jarosław,Sezon 2007/2008
2007-11-17 18:00,Tarnovia Tarnowo Podgórne(d),100 : 64W,100,27,45,60.0,10,19,52.6,37,64,57.8,16,22,72.7,8,28,36,28,12,15,8,7,4,1,134,Znicz Jarosław,Sezon 2007/2008
2007-11-24 17:00,Stal Stalowa Wola(w),73 : 68P,68,20,44,45.5,5,17,29.4,25,61,41.0,13,15,86.7,9,22,31,7,23,17,15,5,2,5,60,Znicz Jarosław,Sezon 2007/2008
2007-12-01 18:00,Polonia 2011 Warszawa(d),85 : 74W,85,23,41,56.1,6,21,28.6,29,62,46.8,21,29,72.4,10,25,35,16,24,17,14,16,3,4,100,Znicz Jarosław,Sezon 2007/2008
2007-12-08 19:00,Siarka Tarnobrzeg(w),84 : 86W,86,21,41,51.2,6,16,37.5,27,57,47.4,26,32,81.3,7,22,29,14,29,25,12,6,0,3,87,Znicz Jarosław,Sezon 2007/2008
2007-12-16 17:00,MKS Start AZS Lublin(w),86 : 101W,101,30,44,68.2,9,20,45.0,39,64,60.9,14,19,73.7,11,27,38,23,21,22,14,7,4,2,129,Znicz Jarosław,Sezon 2007/2008
2007-12-19 18:00,GKS Tychy(d),66 : 60W,66,21,40,52.5,3,15,20.0,24,55,43.6,15,16,93.8,13,23,36,14,16,19,13,10,0,4,81,Znicz Jarosław,Sezon 2007/2008
2008-01-05 18:00,PBG Basket Poznań(w),68 : 66P,66,10,27,37.0,8,25,32.0,18,52,34.6,22,25,88.0,6,23,29,8,20,21,11,8,1,0,64,Znicz Jarosław,Sezon 2007/2008
2008-01-09 18:00,Żubry Białystok(d),86 : 74W,86,26,39,66.7,9,24,37.5,35,63,55.6,7,11,63.6,9,27,36,24,16,14,16,10,5,2,113,Znicz Jarosław,Sezon 2007/2008
2008-01-13 18:00,PTG Sokół Łańcut(d),85 : 76W,85,21,41,51.2,9,23,39.1,30,64,46.9,16,20,80.0,10,21,31,18,17,16,13,8,2,3,93,Znicz Jarosław,Sezon 2007/2008
2008-01-16 18:00,Znicz Basket Pruszków(w),90 : 92W,92,28,43,65.1,6,16,37.5,34,59,57.6,18,22,81.8,9,16,25,12,17,22,12,13,2,1,103,Znicz Jarosław,Sezon 2007/2008
2008-01-19 18:00,Resovia Rzeszów(d),86 : 64W,86,23,42,54.8,10,26,38.5,33,68,48.5,10,13,76.9,8,21,29,20,23,15,11,14,3,4,103,Znicz Jarosław,Sezon 2007/2008
2008-01-26 19:15,Asseco Prokom 2 Gdynia(w),83 : 92W,92,25,47,53.2,6,16,37.5,31,63,49.2,24,33,72.7,8,28,36,7,16,24,13,5,1,6,87,Znicz Jarosław,Sezon 2007/2008
2008-02-03 18:00,Wiecko Zastal Zielona Góra(d),96 : 67W,96,27,41,65.9,9,21,42.9,36,62,58.1,15,19,78.9,10,20,30,21,16,14,11,8,2,5,116,Znicz Jarosław,Sezon 2007/2008
2008-02-09 17:00,MKKS Rybnik(w),63 : 93W,93,29,41,70.7,6,16,37.5,35,57,61.4,17,24,70.8,10,29,39,18,18,19,16,9,0,0,114,Znicz Jarosław,Sezon 2007/2008
2008-02-16 18:00,Sportino Inowrocław(d),82 : 84P,82,24,32,75.0,4,19,21.1,28,51,54.9,22,32,68.8,6,24,30,16,24,25,11,6,1,0,91,Znicz Jarosław,Sezon 2007/2008
2008-02-24 16:00,Tarnovia Tarnowo Podgórne(w),61 : 74W,74,24,41,58.5,7,14,50.0,31,55,56.4,5,8,62.5,7,29,36,22,12,5,15,7,2,1,99,Znicz Jarosław,Sezon 2007/2008
2008-03-01 18:00,Stal Stalowa Wola(d),77 : 56W,77,22,38,57.9,7,20,35.0,29,58,50.0,12,16,75.0,9,38,47,14,19,16,20,10,2,1,97,Znicz Jarosław,Sezon 2007/2008
2008-03-09 15:00,Polonia 2011 Warszawa(w),83 : 85W,85,26,46,56.5,6,12,50.0,32,58,55.2,15,19,78.9,8,23,31,19,15,21,12,8,3,3,104,Znicz Jarosław,Sezon 2007/2008
2008-03-15 18:00,Siarka Tarnobrzeg(d),90 : 81W,90,26,38,68.4,9,22,40.9,35,60,58.3,11,12,91.7,9,16,25,25,25,18,14,11,2,2,113,Znicz Jarosław,Sezon 2007/2008
2008-03-29 18:00,MKS Start AZS Lublin(d),93 : 86W,93,26,36,72.2,8,23,34.8,34,59,57.6,17,23,73.9,9,25,34,16,15,22,15,9,9,1,115,Znicz Jarosław,Sezon 2007/2008
2008-04-02 18:00,GKS Tychy(w),79 : 82W,82,28,40,70.0,7,23,30.4,35,63,55.6,5,5,100.0,9,22,31,17,17,12,13,9,2,1,100,Znicz Jarosław,Sezon 2007/2008
2008-04-05 18:00,PBG Basket Poznań(d),75 : 67W,75,24,48,50.0,4,22,18.2,28,70,40.0,15,21,71.4,12,30,42,17,17,21,11,7,5,3,87,Znicz Jarosław,Sezon 2007/2008
2008-04-06 18:00,PBG Basket Poznań(d),63 : 67P,63,14,33,42.4,7,28,25.0,21,61,34.4,14,16,87.5,13,23,36,16,19,16,13,6,2,0,68,Znicz Jarosław,Sezon 2007/2008
2008-04-12 18:00,PBG Basket Poznań(w),89 : 67P,67,13,34,38.2,9,23,39.1,22,57,38.6,14,17,82.4,8,16,24,12,17,18,13,7,5,2,64,Znicz Jarosław,Sezon 2007/2008
2008-04-13 18:00,PBG Basket Poznań(w),86 : 104W,104,23,42,54.8,9,23,39.1,32,65,49.2,31,33,93.9,9,16,25,16,18,31,4,6,2,0,114,Znicz Jarosław,Sezon 2007/2008
2008-04-16 18:00,PBG Basket Poznań(d),101 : 79W,101,22,37,59.5,12,35,34.3,34,72,47.2,21,26,80.8,12,16,28,23,12,23,10,23,3,1,125,Znicz Jarosław,Sezon 2007/2008
2008-04-19 18:00,Stal Stalowa Wola(d),89 : 81W,89,23,38,60.5,7,16,43.8,30,54,55.6,22,26,84.6,7,29,36,20,23,22,16,7,1,4,109,Znicz Jarosław,Sezon 2007/2008
2008-04-20 18:00,Stal Stalowa Wola(d),99 : 102P,99,24,37,64.9,11,22,50.0,35,59,59.3,18,23,78.3,4,24,28,18,19,22,15,13,3,1,117,Znicz Jarosław,Sezon 2007/2008
2008-04-26 17:00,Stal Stalowa Wola(w),60 : 72W,72,15,36,41.7,11,28,39.3,26,64,40.6,9,14,64.3,10,29,39,15,24,17,10,1,3,5,77,Znicz Jarosław,Sezon 2007/2008
2008-04-27 18:30,Stal Stalowa Wola(w),81 : 72P,72,17,39,43.6,9,24,37.5,26,63,41.3,11,14,78.6,7,23,30,12,21,20,16,5,3,5,66,Znicz Jarosław,Sezon 2007/2008
2008-04-30 18:00,Stal Stalowa Wola(d),70 : 57W,70,19,48,39.6,4,15,26.7,23,63,36.5,20,28,71.4,18,32,50,8,15,25,13,9,5,1,81,Znicz Jarosław,Sezon 2007/2008
2008-05-04 18:00,Sportino Inowrocław(d),77 : 74W,77,18,36,50.0,6,13,46.2,24,49,49.0,23,32,71.9,6,26,32,13,21,26,17,10,1,1,82,Znicz Jarosław,Sezon 2007/2008
2008-05-07 18:00,Sportino Inowrocław(w),82 : 90W,90,20,40,50.0,10,18,55.6,30,58,51.7,20,24,83.3,7,23,30,14,23,19,9,8,3,1,104,Znicz Jarosław,Sezon 2007/2008
2006-09-23 18:30,Basket Kwidzyn(w),65 : 63P,63,13,32,40.6,9,23,39.1,22,55,40.0,10,19,52.6,8,17,25,14,17,0,10,9,1,0,60,PTG Sokół Łańcut,Sezon 2006/2007
2006-09-30 18:00,Znicz Basket Pruszków(w),68 : 72W,72,20,31,64.5,3,20,15.0,23,51,45.1,23,36,63.9,10,20,30,14,23,0,24,15,0,0,66,PTG Sokół Łańcut,Sezon 2006/2007
2006-10-07 18:30,PBG Basket Poznań(d),79 : 67W,79,20,34,58.8,7,18,38.9,27,52,51.9,18,28,64.3,4,28,32,22,21,0,15,9,5,0,97,PTG Sokół Łańcut,Sezon 2006/2007
2006-10-14 18:00,Siarka Tarnobrzeg(w),89 : 82P,82,25,42,59.5,8,22,36.4,33,64,51.6,8,12,66.7,8,15,23,18,21,0,18,9,1,0,80,PTG Sokół Łańcut,Sezon 2006/2007
2006-10-21 18:00,Sportowiec Częstochowa(d),88 : 93P,88,23,48,47.9,7,28,25.0,30,76,39.5,21,29,72.4,15,20,35,22,29,0,10,13,2,0,96,PTG Sokół Łańcut,Sezon 2006/2007
2006-10-28 17:00,Spójnia Stargard Szcz.(w),61 : 70W,70,24,45,53.3,2,10,20.0,26,55,47.3,16,26,61.5,10,28,38,11,18,0,11,8,3,0,80,PTG Sokół Łańcut,Sezon 2006/2007
2006-11-04 17:30,Górnik Wałbrzych(d),68 : 94P,68,15,41,36.6,7,20,35.0,22,61,36.1,17,23,73.9,12,11,23,14,22,0,10,10,3,0,63,PTG Sokół Łańcut,Sezon 2006/2007
2006-11-08 18:00,Resovia Rzeszów(w),51 : 58W,58,20,40,50.0,3,16,18.8,23,56,41.1,9,13,69.2,8,25,33,8,23,0,19,11,2,0,56,PTG Sokół Łańcut,Sezon 2006/2007
2006-11-11 17:30,Tarnovia Tarnowo Podgórne(d),75 : 60W,75,18,44,40.9,7,20,35.0,25,64,39.1,18,23,78.3,15,16,31,18,15,0,12,17,0,0,85,PTG Sokół Łańcut,Sezon 2006/2007
2006-11-18 17:00,Stal Stalowa Wola(w),77 : 68P,68,21,48,43.8,5,17,29.4,26,65,40.0,11,17,64.7,12,19,31,10,27,0,15,10,0,0,59,PTG Sokół Łańcut,Sezon 2006/2007
2006-11-26 17:30,MKS Start AZS Lublin(d),92 : 51W,92,13,29,44.8,15,30,50.0,28,59,47.5,21,26,80.8,8,18,26,27,13,0,9,21,3,0,124,PTG Sokół Łańcut,Sezon 2006/2007
2006-12-02 17:30,Sportino Inowrocław(w),81 : 75P,75,16,40,40.0,10,21,47.6,26,61,42.6,13,21,61.9,10,17,27,13,24,0,13,14,3,0,76,PTG Sokół Łańcut,Sezon 2006/2007
2006-12-09 17:30,Grono Zielona Góra(d),61 : 62P,61,20,29,69.0,4,17,23.5,24,46,52.2,9,16,56.3,6,21,27,16,19,0,18,8,1,0,66,PTG Sokół Łańcut,Sezon 2006/2007
2006-12-16 18:30,Basket Kwidzyn(d),78 : 70W,78,23,43,53.5,5,19,26.3,28,62,45.2,17,21,81.0,9,21,30,18,23,0,7,10,7,0,98,PTG Sokół Łańcut,Sezon 2006/2007
2007-01-06 17:30,Znicz Basket Pruszków(d),63 : 70P,63,15,32,46.9,6,25,24.0,21,57,36.8,15,21,71.4,7,26,33,17,25,0,15,6,3,0,65,PTG Sokół Łańcut,Sezon 2006/2007
2007-01-13 17:00,PBG Basket Poznań(w),92 : 79P,79,20,38,52.6,8,27,29.6,28,65,43.1,15,18,83.3,9,22,31,10,21,0,18,11,8,0,81,PTG Sokół Łańcut,Sezon 2006/2007
2007-01-20 17:30,Siarka Tarnobrzeg(d),80 : 63W,80,24,37,64.9,6,18,33.3,30,55,54.5,14,23,60.9,8,20,28,21,22,0,16,14,3,0,96,PTG Sokół Łańcut,Sezon 2006/2007
2007-01-28 16:00,Sportowiec Częstochowa(w),84 : 92W,92,22,38,57.9,10,18,55.6,32,56,57.1,18,25,72.0,10,19,29,20,20,0,11,7,2,0,108,PTG Sokół Łańcut,Sezon 2006/2007
2007-02-04 18:00,Spójnia Stargard Szcz.(d),75 : 55W,75,16,42,38.1,10,21,47.6,26,63,41.3,13,14,92.9,10,25,35,21,15,0,5,9,2,0,99,PTG Sokół Łańcut,Sezon 2006/2007
2007-02-10 17:00,Górnik Wałbrzych(w),84 : 69P,69,12,25,48.0,7,25,28.0,19,50,38.0,24,28,85.7,8,15,23,10,26,0,14,13,1,0,67,PTG Sokół Łańcut,Sezon 2006/2007
2007-02-14 18:30,Resovia Rzeszów(d),76 : 90P,76,21,42,50.0,5,20,25.0,26,62,41.9,19,24,79.2,10,25,35,19,25,0,20,8,4,0,81,PTG Sokół Łańcut,Sezon 2006/2007
2007-02-18 16:00,Tarnovia Tarnowo Podgórne(w),58 : 52P,52,19,47,40.4,2,9,22.2,21,56,37.5,8,12,66.7,5,26,31,7,15,0,13,5,1,0,44,PTG Sokół Łańcut,Sezon 2006/2007
2007-02-25 17:00,Stal Stalowa Wola(d),74 : 93P,74,24,44,54.5,3,22,13.6,27,66,40.9,17,20,85.0,14,20,34,16,27,0,18,12,3,0,79,PTG Sokół Łańcut,Sezon 2006/2007
2007-03-07 17:00,MKS Start AZS Lublin(w),74 : 70P,70,13,33,39.4,9,22,40.9,22,55,40.0,17,20,85.0,8,19,27,14,26,0,16,12,2,0,73,PTG Sokół Łańcut,Sezon 2006/2007
2007-03-10 17:30,Sportino Inowrocław(d),80 : 79W,80,19,38,50.0,5,17,29.4,24,55,43.6,27,29,93.1,10,28,38,16,20,0,15,13,3,0,102,PTG Sokół Łańcut,Sezon 2006/2007
2007-03-17 17:00,Grono Zielona Góra(w),82 : 62P,62,13,36,36.1,8,21,38.1,21,57,36.8,12,15,80.0,5,20,25,8,17,0,15,8,2,0,51,PTG Sokół Łańcut,Sezon 2006/2007
2006-09-23 16:00,Górnik Wałbrzych(d),75 : 77P,75,21,41,51.2,6,19,31.6,27,60,45.0,15,22,68.2,7,12,19,9,23,0,10,7,2,0,62,Tarnovia Tarnowo Podgórne,Sezon 2006/2007
2006-09-30 17:00,Resovia Rzeszów(w),92 : 81P,81,27,47,57.4,2,15,13.3,29,62,46.8,21,31,67.7,13,21,34,12,32,0,8,7,1,0,84,Tarnovia Tarnowo Podgórne,Sezon 2006/2007
2006-10-07 16:00,Znicz Basket Pruszków(d),84 : 90P,84,23,44,52.3,10,24,41.7,33,68,48.5,8,16,50.0,11,21,32,7,33,0,12,9,0,0,77,Tarnovia Tarnowo Podgórne,Sezon 2006/2007
2006-10-15 17:00,Stal Stalowa Wola(d),64 : 94P,64,23,59,39.0,3,13,23.1,26,72,36.1,9,14,64.3,12,12,24,8,23,0,3,12,0,0,54,Tarnovia Tarnowo Podgórne,Sezon 2006/2007
2006-10-22 17:00,MKS Start AZS Lublin(w),93 : 81P,81,22,47,46.8,7,21,33.3,29,68,42.6,16,20,80.0,7,20,27,15,23,0,14,9,1,0,76,Tarnovia Tarnowo Podgórne,Sezon 2006/2007
2006-10-29 16:00,Sportino Inowrocław(d),68 : 76P,68,18,40,45.0,7,18,38.9,25,58,43.1,11,18,61.1,12,19,31,8,24,0,8,7,1,0,67,Tarnovia Tarnowo Podgórne,Sezon 2006/2007
2006-11-05 17:00,Grono Zielona Góra(w),62 : 65W,65,17,35,48.6,6,19,31.6,23,54,42.6,13,18,72.2,8,24,32,12,28,0,11,12,1,0,75,Tarnovia Tarnowo Podgórne,Sezon 2006/2007
2006-11-11 17:30,PTG Sokół Łańcut(w),75 : 60P,60,18,26,69.2,5,18,27.8,23,44,52.3,9,14,64.3,6,22,28,13,28,0,24,10,2,0,63,Tarnovia Tarnowo Podgórne,Sezon 2006/2007
2006-11-15 18:00,Basket Kwidzyn(d),66 : 78P,66,18,42,42.9,7,19,36.8,25,61,41.0,9,17,52.9,15,12,27,2,19,0,12,6,2,0,47,Tarnovia Tarnowo Podgórne,Sezon 2006/2007
2006-11-18 16:00,PBG Basket Poznań(d),76 : 84P,76,15,31,48.4,13,27,48.1,28,58,48.3,7,12,58.3,11,19,30,9,25,0,10,5,1,0,76,Tarnovia Tarnowo Podgórne,Sezon 2006/2007
2006-11-26 18:00,Siarka Tarnobrzeg(w),96 : 89P,89,31,46,67.4,5,18,27.8,36,64,56.3,12,15,80.0,7,18,25,20,31,0,20,9,1,0,93,Tarnovia Tarnowo Podgórne,Sezon 2006/2007
2006-12-03 18:00,Sportowiec Częstochowa(d),80 : 58W,80,22,36,61.1,8,22,36.4,30,58,51.7,12,15,80.0,13,22,35,7,24,0,16,8,3,0,86,Tarnovia Tarnowo Podgórne,Sezon 2006/2007
2006-12-09 17:00,Spójnia Stargard Szcz.(w),67 : 77W,77,26,45,57.8,5,16,31.3,31,61,50.8,10,11,90.9,11,26,37,11,28,0,11,7,1,0,91,Tarnovia Tarnowo Podgórne,Sezon 2006/2007
2006-12-16 18:30,Górnik Wałbrzych(w),65 : 55P,55,16,30,53.3,5,24,20.8,21,54,38.9,8,14,57.1,7,17,24,12,24,0,15,6,2,0,45,Tarnovia Tarnowo Podgórne,Sezon 2006/2007
2007-01-07 18:00,Resovia Rzeszów(d),78 : 74W,78,18,30,60.0,10,27,37.0,28,57,49.1,12,16,75.0,12,18,30,6,26,0,12,5,1,0,75,Tarnovia Tarnowo Podgórne,Sezon 2006/2007
2007-01-13 18:00,Znicz Basket Pruszków(w),64 : 73W,73,11,31,35.5,8,24,33.3,19,55,34.5,27,33,81.8,7,29,36,6,16,0,18,11,0,0,66,Tarnovia Tarnowo Podgórne,Sezon 2006/2007
2007-01-20 17:00,Stal Stalowa Wola(w),83 : 67P,67,21,37,56.8,7,23,30.4,28,60,46.7,4,7,57.1,4,21,25,8,20,0,15,6,0,0,56,Tarnovia Tarnowo Podgórne,Sezon 2006/2007
2007-01-28 16:00,MKS Start AZS Lublin(d),99 : 87W,99,22,35,62.9,13,25,52.0,35,60,58.3,16,21,76.2,4,13,17,7,25,0,13,14,0,0,94,Tarnovia Tarnowo Podgórne,Sezon 2006/2007
2007-02-03 17:00,Sportino Inowrocław(w),90 : 71P,71,13,32,40.6,9,27,33.3,22,59,37.3,18,21,85.7,9,13,22,14,24,0,11,10,2,0,68,Tarnovia Tarnowo Podgórne,Sezon 2006/2007
2007-02-11 16:00,Grono Zielona Góra(d),82 : 88P,82,13,30,43.3,15,33,45.5,28,63,44.4,11,15,73.3,5,27,32,8,25,0,8,2,1,0,78,Tarnovia Tarnowo Podgórne,Sezon 2006/2007
2007-02-14 18:00,Basket Kwidzyn(w),94 : 84P,84,22,33,66.7,8,22,36.4,30,55,54.5,16,21,76.2,3,16,19,8,25,0,18,7,1,0,71,Tarnovia Tarnowo Podgórne,Sezon 2006/2007
2007-02-18 16:00,PTG Sokół Łańcut(d),58 : 52W,58,15,33,45.5,5,21,23.8,20,54,37.0,13,17,76.5,6,29,35,4,15,0,10,6,1,0,56,Tarnovia Tarnowo Podgórne,Sezon 2006/2007
2007-02-24 17:00,PBG Basket Poznań(w),88 : 86P,86,22,40,55.0,8,23,34.8,30,63,47.6,18,19,94.7,9,19,28,5,18,0,15,8,2,0,80,Tarnovia Tarnowo Podgórne,Sezon 2006/2007
2007-03-04 16:00,Siarka Tarnobrzeg(d),77 : 60W,77,15,40,37.5,13,28,46.4,28,68,41.2,8,11,72.7,13,26,39,11,25,0,7,5,3,0,85,Tarnovia Tarnowo Podgórne,Sezon 2006/2007
2007-03-10 17:00,Sportowiec Częstochowa(w),75 : 80W,80,13,24,54.2,13,26,50.0,26,50,52.0,15,17,88.2,3,17,20,14,23,0,14,9,2,0,85,Tarnovia Tarnowo Podgórne,Sezon 2006/2007
2007-03-17 17:00,Spójnia Stargard Szcz.(d),72 : 80P,72,16,26,61.5,10,28,35.7,26,54,48.1,10,11,90.9,9,18,27,10,24,0,11,4,1,0,74,Tarnovia Tarnowo Podgórne,Sezon 2006/2007
2007-03-24 17:00,PBG Basket Poznań(w),88 : 90W,90,28,46,60.9,4,22,18.2,32,68,47.1,22,26,84.6,7,20,27,12,23,0,8,9,0,0,90,Tarnovia Tarnowo Podgórne,Sezon 2006/2007
2007-04-02 18:00,PBG Basket Poznań(d),85 : 78W,85,20,30,66.7,10,23,43.5,30,53,56.6,15,21,71.4,6,18,24,8,18,0,15,5,1,0,79,Tarnovia Tarnowo Podgórne,Sezon 2006/2007
2006-09-23 18:00,Grono Zielona Góra(w),66 : 56P,56,14,33,42.4,4,19,21.1,18,52,34.6,16,23,69.6,12,21,33,8,23,0,11,10,0,0,55,PBG Basket Poznań,Sezon 2006/2007
2006-09-30 17:00,Basket Kwidzyn(d),74 : 72W,74,21,46,45.7,7,22,31.8,28,68,41.2,11,14,78.6,17,23,40,7,17,0,10,10,0,0,78,PBG Basket Poznań,Sezon 2006/2007
2006-10-07 18:30,PTG Sokół Łańcut(w),79 : 67P,67,17,39,43.6,6,23,26.1,23,62,37.1,15,23,65.2,10,25,35,10,25,0,17,10,1,0,59,PBG Basket Poznań,Sezon 2006/2007
2006-10-14 18:00,Znicz Basket Pruszków(w),84 : 70P,70,18,29,62.1,9,26,34.6,27,55,49.1,7,8,87.5,11,15,26,10,21,0,20,4,1,0,62,PBG Basket Poznań,Sezon 2006/2007
2006-10-21 18:00,Siarka Tarnobrzeg(d),87 : 94P,87,31,52,59.6,3,18,16.7,34,70,48.6,16,23,69.6,11,26,37,14,29,0,22,10,3,0,86,PBG Basket Poznań,Sezon 2006/2007
2006-10-29 16:00,Sportowiec Częstochowa(w),97 : 87P,87,15,39,38.5,12,22,54.5,27,61,44.3,21,24,87.5,11,19,30,23,26,0,12,10,0,0,101,PBG Basket Poznań,Sezon 2006/2007
2006-11-04 18:00,Spójnia Stargard Szcz.(d),75 : 80P,75,26,52,50.0,4,12,33.3,30,64,46.9,11,17,64.7,12,23,35,11,16,0,13,8,1,0,77,PBG Basket Poznań,Sezon 2006/2007
2006-11-08 18:00,Górnik Wałbrzych(w),84 : 51P,51,12,32,37.5,7,21,33.3,19,53,35.8,6,8,75.0,4,14,18,9,26,0,18,5,1,0,30,PBG Basket Poznań,Sezon 2006/2007
2006-11-11 16:00,Resovia Rzeszów(d),70 : 82P,70,25,53,47.2,4,19,21.1,29,72,40.3,8,10,80.0,18,17,35,9,28,0,18,16,0,0,67,PBG Basket Poznań,Sezon 2006/2007
2006-11-18 16:00,Tarnovia Tarnowo Podgórne(w),76 : 84W,84,26,42,61.9,4,14,28.6,30,56,53.6,20,28,71.4,12,20,32,18,20,0,8,4,0,0,96,PBG Basket Poznań,Sezon 2006/2007
2006-11-27 16:00,Stal Stalowa Wola(d),97 : 94W,97,23,42,54.8,11,23,47.8,34,65,52.3,18,26,69.2,7,25,32,16,21,0,13,8,0,0,101,PBG Basket Poznań,Sezon 2006/2007
2006-12-02 18:00,MKS Start AZS Lublin(w),89 : 81P,81,18,37,48.6,10,37,27.0,28,74,37.8,15,18,83.3,8,24,32,10,26,0,15,14,3,0,76,PBG Basket Poznań,Sezon 2006/2007
2006-12-09 17:00,Sportino Inowrocław(d),102 : 86W,102,25,44,56.8,8,23,34.8,33,67,49.3,28,35,80.0,13,26,39,22,22,0,16,14,2,0,122,PBG Basket Poznań,Sezon 2006/2007
2006-12-16 18:00,Grono Zielona Góra(d),67 : 75P,67,16,34,47.1,8,30,26.7,24,64,37.5,11,14,78.6,11,24,35,15,20,0,15,4,3,0,66,PBG Basket Poznań,Sezon 2006/2007
2007-01-06 18:00,Basket Kwidzyn(w),101 : 49P,49,16,35,45.7,3,18,16.7,19,53,35.8,8,14,57.1,7,14,21,6,19,0,19,7,2,0,26,PBG Basket Poznań,Sezon 2006/2007
2007-01-13 17:00,PTG Sokół Łańcut(d),92 : 79W,92,28,57,49.1,8,18,44.4,36,75,48.0,12,17,70.6,13,23,36,19,19,0,15,12,1,0,101,PBG Basket Poznań,Sezon 2006/2007
2007-01-21 17:00,Znicz Basket Pruszków(d),118 : 115W,118,31,63,49.2,7,25,28.0,38,88,43.2,35,40,87.5,14,29,43,24,24,0,9,14,4,0,139,PBG Basket Poznań,Sezon 2006/2007
2007-01-27 17:00,Siarka Tarnobrzeg(w),83 : 70P,70,19,39,48.7,8,20,40.0,27,59,45.8,8,10,80.0,9,22,31,14,19,0,19,9,1,0,72,PBG Basket Poznań,Sezon 2006/2007
2007-02-03 17:00,Sportowiec Częstochowa(d),109 : 81W,109,26,49,53.1,14,24,58.3,40,73,54.8,15,20,75.0,12,32,44,27,24,0,16,11,0,0,137,PBG Basket Poznań,Sezon 2006/2007
2007-02-11 17:00,Spójnia Stargard Szcz.(w),67 : 66P,66,24,47,51.1,3,13,23.1,27,60,45.0,9,15,60.0,10,23,33,13,18,0,18,6,2,0,63,PBG Basket Poznań,Sezon 2006/2007
2007-02-14 16:00,Górnik Wałbrzych(d),78 : 80P,78,23,41,56.1,6,23,26.1,29,64,45.3,14,20,70.0,9,15,24,18,19,0,15,18,2,0,84,PBG Basket Poznań,Sezon 2006/2007
2007-02-17 17:30,Resovia Rzeszów(w),82 : 97W,97,26,40,65.0,8,22,36.4,34,62,54.8,21,24,87.5,10,19,29,18,25,0,14,8,1,0,108,PBG Basket Poznań,Sezon 2006/2007
2007-02-24 17:00,Tarnovia Tarnowo Podgórne(d),88 : 86W,88,29,49,59.2,6,13,46.2,35,62,56.5,12,18,66.7,10,23,33,13,18,0,14,12,3,0,102,PBG Basket Poznań,Sezon 2006/2007
2007-03-07 17:00,Stal Stalowa Wola(w),74 : 69P,69,16,54,29.6,6,14,42.9,22,68,32.4,19,27,70.4,13,28,41,11,19,0,16,10,10,0,71,PBG Basket Poznań,Sezon 2006/2007
2007-03-11 17:00,MKS Start AZS Lublin(d),92 : 74W,92,32,65,49.2,6,22,27.3,38,87,43.7,10,14,71.4,19,22,41,16,25,0,12,13,2,0,99,PBG Basket Poznań,Sezon 2006/2007
2007-03-15 18:00,Sportino Inowrocław(w),66 : 61P,61,12,38,31.6,4,14,28.6,16,52,30.8,25,30,83.3,5,24,29,6,24,0,13,10,5,0,57,PBG Basket Poznań,Sezon 2006/2007
2007-03-24 17:00,Tarnovia Tarnowo Podgórne(d),88 : 90P,88,28,48,58.3,3,11,27.3,31,59,52.5,23,29,79.3,8,29,37,16,27,0,19,6,2,0,96,PBG Basket Poznań,Sezon 2006/2007
2007-04-02 18:00,Tarnovia Tarnowo Podgórne(w),85 : 78P,78,22,42,52.4,7,12,58.3,29,54,53.7,13,16,81.3,6,17,23,11,21,0,16,6,2,0,76,PBG Basket Poznań,Sezon 2006/2007
2007-04-14 16:30,Spójnia Stargard Szcz.(w),69 : 55P,55,20,44,45.5,2,16,12.5,22,60,36.7,9,15,60.0,13,19,32,6,23,0,14,4,3,0,42,PBG Basket Poznań,Sezon 2006/2007
2007-04-19 18:00,Spójnia Stargard Szcz.(d),80 : 65W,80,26,66,39.4,5,11,45.5,31,77,40.3,13,16,81.3,15,28,43,11,20,0,11,10,4,0,88,PBG Basket Poznań,Sezon 2006/2007
2007-04-25 18:00,Spójnia Stargard Szcz.(w),67 : 70W,70,19,42,45.2,4,18,22.2,23,60,38.3,20,26,76.9,18,18,36,16,22,0,17,6,2,0,70,PBG Basket Poznań,Sezon 2006/2007
2006-09-23 17:30,Znicz Basket Pruszków(d),74 : 72W,74,21,41,51.2,4,18,22.2,25,59,42.4,20,33,60.6,11,25,36,20,22,0,10,7,4,0,84,Resovia Rzeszów,Sezon 2006/2007
2006-09-30 17:00,Tarnovia Tarnowo Podgórne(d),92 : 81W,92,20,44,45.5,6,12,50.0,26,56,46.4,34,42,81.0,7,22,29,19,27,0,11,14,3,0,108,Resovia Rzeszów,Sezon 2006/2007
2006-10-07 17:00,Stal Stalowa Wola(w),97 : 71P,71,21,47,44.7,4,11,36.4,25,58,43.1,17,29,58.6,5,13,18,11,27,0,12,9,2,0,54,Resovia Rzeszów,Sezon 2006/2007
2006-10-15 17:00,MKS Start AZS Lublin(d),89 : 70W,89,23,36,63.9,7,21,33.3,30,57,52.6,22,32,68.8,8,20,28,16,23,0,16,15,4,0,99,Resovia Rzeszów,Sezon 2006/2007
2006-10-21 18:00,Sportino Inowrocław(w),90 : 84P,84,22,43,51.2,5,16,31.3,27,59,45.8,25,30,83.3,10,16,26,14,24,0,14,12,7,0,92,Resovia Rzeszów,Sezon 2006/2007
2006-10-29 17:30,Grono Zielona Góra(d),66 : 70P,66,18,34,52.9,7,16,43.8,25,50,50.0,9,13,69.2,4,18,22,11,21,0,15,10,2,0,67,Resovia Rzeszów,Sezon 2006/2007
2006-11-04 18:00,Basket Kwidzyn(w),79 : 95W,95,19,39,48.7,11,19,57.9,30,58,51.7,24,29,82.8,6,23,29,13,14,0,14,7,0,0,97,Resovia Rzeszów,Sezon 2006/2007
2006-11-08 18:00,PTG Sokół Łańcut(d),51 : 58P,51,13,33,39.4,2,18,11.1,15,51,29.4,19,26,73.1,5,18,23,9,20,0,13,12,4,0,43,Resovia Rzeszów,Sezon 2006/2007
2006-11-11 16:00,PBG Basket Poznań(w),70 : 82W,82,20,35,57.1,7,14,50.0,27,49,55.1,21,27,77.8,6,20,26,10,16,0,21,12,4,0,85,Resovia Rzeszów,Sezon 2006/2007
2006-11-18 17:30,Siarka Tarnobrzeg(d),84 : 82W,84,25,44,56.8,7,17,41.2,32,61,52.5,13,21,61.9,10,21,31,16,23,0,19,9,4,0,88,Resovia Rzeszów,Sezon 2006/2007
2006-11-26 17:00,Sportowiec Częstochowa(w),92 : 86P,86,21,42,50.0,7,19,36.8,28,61,45.9,23,30,76.7,8,27,35,18,31,0,20,11,4,0,94,Resovia Rzeszów,Sezon 2006/2007
2006-12-02 17:30,Spójnia Stargard Szcz.(d),96 : 72W,96,28,47,59.6,11,19,57.9,39,66,59.1,7,9,77.8,9,23,32,25,16,0,10,10,6,0,130,Resovia Rzeszów,Sezon 2006/2007
2006-12-09 17:00,Górnik Wałbrzych(w),75 : 63P,63,14,32,43.8,8,25,32.0,22,57,38.6,11,16,68.8,2,20,22,10,17,0,11,12,6,0,62,Resovia Rzeszów,Sezon 2006/2007
2006-12-16 18:00,Znicz Basket Pruszków(w),83 : 72P,72,21,43,48.8,6,27,22.2,27,70,38.6,12,22,54.5,16,22,38,16,24,0,18,10,4,0,69,Resovia Rzeszów,Sezon 2006/2007
2007-01-07 18:00,Tarnovia Tarnowo Podgórne(w),78 : 74P,74,27,43,62.8,1,9,11.1,28,52,53.8,17,23,73.9,5,13,18,5,16,0,13,7,1,0,62,Resovia Rzeszów,Sezon 2006/2007
2007-01-13 17:30,Stal Stalowa Wola(d),76 : 75W,76,22,46,47.8,5,18,27.8,27,64,42.2,17,25,68.0,9,17,26,11,23,0,18,9,1,0,60,Resovia Rzeszów,Sezon 2006/2007
2007-01-20 17:00,MKS Start AZS Lublin(w),84 : 80P,80,11,30,36.7,10,27,37.0,21,57,36.8,28,33,84.8,4,23,27,11,20,0,17,11,2,0,73,Resovia Rzeszów,Sezon 2006/2007
2007-01-27 17:30,Sportino Inowrocław(d),97 : 103P,97,23,37,62.2,8,25,32.0,31,62,50.0,27,37,73.0,5,22,27,21,30,0,23,11,0,0,92,Resovia Rzeszów,Sezon 2006/2007
2007-02-03 17:30,Grono Zielona Góra(w),82 : 46P,46,9,32,28.1,1,20,5.0,10,52,19.2,25,36,69.4,4,21,25,4,21,0,16,10,2,0,18,Resovia Rzeszów,Sezon 2006/2007
2007-02-10 17:30,Basket Kwidzyn(d),77 : 96P,77,22,41,53.7,5,11,45.5,27,52,51.9,18,20,90.0,2,17,19,13,18,0,15,6,4,0,77,Resovia Rzeszów,Sezon 2006/2007
2007-02-14 18:30,PTG Sokół Łańcut(w),76 : 90W,90,25,43,58.1,7,16,43.8,32,59,54.2,19,23,82.6,3,24,27,15,21,0,11,18,3,0,111,Resovia Rzeszów,Sezon 2006/2007
2007-02-17 17:30,PBG Basket Poznań(d),82 : 97P,82,22,37,59.5,6,18,33.3,28,55,50.9,20,27,74.1,2,10,12,15,22,0,15,11,4,0,75,Resovia Rzeszów,Sezon 2006/2007
2007-02-24 19:00,Siarka Tarnobrzeg(w),84 : 87W,87,27,45,60.0,7,15,46.7,34,60,56.7,12,21,57.1,7,17,24,13,25,0,17,14,5,0,91,Resovia Rzeszów,Sezon 2006/2007
2007-03-07 18:00,Sportowiec Częstochowa(d),65 : 72P,65,22,45,48.9,4,16,25.0,26,61,42.6,9,15,60.0,6,20,26,9,21,0,15,12,3,0,59,Resovia Rzeszów,Sezon 2006/2007
2007-03-11 17:00,Spójnia Stargard Szcz.(w),62 : 88W,88,24,36,66.7,8,17,47.1,32,53,60.4,16,26,61.5,5,31,36,12,23,0,15,8,3,0,101,Resovia Rzeszów,Sezon 2006/2007
2007-03-17 17:00,Górnik Wałbrzych(d),95 : 83W,95,25,43,58.1,7,19,36.8,32,62,51.6,24,29,82.8,2,14,16,16,20,0,11,14,6,0,101,Resovia Rzeszów,Sezon 2006/2007
2007-03-24 17:00,Grono Zielona Góra(w),77 : 58P,58,12,39,30.8,5,17,29.4,17,56,30.4,19,33,57.6,14,14,28,5,17,0,17,9,1,0,31,Resovia Rzeszów,Sezon 2006/2007
2007-03-25 17:00,Grono Zielona Góra(w),84 : 69P,69,14,35,40.0,8,18,44.4,22,53,41.5,17,25,68.0,5,15,20,7,22,0,16,11,0,0,52,Resovia Rzeszów,Sezon 2006/2007
2007-04-03 18:00,Grono Zielona Góra(d),64 : 74P,64,14,29,48.3,3,12,25.0,17,41,41.5,27,41,65.9,6,27,33,8,19,0,23,8,2,0,54,Resovia Rzeszów,Sezon 2006/2007
2006-09-23 16:30,MKS Start AZS Lublin(w),73 : 80W,80,21,49,42.9,4,18,22.2,25,67,37.3,26,38,68.4,12,27,39,12,19,0,17,17,0,0,77,Sportowiec Częstochowa,Sezon 2006/2007
2006-09-30 18:00,Sportino Inowrocław(d),103 : 105P,103,29,48,60.4,5,22,22.7,34,70,48.6,30,37,81.1,10,23,33,21,28,0,16,13,3,0,114,Sportowiec Częstochowa,Sezon 2006/2007
2006-10-07 18:00,Grono Zielona Góra(w),67 : 48P,48,18,44,40.9,1,13,7.7,19,57,33.3,9,15,60.0,9,14,23,7,19,0,18,14,0,0,30,Sportowiec Częstochowa,Sezon 2006/2007
2006-10-14 17:00,Basket Kwidzyn(d),85 : 95P,85,24,43,55.8,7,23,30.4,31,66,47.0,16,21,76.2,10,23,33,22,23,0,17,9,1,0,93,Sportowiec Częstochowa,Sezon 2006/2007
2006-10-21 18:00,PTG Sokół Łańcut(w),88 : 93W,93,28,51,54.9,6,12,50.0,34,63,54.0,19,28,67.9,12,27,39,21,25,0,16,8,2,0,109,Sportowiec Częstochowa,Sezon 2006/2007
2006-10-29 16:00,PBG Basket Poznań(d),97 : 87W,97,27,38,71.1,7,17,41.2,34,55,61.8,22,32,68.8,8,22,30,23,24,0,14,12,3,0,120,Sportowiec Częstochowa,Sezon 2006/2007
2006-11-05 18:00,Siarka Tarnobrzeg(w),81 : 78P,78,26,43,60.5,5,15,33.3,31,58,53.4,11,14,78.6,11,22,33,15,21,0,24,11,0,0,83,Sportowiec Częstochowa,Sezon 2006/2007
2006-11-08 18:00,Znicz Basket Pruszków(w),86 : 98W,98,25,44,56.8,6,16,37.5,31,60,51.7,30,38,78.9,12,28,40,11,26,0,23,9,2,0,100,Sportowiec Częstochowa,Sezon 2006/2007
2006-11-11 17:00,Spójnia Stargard Szcz.(d),89 : 92P,89,24,49,49.0,6,14,42.9,30,63,47.6,23,28,82.1,18,25,43,16,25,0,13,7,1,0,105,Sportowiec Częstochowa,Sezon 2006/2007
2006-11-18 16:00,Górnik Wałbrzych(w),80 : 75P,75,23,46,50.0,4,20,20.0,27,66,40.9,17,23,73.9,6,24,30,17,29,0,12,17,3,0,85,Sportowiec Częstochowa,Sezon 2006/2007
2006-11-26 17:00,Resovia Rzeszów(d),92 : 86W,92,30,59,50.8,4,19,21.1,34,78,43.6,20,28,71.4,21,31,52,20,26,0,11,18,3,0,122,Sportowiec Częstochowa,Sezon 2006/2007
2006-12-03 18:00,Tarnovia Tarnowo Podgórne(w),80 : 58P,58,17,41,41.5,3,7,42.9,20,48,41.7,15,20,75.0,5,8,13,3,19,0,14,15,0,0,42,Sportowiec Częstochowa,Sezon 2006/2007
2006-12-09 17:00,Stal Stalowa Wola(w),83 : 65P,65,22,57,38.6,6,21,28.6,28,78,35.9,3,7,42.9,14,16,30,9,19,0,15,11,4,0,50,Sportowiec Częstochowa,Sezon 2006/2007
2007-01-06 18:00,Sportino Inowrocław(w),95 : 74P,74,23,53,43.4,5,11,45.5,28,64,43.8,13,16,81.3,9,18,27,15,15,0,20,12,4,0,73,Sportowiec Częstochowa,Sezon 2006/2007
2007-01-14 16:00,Grono Zielona Góra(d),59 : 81P,59,14,35,40.0,5,16,31.3,19,51,37.3,16,20,80.0,10,24,34,16,16,0,14,10,4,0,73,Sportowiec Częstochowa,Sezon 2006/2007
2007-01-20 18:00,Basket Kwidzyn(w),80 : 78P,78,17,37,45.9,10,22,45.5,27,59,45.8,14,15,93.3,8,22,30,7,21,0,18,8,2,0,74,Sportowiec Częstochowa,Sezon 2006/2007
2007-01-28 16:00,PTG Sokół Łańcut(d),84 : 92P,84,25,47,53.2,6,17,35.3,31,64,48.4,16,23,69.6,18,17,35,22,20,0,8,10,1,0,104,Sportowiec Częstochowa,Sezon 2006/2007
2007-02-03 17:00,PBG Basket Poznań(w),109 : 81P,81,19,46,41.3,8,26,30.8,27,72,37.5,19,29,65.5,12,17,29,10,20,0,15,10,2,0,62,Sportowiec Częstochowa,Sezon 2006/2007
2007-02-11 16:00,Siarka Tarnobrzeg(d),76 : 86P,76,23,47,48.9,6,17,35.3,29,64,45.3,12,12,100.0,9,28,37,18,24,0,8,12,3,0,103,Sportowiec Częstochowa,Sezon 2006/2007
2007-02-14 19:00,Znicz Basket Pruszków(d),88 : 91P,88,21,44,47.7,10,26,38.5,31,70,44.3,16,19,84.2,14,26,40,25,25,0,8,8,2,0,113,Sportowiec Częstochowa,Sezon 2006/2007
2007-02-17 17:00,Spójnia Stargard Szcz.(w),73 : 84W,84,21,41,51.2,7,18,38.9,28,59,47.5,21,30,70.0,10,19,29,11,19,0,13,14,2,0,87,Sportowiec Częstochowa,Sezon 2006/2007
2007-02-24 17:00,Górnik Wałbrzych(d),81 : 80W,81,13,37,35.1,10,33,30.3,23,70,32.9,25,29,86.2,17,18,35,17,18,0,11,15,1,0,87,Sportowiec Częstochowa,Sezon 2006/2007
2007-03-07 18:00,Resovia Rzeszów(w),65 : 72W,72,24,49,49.0,5,16,31.3,29,65,44.6,9,13,69.2,11,27,38,13,19,0,21,11,0,0,73,Sportowiec Częstochowa,Sezon 2006/2007
2007-03-10 17:00,Tarnovia Tarnowo Podgórne(d),75 : 80P,75,26,49,53.1,4,11,36.4,30,60,50.0,11,13,84.6,9,22,31,16,18,0,10,13,2,0,95,Sportowiec Częstochowa,Sezon 2006/2007
2007-03-17 17:00,Stal Stalowa Wola(d),103 : 79W,103,36,56,64.3,6,20,30.0,42,76,55.3,13,19,68.4,12,19,31,26,20,0,13,16,3,0,126,Sportowiec Częstochowa,Sezon 2006/2007
2007-03-24 17:00,Spójnia Stargard Szcz.(w),69 : 84W,84,20,41,48.8,8,14,57.1,28,55,50.9,20,29,69.0,7,22,29,12,21,0,9,6,0,0,86,Sportowiec Częstochowa,Sezon 2006/2007
2007-04-01 17:00,Spójnia Stargard Szcz.(d),84 : 76W,84,23,49,46.9,5,18,27.8,28,67,41.8,23,26,88.5,19,28,47,11,19,0,14,13,2,0,101,Sportowiec Częstochowa,Sezon 2006/2007
2006-09-23 16:30,Sportowiec Częstochowa(d),73 : 80P,73,20,37,54.1,6,28,21.4,26,65,40.0,15,24,62.5,10,26,36,19,30,0,20,13,3,0,76,MKS Start AZS Lublin,Sezon 2006/2007
2006-09-27 17:00,Spójnia Stargard Szcz.(d),68 : 71P,68,22,44,50.0,3,17,17.6,25,61,41.0,15,25,60.0,12,28,40,9,23,0,16,12,2,0,69,MKS Start AZS Lublin,Sezon 2006/2007
2006-10-08 18:00,Górnik Wałbrzych(d),63 : 74P,63,15,26,57.7,4,29,13.8,19,55,34.5,21,34,61.8,7,26,33,7,33,0,20,9,3,0,46,MKS Start AZS Lublin,Sezon 2006/2007
2006-10-15 17:00,Resovia Rzeszów(w),89 : 70P,70,13,26,50.0,9,26,34.6,22,52,42.3,17,20,85.0,6,15,21,8,26,0,14,7,2,0,61,MKS Start AZS Lublin,Sezon 2006/2007
2006-10-22 17:00,Tarnovia Tarnowo Podgórne(d),93 : 81W,93,29,43,67.4,5,15,33.3,34,58,58.6,20,30,66.7,4,27,31,17,24,0,15,11,0,0,103,MKS Start AZS Lublin,Sezon 2006/2007
2006-10-28 18:00,Stal Stalowa Wola(w),72 : 75W,75,22,42,52.4,3,14,21.4,25,56,44.6,22,31,71.0,9,29,38,11,29,0,18,7,1,0,74,MKS Start AZS Lublin,Sezon 2006/2007
2006-11-04 18:00,Znicz Basket Pruszków(d),70 : 72P,70,17,42,40.5,6,16,37.5,23,58,39.7,18,29,62.1,14,24,38,12,18,0,18,17,1,0,74,MKS Start AZS Lublin,Sezon 2006/2007
2006-11-08 18:00,Sportino Inowrocław(d),55 : 56P,55,10,35,28.6,8,29,27.6,18,64,28.1,11,16,68.8,19,29,48,12,16,0,14,9,3,0,62,MKS Start AZS Lublin,Sezon 2006/2007
2006-11-11 16:00,Grono Zielona Góra(w),63 : 39P,39,9,22,40.9,4,17,23.5,13,39,33.3,9,12,75.0,4,17,21,7,16,0,19,9,2,0,30,MKS Start AZS Lublin,Sezon 2006/2007
2006-11-19 17:00,Basket Kwidzyn(d),94 : 87W,94,28,39,71.8,6,20,30.0,34,59,57.6,20,33,60.6,7,25,32,17,18,0,12,11,2,0,106,MKS Start AZS Lublin,Sezon 2006/2007
2006-11-26 17:30,PTG Sokół Łańcut(w),92 : 51P,51,13,31,41.9,6,22,27.3,19,53,35.8,7,11,63.6,10,23,33,10,21,0,28,4,1,0,33,MKS Start AZS Lublin,Sezon 2006/2007
2006-12-02 18:00,PBG Basket Poznań(d),89 : 81W,89,25,47,53.2,7,25,28.0,32,72,44.4,18,27,66.7,12,35,47,25,16,0,20,13,0,0,105,MKS Start AZS Lublin,Sezon 2006/2007
2006-12-10 17:00,Siarka Tarnobrzeg(w),86 : 89W,89,18,26,69.2,11,28,39.3,29,54,53.7,20,22,90.9,8,20,28,14,20,0,21,7,3,0,93,MKS Start AZS Lublin,Sezon 2006/2007
2007-01-06 17:00,Spójnia Stargard Szcz.(w),76 : 70P,70,16,33,48.5,7,25,28.0,23,58,39.7,17,22,77.3,10,22,32,10,21,0,14,9,1,0,68,MKS Start AZS Lublin,Sezon 2006/2007
2007-01-13 16:30,Górnik Wałbrzych(w),86 : 101W,101,23,39,59.0,11,24,45.8,34,63,54.0,22,33,66.7,7,26,33,23,21,0,16,12,0,0,113,MKS Start AZS Lublin,Sezon 2006/2007
2007-01-20 17:00,Resovia Rzeszów(d),84 : 80W,84,19,36,52.8,10,24,41.7,29,60,48.3,16,20,80.0,8,28,36,16,26,0,19,11,3,0,96,MKS Start AZS Lublin,Sezon 2006/2007
2007-01-28 16:00,Tarnovia Tarnowo Podgórne(w),99 : 87P,87,31,46,67.4,2,9,22.2,33,55,60.0,19,28,67.9,10,19,29,6,22,0,14,8,1,0,86,MKS Start AZS Lublin,Sezon 2006/2007
2007-02-03 17:00,Stal Stalowa Wola(d),93 : 99P,93,27,56,48.2,7,18,38.9,34,74,45.9,18,23,78.3,13,28,41,18,27,0,18,11,3,0,103,MKS Start AZS Lublin,Sezon 2006/2007
2007-02-10 18:00,Znicz Basket Pruszków(w),91 : 96W,96,22,38,57.9,8,23,34.8,30,61,49.2,28,39,71.8,13,25,38,16,25,0,18,9,1,0,100,MKS Start AZS Lublin,Sezon 2006/2007
2007-02-14 18:00,Sportino Inowrocław(w),84 : 71P,71,21,37,56.8,7,21,33.3,28,58,48.3,8,12,66.7,8,21,29,20,19,0,18,7,1,0,76,MKS Start AZS Lublin,Sezon 2006/2007
2007-02-17 15:30,Grono Zielona Góra(d),68 : 72P,68,14,29,48.3,6,16,37.5,20,45,44.4,22,32,68.8,9,28,37,12,20,0,19,6,2,0,71,MKS Start AZS Lublin,Sezon 2006/2007
2007-02-25 18:00,Basket Kwidzyn(w),83 : 76P,76,19,31,61.3,5,20,25.0,24,51,47.1,23,30,76.7,7,27,34,11,20,0,18,7,2,0,78,MKS Start AZS Lublin,Sezon 2006/2007
2007-03-07 17:00,PTG Sokół Łańcut(d),74 : 70W,74,17,35,48.6,4,20,20.0,21,55,38.2,28,38,73.7,13,24,37,12,20,0,15,9,2,0,75,MKS Start AZS Lublin,Sezon 2006/2007
2007-03-11 17:00,PBG Basket Poznań(w),92 : 74P,74,22,36,61.1,4,25,16.0,26,61,42.6,18,23,78.3,7,24,31,13,13,0,15,5,3,0,71,MKS Start AZS Lublin,Sezon 2006/2007
2007-03-17 17:00,Siarka Tarnobrzeg(d),92 : 77W,92,33,53,62.3,6,23,26.1,39,76,51.3,8,14,57.1,11,27,38,23,14,0,10,13,4,0,117,MKS Start AZS Lublin,Sezon 2006/2007
2006-09-23 17:30,Resovia Rzeszów(w),74 : 72P,72,20,37,54.1,8,27,29.6,28,64,43.8,8,15,53.3,8,22,30,13,30,0,11,6,2,0,69,Znicz Basket Pruszków,Sezon 2006/2007
2006-09-30 18:00,PTG Sokół Łańcut(d),68 : 72P,68,16,39,41.0,5,26,19.2,21,65,32.3,21,28,75.0,14,17,31,9,30,0,24,13,2,0,48,Znicz Basket Pruszków,Sezon 2006/2007
2006-10-07 16:00,Tarnovia Tarnowo Podgórne(w),84 : 90W,90,23,42,54.8,5,13,38.5,28,55,50.9,29,43,67.4,6,19,25,11,22,0,9,4,1,0,81,Znicz Basket Pruszków,Sezon 2006/2007
2006-10-14 18:00,PBG Basket Poznań(d),84 : 70W,84,22,39,56.4,7,20,35.0,29,59,49.2,19,23,82.6,10,12,22,16,14,0,11,10,0,0,87,Znicz Basket Pruszków,Sezon 2006/2007
2006-10-21 18:00,Stal Stalowa Wola(w),92 : 94W,94,24,45,53.3,7,20,35.0,31,65,47.7,25,35,71.4,7,21,28,12,28,0,13,11,1,0,89,Znicz Basket Pruszków,Sezon 2006/2007
2006-10-28 18:00,Siarka Tarnobrzeg(d),84 : 72W,84,24,43,55.8,7,17,41.2,31,60,51.7,15,19,78.9,8,23,31,19,26,0,19,13,1,0,96,Znicz Basket Pruszków,Sezon 2006/2007
2006-11-04 18:00,MKS Start AZS Lublin(w),70 : 72W,72,16,30,53.3,10,27,37.0,26,57,45.6,10,15,66.7,7,21,28,20,28,0,19,12,3,0,80,Znicz Basket Pruszków,Sezon 2006/2007
2006-11-08 18:00,Sportowiec Częstochowa(d),86 : 98P,86,18,39,46.2,11,32,34.4,29,71,40.8,17,28,60.7,10,19,29,18,32,0,15,16,3,0,84,Znicz Basket Pruszków,Sezon 2006/2007
2006-11-11 17:30,Sportino Inowrocław(w),89 : 96W,96,20,34,58.8,11,27,40.7,31,61,50.8,23,30,76.7,9,20,29,23,30,0,13,12,8,0,118,Znicz Basket Pruszków,Sezon 2006/2007
2006-11-18 17:00,Spójnia Stargard Szcz.(w),74 : 77W,77,24,41,58.5,4,14,28.6,28,55,50.9,17,23,73.9,12,22,34,16,19,0,21,10,1,0,84,Znicz Basket Pruszków,Sezon 2006/2007
2006-11-26 19:00,Grono Zielona Góra(w),63 : 72W,72,23,32,71.9,4,16,25.0,27,48,56.3,14,23,60.9,6,23,29,12,23,0,16,11,3,0,81,Znicz Basket Pruszków,Sezon 2006/2007
2006-12-02 18:00,Górnik Wałbrzych(d),71 : 80P,71,12,22,54.5,7,25,28.0,19,47,40.4,26,33,78.8,5,17,22,11,27,0,18,9,2,0,62,Znicz Basket Pruszków,Sezon 2006/2007
2006-12-09 18:00,Basket Kwidzyn(w),92 : 83P,83,20,29,69.0,9,24,37.5,29,53,54.7,16,19,84.2,6,25,31,13,19,0,11,3,1,0,93,Znicz Basket Pruszków,Sezon 2006/2007
2006-12-16 18:00,Resovia Rzeszów(d),83 : 72W,83,18,39,46.2,8,30,26.7,26,69,37.7,23,28,82.1,13,26,39,15,25,0,14,9,1,0,85,Znicz Basket Pruszków,Sezon 2006/2007
2007-01-06 17:30,PTG Sokół Łańcut(w),63 : 70W,70,17,40,42.5,5,20,25.0,22,60,36.7,21,24,87.5,6,27,33,19,21,0,11,15,3,0,88,Znicz Basket Pruszków,Sezon 2006/2007
2007-01-13 18:00,Tarnovia Tarnowo Podgórne(d),64 : 73P,64,19,38,50.0,4,17,23.5,23,55,41.8,14,20,70.0,3,28,31,14,21,0,20,10,1,0,62,Znicz Basket Pruszków,Sezon 2006/2007
2007-01-21 17:00,PBG Basket Poznań(w),118 : 115P,115,27,50,54.0,12,29,41.4,39,79,49.4,25,31,80.6,12,33,45,16,35,0,22,7,3,0,118,Znicz Basket Pruszków,Sezon 2006/2007
2007-01-26 19:00,Stal Stalowa Wola(d),87 : 89P,87,25,53,47.2,6,17,35.3,31,70,44.3,19,27,70.4,15,21,36,13,27,0,14,7,4,0,86,Znicz Basket Pruszków,Sezon 2006/2007
2007-02-04 17:00,Siarka Tarnobrzeg(w),82 : 93W,93,25,44,56.8,7,18,38.9,32,62,51.6,22,27,81.5,11,24,35,19,28,0,19,8,1,0,102,Znicz Basket Pruszków,Sezon 2006/2007
2007-02-10 18:00,MKS Start AZS Lublin(d),91 : 96P,91,17,32,53.1,11,32,34.4,28,64,43.8,24,31,77.4,9,15,24,18,29,0,15,12,0,0,87,Znicz Basket Pruszków,Sezon 2006/2007
2007-02-14 19:00,Sportowiec Częstochowa(w),88 : 91W,91,22,35,62.9,7,22,31.8,29,57,50.9,26,34,76.5,9,27,36,21,21,0,11,7,2,0,110,Znicz Basket Pruszków,Sezon 2006/2007
2007-02-18 18:00,Sportino Inowrocław(d),63 : 74P,63,15,31,48.4,8,21,38.1,23,52,44.2,9,12,75.0,7,17,24,14,14,0,24,11,5,0,61,Znicz Basket Pruszków,Sezon 2006/2007
2007-02-24 18:00,Spójnia Stargard Szcz.(d),81 : 64W,81,25,39,64.1,6,24,25.0,31,63,49.2,13,21,61.9,10,21,31,18,30,0,15,14,3,0,92,Znicz Basket Pruszków,Sezon 2006/2007
2007-02-28 19:00,Grono Zielona Góra(d),67 : 86P,67,14,30,46.7,8,26,30.8,22,56,39.3,15,23,65.2,3,23,26,5,24,0,18,11,4,0,53,Znicz Basket Pruszków,Sezon 2006/2007
2007-03-11 17:00,Górnik Wałbrzych(w),92 : 70P,70,21,43,48.8,3,16,18.8,24,59,40.7,19,25,76.0,7,9,16,10,22,0,22,9,5,0,47,Znicz Basket Pruszków,Sezon 2006/2007
2007-03-14 19:00,Basket Kwidzyn(d),60 : 88P,60,13,33,39.4,5,26,19.2,18,59,30.5,19,28,67.9,7,23,30,11,18,0,17,11,1,0,46,Znicz Basket Pruszków,Sezon 2006/2007
2007-03-24 17:00,Basket Kwidzyn(w),109 : 67P,67,18,33,54.5,4,23,17.4,22,56,39.3,19,27,70.4,7,16,23,10,26,0,24,9,1,0,44,Znicz Basket Pruszków,Sezon 2006/2007
2007-03-25 17:00,Basket Kwidzyn(w),99 : 67P,67,15,30,50.0,3,18,16.7,18,48,37.5,28,36,77.8,7,21,28,10,25,0,25,9,2,0,53,Znicz Basket Pruszków,Sezon 2006/2007
2007-03-31 17:00,Basket Kwidzyn(d),95 : 79W,95,21,32,65.6,7,20,35.0,28,52,53.8,32,38,84.2,9,26,35,20,24,0,18,13,3,0,118,Znicz Basket Pruszków,Sezon 2006/2007
2007-04-01 17:00,Basket Kwidzyn(d),86 : 84W,86,17,36,47.2,8,21,38.1,25,57,43.9,28,44,63.6,9,20,29,12,24,0,10,8,2,0,79,Znicz Basket Pruszków,Sezon 2006/2007
2007-04-04 18:00,Basket Kwidzyn(w),92 : 85P,85,19,28,67.9,8,23,34.8,27,51,52.9,23,28,82.1,3,16,19,13,21,0,19,9,2,0,80,Znicz Basket Pruszków,Sezon 2006/2007
2006-09-23 18:30,PTG Sokół Łańcut(d),65 : 63W,65,20,41,48.8,6,17,35.3,26,58,44.8,7,11,63.6,13,21,34,16,19,0,14,8,1,0,74,Basket Kwidzyn,Sezon 2006/2007
2006-09-30 17:00,PBG Basket Poznań(w),74 : 72P,72,24,42,57.1,4,21,19.0,28,63,44.4,12,16,75.0,10,20,30,7,18,0,7,9,1,0,73,Basket Kwidzyn,Sezon 2006/2007
2006-10-08 18:00,Siarka Tarnobrzeg(d),91 : 66W,91,33,51,64.7,3,15,20.0,36,66,54.5,16,22,72.7,11,26,37,21,28,0,10,11,3,0,117,Basket Kwidzyn,Sezon 2006/2007
2006-10-14 17:00,Sportowiec Częstochowa(w),85 : 95W,95,21,38,55.3,9,20,45.0,30,58,51.7,26,33,78.8,8,24,32,18,21,0,13,13,0,0,110,Basket Kwidzyn,Sezon 2006/2007
2006-10-21 18:00,Spójnia Stargard Szcz.(d),64 : 67P,64,20,46,43.5,3,16,18.8,23,62,37.1,15,22,68.2,10,26,36,13,19,0,12,9,0,0,64,Basket Kwidzyn,Sezon 2006/2007
2006-10-28 16:00,Górnik Wałbrzych(w),76 : 78W,78,27,48,56.3,2,15,13.3,29,63,46.0,18,23,78.3,8,19,27,16,20,0,5,11,2,0,90,Basket Kwidzyn,Sezon 2006/2007
2006-11-04 18:00,Resovia Rzeszów(d),79 : 95P,79,28,47,59.6,4,19,21.1,32,66,48.5,11,13,84.6,8,21,29,18,29,0,13,11,1,0,89,Basket Kwidzyn,Sezon 2006/2007
2006-11-11 18:00,Stal Stalowa Wola(d),75 : 58W,75,25,45,55.6,4,10,40.0,29,55,52.7,13,18,72.2,7,20,27,16,21,0,13,10,4,0,88,Basket Kwidzyn,Sezon 2006/2007
2006-11-15 18:00,Tarnovia Tarnowo Podgórne(w),66 : 78W,78,17,26,65.4,8,20,40.0,25,46,54.3,20,28,71.4,8,15,23,7,23,0,7,3,3,0,78,Basket Kwidzyn,Sezon 2006/2007
2006-11-19 17:00,MKS Start AZS Lublin(w),94 : 87P,87,22,39,56.4,9,27,33.3,31,66,47.0,16,20,80.0,9,20,29,17,29,0,15,11,1,0,91,Basket Kwidzyn,Sezon 2006/2007
2006-11-26 18:00,Sportino Inowrocław(d),70 : 67W,70,13,29,44.8,8,22,36.4,21,51,41.2,20,29,69.0,8,21,29,14,19,0,15,9,0,0,68,Basket Kwidzyn,Sezon 2006/2007
2006-12-02 18:30,Grono Zielona Góra(w),67 : 58P,58,15,39,38.5,6,19,31.6,21,58,36.2,10,16,62.5,9,22,31,10,20,0,5,6,3,0,60,Basket Kwidzyn,Sezon 2006/2007
2006-12-09 18:00,Znicz Basket Pruszków(d),92 : 83W,92,24,37,64.9,8,24,33.3,32,61,52.5,20,21,95.2,3,19,22,12,21,0,5,6,2,0,99,Basket Kwidzyn,Sezon 2006/2007
2006-12-16 18:30,PTG Sokół Łańcut(w),78 : 70P,70,20,42,47.6,5,23,21.7,25,65,38.5,15,22,68.2,14,23,37,12,21,0,13,3,3,0,65,Basket Kwidzyn,Sezon 2006/2007
2007-01-06 18:00,PBG Basket Poznań(d),101 : 49W,101,34,48,70.8,8,16,50.0,42,64,65.6,9,14,64.3,8,26,34,26,16,0,14,13,1,0,134,Basket Kwidzyn,Sezon 2006/2007
2007-01-13 17:00,Siarka Tarnobrzeg(w),85 : 72P,72,21,43,48.8,5,30,16.7,26,73,35.6,15,19,78.9,11,19,30,8,20,0,14,10,3,0,58,Basket Kwidzyn,Sezon 2006/2007
2007-01-20 18:00,Sportowiec Częstochowa(d),80 : 78W,80,32,51,62.7,3,15,20.0,35,66,53.0,7,17,41.2,11,20,31,17,21,0,10,12,5,0,94,Basket Kwidzyn,Sezon 2006/2007
2007-01-27 17:00,Spójnia Stargard Szcz.(w),68 : 62P,62,16,46,34.8,6,18,33.3,22,64,34.4,12,14,85.7,9,29,38,7,23,0,14,7,1,0,57,Basket Kwidzyn,Sezon 2006/2007
2007-02-04 18:45,Górnik Wałbrzych(d),87 : 64W,87,23,35,65.7,7,21,33.3,30,56,53.6,20,27,74.1,9,19,28,18,27,0,14,15,0,0,101,Basket Kwidzyn,Sezon 2006/2007
2007-02-10 17:30,Resovia Rzeszów(w),77 : 96W,96,26,46,56.5,9,17,52.9,35,63,55.6,17,18,94.4,4,21,25,18,23,0,6,8,1,0,113,Basket Kwidzyn,Sezon 2006/2007
2007-02-14 18:00,Tarnovia Tarnowo Podgórne(d),94 : 84W,94,32,48,66.7,4,13,30.8,36,61,59.0,18,23,78.3,5,23,28,11,29,0,14,12,2,0,103,Basket Kwidzyn,Sezon 2006/2007
2007-02-17 17:00,Stal Stalowa Wola(w),62 : 93W,93,30,48,62.5,2,14,14.3,32,62,51.6,27,30,90.0,6,23,29,11,16,0,11,13,2,0,104,Basket Kwidzyn,Sezon 2006/2007
2007-02-25 18:00,MKS Start AZS Lublin(d),83 : 76W,83,27,52,51.9,4,18,22.2,31,70,44.3,17,23,73.9,12,20,32,11,25,0,12,11,4,0,84,Basket Kwidzyn,Sezon 2006/2007
2007-03-07 18:00,Sportino Inowrocław(w),67 : 59P,59,14,29,48.3,8,28,28.6,22,57,38.6,7,12,58.3,4,15,19,14,25,0,11,10,2,0,53,Basket Kwidzyn,Sezon 2006/2007
2007-03-10 18:00,Grono Zielona Góra(d),70 : 62W,70,16,26,61.5,4,15,26.7,20,41,48.8,26,33,78.8,6,24,30,12,17,0,18,11,3,0,80,Basket Kwidzyn,Sezon 2006/2007
2007-03-14 19:00,Znicz Basket Pruszków(w),60 : 88W,88,28,54,51.9,7,21,33.3,35,75,46.7,11,14,78.6,13,34,47,18,31,0,16,8,2,0,104,Basket Kwidzyn,Sezon 2006/2007
2007-03-24 17:00,Znicz Basket Pruszków(d),109 : 67W,109,34,53,64.2,4,11,36.4,38,64,59.4,29,33,87.9,7,23,30,16,30,0,14,17,2,0,130,Basket Kwidzyn,Sezon 2006/2007
2007-03-25 17:00,Znicz Basket Pruszków(d),99 : 67W,99,26,46,56.5,7,18,38.9,33,64,51.6,26,33,78.8,9,19,28,20,31,0,13,19,7,0,122,Basket Kwidzyn,Sezon 2006/2007
2007-03-31 17:00,Znicz Basket Pruszków(w),95 : 79P,79,19,49,38.8,7,17,41.2,26,66,39.4,20,33,60.6,14,14,28,11,31,0,17,11,0,0,59,Basket Kwidzyn,Sezon 2006/2007
2007-04-01 17:00,Znicz Basket Pruszków(w),86 : 84P,84,25,48,52.1,3,12,25.0,28,60,46.7,25,30,83.3,10,25,35,7,29,0,15,4,1,0,79,Basket Kwidzyn,Sezon 2006/2007
2007-04-04 18:00,Znicz Basket Pruszków(d),92 : 85W,92,30,50,60.0,7,12,58.3,37,62,59.7,11,16,68.8,8,19,27,21,25,0,17,15,4,0,112,Basket Kwidzyn,Sezon 2006/2007
2007-04-14 18:00,Grono Zielona Góra(w),84 : 64P,64,13,36,36.1,5,10,50.0,18,46,39.1,23,34,67.6,5,15,20,7,20,0,12,8,1,0,49,Basket Kwidzyn,Sezon 2006/2007
2007-04-15 17:00,Grono Zielona Góra(w),58 : 82W,82,24,48,50.0,4,12,33.3,28,60,46.7,22,28,78.6,11,29,40,13,25,0,13,13,2,0,99,Basket Kwidzyn,Sezon 2006/2007
2007-04-21 18:00,Grono Zielona Góra(d),81 : 73W,81,20,34,58.8,5,10,50.0,25,44,56.8,26,35,74.3,4,20,24,8,23,0,16,14,6,0,89,Basket Kwidzyn,Sezon 2006/2007
2007-04-22 17:00,Grono Zielona Góra(d),80 : 73W,80,16,32,50.0,7,15,46.7,23,47,48.9,27,32,84.4,6,27,33,16,26,0,10,7,1,0,98,Basket Kwidzyn,Sezon 2006/2007
2007-04-28 18:00,Górnik Wałbrzych(d),86 : 79W,86,26,46,56.5,8,25,32.0,34,71,47.9,10,12,83.3,11,22,33,26,18,0,10,7,5,0,108,Basket Kwidzyn,Sezon 2006/2007
2007-05-05 16:00,Górnik Wałbrzych(w),68 : 85W,85,25,52,48.1,6,15,40.0,31,67,46.3,17,18,94.4,7,23,30,18,22,0,13,11,3,0,97,Basket Kwidzyn,Sezon 2006/2007
2006-09-23 16:00,Tarnovia Tarnowo Podgórne(w),75 : 77W,77,17,32,53.1,8,16,50.0,25,48,52.1,19,26,73.1,8,18,26,8,28,0,7,7,0,0,81,Górnik Wałbrzych,Sezon 2006/2007
2006-09-30 18:00,Stal Stalowa Wola(d),89 : 62W,89,18,32,56.3,10,20,50.0,28,52,53.8,23,30,76.7,9,33,42,15,26,0,23,17,4,0,113,Górnik Wałbrzych,Sezon 2006/2007
2006-10-08 18:00,MKS Start AZS Lublin(w),63 : 74W,74,15,31,48.4,7,17,41.2,22,48,45.8,23,36,63.9,4,27,31,7,30,0,46,17,2,0,46,Górnik Wałbrzych,Sezon 2006/2007
2006-10-14 18:30,Sportino Inowrocław(d),59 : 60P,59,11,28,39.3,6,18,33.3,17,46,37.0,19,31,61.3,11,28,39,15,17,0,16,12,2,0,70,Górnik Wałbrzych,Sezon 2006/2007
2006-10-21 18:00,Grono Zielona Góra(w),61 : 45P,45,11,36,30.6,5,13,38.5,16,49,32.7,8,13,61.5,10,24,34,4,15,0,19,8,1,0,35,Górnik Wałbrzych,Sezon 2006/2007
2006-10-28 16:00,Basket Kwidzyn(d),76 : 78P,76,26,43,60.5,4,15,26.7,30,58,51.7,12,17,70.6,7,26,33,19,18,0,15,4,5,0,89,Górnik Wałbrzych,Sezon 2006/2007
2006-11-04 17:30,PTG Sokół Łańcut(w),68 : 94W,94,27,37,73.0,8,18,44.4,35,55,63.6,16,19,84.2,9,26,35,16,23,0,17,6,1,0,112,Górnik Wałbrzych,Sezon 2006/2007
2006-11-08 18:00,PBG Basket Poznań(d),84 : 51W,84,25,40,62.5,5,16,31.3,30,56,53.6,19,26,73.1,8,29,37,23,17,0,13,17,2,0,117,Górnik Wałbrzych,Sezon 2006/2007
2006-11-11 18:00,Siarka Tarnobrzeg(w),85 : 75P,75,23,47,48.9,4,12,33.3,27,59,45.8,17,24,70.8,12,9,21,9,26,0,21,16,2,0,63,Górnik Wałbrzych,Sezon 2006/2007
2006-11-18 16:00,Sportowiec Częstochowa(d),80 : 75W,80,22,45,48.9,3,19,15.8,25,64,39.1,27,37,73.0,18,29,47,12,24,0,19,10,4,0,85,Górnik Wałbrzych,Sezon 2006/2007
2006-11-26 17:00,Spójnia Stargard Szcz.(w),67 : 79W,79,20,36,55.6,5,13,38.5,25,49,51.0,24,28,85.7,7,23,30,9,21,0,17,8,0,0,81,Górnik Wałbrzych,Sezon 2006/2007
2006-12-02 18:00,Znicz Basket Pruszków(w),71 : 80W,80,15,32,46.9,7,20,35.0,22,52,42.3,29,35,82.9,9,21,30,9,28,0,16,12,1,0,80,Górnik Wałbrzych,Sezon 2006/2007
2006-12-09 17:00,Resovia Rzeszów(d),75 : 63W,75,21,44,47.7,8,17,47.1,29,61,47.5,9,13,69.2,14,31,45,22,20,0,14,13,5,0,110,Górnik Wałbrzych,Sezon 2006/2007
2006-12-16 18:30,Tarnovia Tarnowo Podgórne(d),65 : 55W,65,20,38,52.6,1,8,12.5,21,46,45.7,22,26,84.6,6,26,32,17,14,0,12,14,2,0,89,Górnik Wałbrzych,Sezon 2006/2007
2007-01-06 17:00,Stal Stalowa Wola(w),95 : 98W,98,28,53,52.8,5,17,29.4,33,70,47.1,27,39,69.2,9,24,33,5,28,0,10,9,1,0,87,Górnik Wałbrzych,Sezon 2006/2007
2007-01-13 16:30,MKS Start AZS Lublin(d),86 : 101P,86,24,35,68.6,8,29,27.6,32,64,50.0,14,22,63.6,9,24,33,24,29,0,15,16,5,0,109,Górnik Wałbrzych,Sezon 2006/2007
2007-01-20 17:00,Sportino Inowrocław(w),64 : 76W,76,21,44,47.7,8,17,47.1,29,61,47.5,10,22,45.5,10,29,39,13,19,0,13,6,3,0,80,Górnik Wałbrzych,Sezon 2006/2007
2007-01-28 18:15,Grono Zielona Góra(d),62 : 57W,62,19,37,51.4,3,12,25.0,22,49,44.9,15,21,71.4,10,23,33,12,14,0,12,11,0,0,73,Górnik Wałbrzych,Sezon 2006/2007
2007-02-04 18:45,Basket Kwidzyn(w),87 : 64P,64,18,27,66.7,3,11,27.3,21,38,55.3,19,27,70.4,1,16,17,9,26,0,27,8,1,0,47,Górnik Wałbrzych,Sezon 2006/2007
2007-02-10 17:00,PTG Sokół Łańcut(d),84 : 69W,84,24,36,66.7,5,13,38.5,29,49,59.2,21,24,87.5,7,24,31,20,23,0,16,12,3,0,111,Górnik Wałbrzych,Sezon 2006/2007
2007-02-14 16:00,PBG Basket Poznań(w),78 : 80W,80,27,40,67.5,4,15,26.7,31,55,56.4,14,18,77.8,7,26,33,13,18,0,18,10,0,0,90,Górnik Wałbrzych,Sezon 2006/2007
2007-02-17 18:00,Siarka Tarnobrzeg(d),81 : 77W,81,23,31,74.2,6,17,35.3,29,48,60.4,17,20,85.0,8,20,28,18,17,0,15,12,2,0,104,Górnik Wałbrzych,Sezon 2006/2007
2007-02-24 17:00,Sportowiec Częstochowa(w),81 : 80P,80,26,40,65.0,5,14,35.7,31,54,57.4,13,18,72.2,6,28,34,21,25,0,19,8,6,0,102,Górnik Wałbrzych,Sezon 2006/2007
2007-03-07 18:00,Spójnia Stargard Szcz.(d),63 : 57W,63,20,44,45.5,4,12,33.3,24,56,42.9,11,12,91.7,7,25,32,12,19,0,15,7,4,0,70,Górnik Wałbrzych,Sezon 2006/2007
2007-03-11 17:00,Znicz Basket Pruszków(d),92 : 70W,92,21,33,63.6,8,19,42.1,29,52,55.8,26,31,83.9,8,24,32,22,23,0,20,16,1,0,115,Górnik Wałbrzych,Sezon 2006/2007
2007-03-17 17:00,Resovia Rzeszów(w),95 : 83P,83,24,41,58.5,5,20,25.0,29,61,47.5,20,23,87.0,9,26,35,12,26,0,23,8,1,0,81,Górnik Wałbrzych,Sezon 2006/2007
2007-03-24 18:00,Siarka Tarnobrzeg(d),95 : 81W,95,29,56,51.8,7,14,50.0,36,70,51.4,16,21,76.2,18,19,37,24,24,0,15,10,5,0,117,Górnik Wałbrzych,Sezon 2006/2007
2007-03-25 17:00,Siarka Tarnobrzeg(d),108 : 101W,108,24,39,61.5,8,21,38.1,32,60,53.3,36,43,83.7,11,29,40,21,32,0,14,13,0,0,133,Górnik Wałbrzych,Sezon 2006/2007
2007-03-31 18:45,Siarka Tarnobrzeg(w),79 : 74P,74,23,38,60.5,4,19,21.1,27,57,47.4,16,20,80.0,11,20,31,14,26,0,25,11,1,0,72,Górnik Wałbrzych,Sezon 2006/2007
2007-04-01 17:00,Siarka Tarnobrzeg(w),86 : 96W,96,28,40,70.0,8,18,44.4,36,58,62.1,16,17,94.1,7,23,30,21,24,0,27,8,6,0,111,Górnik Wałbrzych,Sezon 2006/2007
2007-04-14 16:00,Sportino Inowrocław(d),69 : 77P,69,15,27,55.6,7,24,29.2,22,51,43.1,18,23,78.3,3,21,24,10,22,0,18,11,1,0,63,Górnik Wałbrzych,Sezon 2006/2007
2007-04-15 17:00,Sportino Inowrocław(d),75 : 97P,75,21,46,45.7,7,22,31.8,28,68,41.2,12,17,70.6,16,13,29,15,17,0,8,6,0,0,72,Górnik Wałbrzych,Sezon 2006/2007
2007-04-21 18:00,Sportino Inowrocław(w),62 : 63W,63,15,34,44.1,6,17,35.3,21,51,41.2,15,22,68.2,9,26,35,8,21,0,17,7,4,0,63,Górnik Wałbrzych,Sezon 2006/2007
2007-04-22 17:30,Sportino Inowrocław(w),75 : 84W,84,17,32,53.1,8,20,40.0,25,52,48.1,26,31,83.9,10,24,34,14,24,0,17,9,5,0,97,Górnik Wałbrzych,Sezon 2006/2007
2007-04-25 19:30,Sportino Inowrocław(d),88 : 74W,88,24,35,68.6,6,20,30.0,30,55,54.5,22,25,88.0,10,27,37,15,25,0,14,11,8,0,117,Górnik Wałbrzych,Sezon 2006/2007
2007-04-28 18:00,Basket Kwidzyn(w),86 : 79P,79,25,52,48.1,5,15,33.3,30,67,44.8,14,18,77.8,9,19,28,13,13,0,14,8,0,0,73,Górnik Wałbrzych,Sezon 2006/2007
2007-05-05 16:00,Basket Kwidzyn(d),68 : 85P,68,17,32,53.1,6,26,23.1,23,58,39.7,16,21,76.2,6,25,31,15,20,0,18,11,1,0,68,Górnik Wałbrzych,Sezon 2006/2007
2006-09-23 18:00,PBG Basket Poznań(d),66 : 56W,66,13,29,44.8,9,22,40.9,22,51,43.1,13,21,61.9,10,24,34,8,17,0,11,10,1,0,71,Grono Zielona Góra,Sezon 2006/2007
2006-09-30 18:00,Siarka Tarnobrzeg(w),61 : 80W,80,22,40,55.0,8,20,40.0,30,60,50.0,12,16,75.0,6,17,23,21,15,0,13,16,2,0,95,Grono Zielona Góra,Sezon 2006/2007
2006-10-07 18:00,Sportowiec Częstochowa(d),67 : 48W,67,19,37,51.4,7,13,53.8,26,50,52.0,8,12,66.7,8,27,35,22,19,0,20,15,3,0,94,Grono Zielona Góra,Sezon 2006/2007
2006-10-14 17:00,Spójnia Stargard Szcz.(w),55 : 63W,63,15,27,55.6,7,21,33.3,22,48,45.8,12,19,63.2,7,26,33,11,19,0,14,11,0,0,71,Grono Zielona Góra,Sezon 2006/2007
2006-10-21 18:00,Górnik Wałbrzych(d),61 : 45W,61,7,16,43.8,14,36,38.9,21,52,40.4,5,13,38.5,4,23,27,21,22,0,12,15,5,0,78,Grono Zielona Góra,Sezon 2006/2007
2006-10-29 17:30,Resovia Rzeszów(w),66 : 70W,70,14,28,50.0,11,28,39.3,25,56,44.6,9,13,69.2,8,16,24,12,22,0,10,9,2,0,72,Grono Zielona Góra,Sezon 2006/2007
2006-11-05 17:00,Tarnovia Tarnowo Podgórne(d),62 : 65P,62,9,20,45.0,8,23,34.8,17,43,39.5,20,30,66.7,7,21,28,11,20,0,17,10,4,0,62,Grono Zielona Góra,Sezon 2006/2007
2006-11-08 18:00,Stal Stalowa Wola(w),56 : 51P,51,17,34,50.0,4,14,28.6,21,48,43.8,5,8,62.5,3,18,21,6,24,0,14,7,2,0,43,Grono Zielona Góra,Sezon 2006/2007
2006-11-11 16:00,MKS Start AZS Lublin(d),63 : 39W,63,17,31,54.8,6,25,24.0,23,56,41.1,11,17,64.7,11,21,32,9,17,0,11,13,3,0,70,Grono Zielona Góra,Sezon 2006/2007
2006-11-18 16:00,Sportino Inowrocław(w),68 : 77W,77,17,34,50.0,6,20,30.0,23,54,42.6,25,26,96.2,8,28,36,11,22,0,14,12,4,0,94,Grono Zielona Góra,Sezon 2006/2007
2006-11-26 19:00,Znicz Basket Pruszków(d),63 : 72P,63,14,35,40.0,5,30,16.7,19,65,29.2,20,21,95.2,16,22,38,9,24,0,12,15,1,0,67,Grono Zielona Góra,Sezon 2006/2007
2006-12-02 18:30,Basket Kwidzyn(d),67 : 58W,67,17,40,42.5,6,21,28.6,23,61,37.7,15,18,83.3,13,22,35,13,19,0,7,5,6,0,78,Grono Zielona Góra,Sezon 2006/2007
2006-12-09 17:30,PTG Sokół Łańcut(w),61 : 62W,62,15,30,50.0,6,24,25.0,21,54,38.9,14,17,82.4,12,17,29,11,22,0,22,12,0,0,56,Grono Zielona Góra,Sezon 2006/2007
2006-12-16 18:00,PBG Basket Poznań(w),67 : 75W,75,17,33,51.5,8,21,38.1,25,54,46.3,17,25,68.0,5,23,28,10,17,0,11,11,1,0,77,Grono Zielona Góra,Sezon 2006/2007
2007-01-06 16:00,Siarka Tarnobrzeg(d),58 : 60P,58,8,24,33.3,9,25,36.0,17,49,34.7,15,23,65.2,4,24,28,14,16,0,11,10,2,0,61,Grono Zielona Góra,Sezon 2006/2007
2007-01-14 16:00,Sportowiec Częstochowa(w),59 : 81W,81,19,37,51.4,10,29,34.5,29,66,43.9,13,19,68.4,20,21,41,15,22,0,12,9,3,0,94,Grono Zielona Góra,Sezon 2006/2007
2007-01-20 18:30,Spójnia Stargard Szcz.(d),75 : 60W,75,10,33,30.3,13,27,48.1,23,60,38.3,16,20,80.0,13,25,38,13,22,0,7,7,2,0,87,Grono Zielona Góra,Sezon 2006/2007
2007-01-28 18:15,Górnik Wałbrzych(w),62 : 57P,57,11,19,57.9,10,36,27.8,21,55,38.2,5,9,55.6,9,20,29,14,25,0,13,8,3,0,60,Grono Zielona Góra,Sezon 2006/2007
2007-02-03 17:30,Resovia Rzeszów(d),82 : 46W,82,17,35,48.6,12,27,44.4,29,62,46.8,12,16,75.0,7,30,37,17,27,0,15,13,5,0,102,Grono Zielona Góra,Sezon 2006/2007
2007-02-11 16:00,Tarnovia Tarnowo Podgórne(w),82 : 88W,88,20,38,52.6,10,20,50.0,30,58,51.7,18,21,85.7,2,26,28,14,21,0,5,3,0,0,97,Grono Zielona Góra,Sezon 2006/2007
2007-02-14 18:00,Stal Stalowa Wola(d),79 : 64W,79,15,30,50.0,12,20,60.0,27,50,54.0,13,20,65.0,4,25,29,13,28,0,11,6,2,0,88,Grono Zielona Góra,Sezon 2006/2007
2007-02-17 15:30,MKS Start AZS Lublin(w),68 : 72W,72,11,28,39.3,12,30,40.0,23,58,39.7,14,21,66.7,5,17,22,16,28,0,9,12,5,0,76,Grono Zielona Góra,Sezon 2006/2007
2007-02-24 18:00,Sportino Inowrocław(d),46 : 62P,46,9,28,32.1,4,12,33.3,13,40,32.5,16,26,61.5,8,20,28,6,21,0,17,10,0,0,36,Grono Zielona Góra,Sezon 2006/2007
2007-02-28 19:00,Znicz Basket Pruszków(w),67 : 86W,86,20,41,48.8,9,19,47.4,29,60,48.3,19,25,76.0,9,30,39,20,24,0,19,13,4,0,106,Grono Zielona Góra,Sezon 2006/2007
2007-03-10 18:00,Basket Kwidzyn(w),70 : 62P,62,15,33,45.5,7,22,31.8,22,55,40.0,11,14,78.6,8,16,24,9,25,0,17,9,0,0,51,Grono Zielona Góra,Sezon 2006/2007
2007-03-17 17:00,PTG Sokół Łańcut(d),82 : 62W,82,16,30,53.3,10,25,40.0,26,55,47.3,20,29,69.0,8,28,36,15,20,0,16,11,0,0,90,Grono Zielona Góra,Sezon 2006/2007
2007-03-24 17:00,Resovia Rzeszów(d),77 : 58W,77,17,32,53.1,11,33,33.3,28,65,43.1,10,13,76.9,20,23,43,15,30,0,12,15,5,0,103,Grono Zielona Góra,Sezon 2006/2007
2007-03-25 17:00,Resovia Rzeszów(d),84 : 69W,84,23,33,69.7,6,22,27.3,29,55,52.7,20,21,95.2,9,25,34,22,24,0,15,9,2,0,109,Grono Zielona Góra,Sezon 2006/2007
2007-04-03 18:00,Resovia Rzeszów(w),64 : 74W,74,19,39,48.7,8,25,32.0,27,64,42.2,12,19,63.2,8,19,27,10,33,0,14,15,1,0,69,Grono Zielona Góra,Sezon 2006/2007
2007-04-14 18:00,Basket Kwidzyn(d),84 : 64W,84,20,29,69.0,11,19,57.9,31,48,64.6,11,16,68.8,3,24,27,16,29,0,13,9,2,0,103,Grono Zielona Góra,Sezon 2006/2007
2007-04-15 17:00,Basket Kwidzyn(d),58 : 82P,58,12,32,37.5,5,23,21.7,17,55,30.9,19,30,63.3,7,18,25,3,28,0,14,7,4,0,34,Grono Zielona Góra,Sezon 2006/2007
2007-04-21 18:00,Basket Kwidzyn(w),81 : 73P,73,15,35,42.9,8,21,38.1,23,56,41.1,19,25,76.0,5,9,14,4,26,0,18,12,1,0,47,Grono Zielona Góra,Sezon 2006/2007
2007-04-22 17:00,Basket Kwidzyn(w),80 : 73P,73,22,36,61.1,2,16,12.5,24,52,46.2,23,32,71.9,4,16,20,4,25,0,12,6,0,0,54,Grono Zielona Góra,Sezon 2006/2007
2006-09-24 17:00,Sportino Inowrocław(d),92 : 85W,92,17,37,45.9,12,30,40.0,29,67,43.3,22,31,71.0,15,19,34,21,26,0,14,17,2,0,105,Siarka Tarnobrzeg,Sezon 2006/2007
2006-09-30 18:00,Grono Zielona Góra(d),61 : 80P,61,20,32,62.5,4,18,22.2,24,50,48.0,9,11,81.8,6,17,23,14,17,0,20,8,3,0,61,Siarka Tarnobrzeg,Sezon 2006/2007
2006-10-08 18:00,Basket Kwidzyn(w),91 : 66P,66,20,43,46.5,2,17,11.8,22,60,36.7,20,32,62.5,11,15,26,8,24,0,14,5,3,0,44,Siarka Tarnobrzeg,Sezon 2006/2007
2006-10-14 18:00,PTG Sokół Łańcut(d),89 : 82W,89,22,28,78.6,11,27,40.7,33,55,60.0,12,18,66.7,4,21,25,27,16,0,16,15,3,0,115,Siarka Tarnobrzeg,Sezon 2006/2007
2006-10-21 18:00,PBG Basket Poznań(w),87 : 94W,94,29,49,59.2,5,20,25.0,34,69,49.3,21,27,77.8,6,19,25,6,23,0,16,6,3,0,77,Siarka Tarnobrzeg,Sezon 2006/2007
2006-10-28 18:00,Znicz Basket Pruszków(w),84 : 72P,72,13,38,34.2,9,22,40.9,22,60,36.7,19,25,76.0,11,20,31,14,18,0,18,12,2,0,69,Siarka Tarnobrzeg,Sezon 2006/2007
2006-11-05 18:00,Sportowiec Częstochowa(d),81 : 78W,81,16,35,45.7,11,25,44.0,27,60,45.0,16,22,72.7,7,17,24,18,20,0,13,19,1,0,91,Siarka Tarnobrzeg,Sezon 2006/2007
2006-11-08 18:00,Spójnia Stargard Szcz.(w),75 : 82W,82,28,45,62.2,5,20,25.0,33,65,50.8,11,23,47.8,9,23,32,12,20,0,10,11,1,0,84,Siarka Tarnobrzeg,Sezon 2006/2007
2006-11-11 18:00,Górnik Wałbrzych(d),85 : 75W,85,19,22,86.4,9,21,42.9,28,43,65.1,20,26,76.9,8,21,29,19,28,0,29,19,10,0,112,Siarka Tarnobrzeg,Sezon 2006/2007
2006-11-18 17:30,Resovia Rzeszów(w),84 : 82P,82,20,47,42.6,8,21,38.1,28,68,41.2,18,26,69.2,15,17,32,9,22,0,14,7,0,0,68,Siarka Tarnobrzeg,Sezon 2006/2007
2006-11-26 18:00,Tarnovia Tarnowo Podgórne(d),96 : 89W,96,27,44,61.4,4,16,25.0,31,60,51.7,30,33,90.9,7,23,30,19,24,0,12,18,3,0,122,Siarka Tarnobrzeg,Sezon 2006/2007
2006-12-02 17:00,Stal Stalowa Wola(w),86 : 57P,57,16,40,40.0,5,19,26.3,21,59,35.6,10,18,55.6,5,17,22,10,15,0,10,10,3,0,46,Siarka Tarnobrzeg,Sezon 2006/2007
2006-12-10 17:00,MKS Start AZS Lublin(d),86 : 89P,86,17,32,53.1,14,39,35.9,31,71,43.7,10,14,71.4,13,18,31,21,21,0,16,15,1,0,94,Siarka Tarnobrzeg,Sezon 2006/2007
2006-12-16 17:30,Sportino Inowrocław(w),69 : 64P,64,13,37,35.1,9,22,40.9,22,59,37.3,11,17,64.7,13,18,31,11,23,0,19,14,4,0,62,Siarka Tarnobrzeg,Sezon 2006/2007
2007-01-06 16:00,Grono Zielona Góra(w),58 : 60W,60,17,46,37.0,6,16,37.5,23,62,37.1,8,15,53.3,16,26,42,8,20,0,11,7,1,0,61,Siarka Tarnobrzeg,Sezon 2006/2007
2007-01-13 17:00,Basket Kwidzyn(d),85 : 72W,85,25,37,67.6,8,23,34.8,33,60,55.0,11,18,61.1,8,35,43,16,22,0,18,11,2,0,105,Siarka Tarnobrzeg,Sezon 2006/2007
2007-01-20 17:30,PTG Sokół Łańcut(w),80 : 63P,63,16,39,41.0,6,22,27.3,22,61,36.1,13,20,65.0,15,17,32,12,24,0,20,11,1,0,53,Siarka Tarnobrzeg,Sezon 2006/2007
2007-01-27 17:00,PBG Basket Poznań(d),83 : 70W,83,24,38,63.2,9,21,42.9,33,59,55.9,8,9,88.9,5,19,24,19,16,0,12,14,2,0,103,Siarka Tarnobrzeg,Sezon 2006/2007
2007-02-04 17:00,Znicz Basket Pruszków(d),82 : 93P,82,21,35,60.0,7,34,20.6,28,69,40.6,19,23,82.6,15,14,29,16,22,0,11,15,1,0,87,Siarka Tarnobrzeg,Sezon 2006/2007
2007-02-07 18:00,Spójnia Stargard Szcz.(d),85 : 57W,85,16,31,51.6,7,17,41.2,23,48,47.9,32,37,86.5,10,28,38,13,22,0,11,16,1,0,112,Siarka Tarnobrzeg,Sezon 2006/2007
2007-02-11 16:00,Sportowiec Częstochowa(w),76 : 86W,86,23,42,54.8,6,15,40.0,29,57,50.9,22,24,91.7,8,30,38,19,21,0,13,5,3,0,108,Siarka Tarnobrzeg,Sezon 2006/2007
2007-02-17 18:00,Górnik Wałbrzych(w),81 : 77P,77,17,45,37.8,10,19,52.6,27,64,42.2,13,18,72.2,15,10,25,14,24,0,14,12,0,0,72,Siarka Tarnobrzeg,Sezon 2006/2007
2007-02-24 19:00,Resovia Rzeszów(d),84 : 87P,84,19,29,65.5,10,21,47.6,29,50,58.0,16,19,84.2,3,21,24,15,23,0,21,8,3,0,89,Siarka Tarnobrzeg,Sezon 2006/2007
2007-03-04 16:00,Tarnovia Tarnowo Podgórne(w),77 : 60P,60,14,33,42.4,5,14,35.7,19,47,40.4,17,27,63.0,9,24,33,4,13,0,9,3,1,0,54,Siarka Tarnobrzeg,Sezon 2006/2007
2007-03-10 17:00,Stal Stalowa Wola(d),83 : 77W,83,30,48,62.5,5,16,31.3,35,64,54.7,8,11,72.7,12,15,27,11,17,0,15,19,3,0,96,Siarka Tarnobrzeg,Sezon 2006/2007
2007-03-17 17:00,MKS Start AZS Lublin(w),92 : 77P,77,15,38,39.5,13,28,46.4,28,66,42.4,8,12,66.7,3,22,25,19,19,0,17,5,4,0,71,Siarka Tarnobrzeg,Sezon 2006/2007
2007-03-24 18:00,Górnik Wałbrzych(w),95 : 81P,81,16,33,48.5,11,20,55.0,27,53,50.9,16,31,51.6,7,18,25,15,24,0,10,10,1,0,81,Siarka Tarnobrzeg,Sezon 2006/2007
2007-03-25 17:00,Górnik Wałbrzych(w),108 : 101P,101,24,44,54.5,9,28,32.1,33,72,45.8,26,36,72.2,6,24,30,19,34,0,15,9,1,0,96,Siarka Tarnobrzeg,Sezon 2006/2007
2007-03-31 18:45,Górnik Wałbrzych(d),79 : 74W,79,25,38,65.8,4,18,22.2,29,56,51.8,17,24,70.8,7,14,21,17,24,0,15,15,4,0,87,Siarka Tarnobrzeg,Sezon 2006/2007
2007-04-01 17:00,Górnik Wałbrzych(d),86 : 96P,86,21,32,65.6,6,24,25.0,27,56,48.2,26,29,89.7,7,12,19,10,18,0,17,15,7,0,88,Siarka Tarnobrzeg,Sezon 2006/2007
2006-09-24 17:00,Siarka Tarnobrzeg(w),92 : 85P,85,23,40,57.5,7,22,31.8,30,62,48.4,18,28,64.3,13,24,37,11,30,0,20,11,1,0,83,Sportino Inowrocław,Sezon 2006/2007
2006-09-30 18:00,Sportowiec Częstochowa(w),103 : 105W,105,23,38,60.5,9,24,37.5,32,62,51.6,32,40,80.0,13,30,43,16,28,0,23,11,1,0,115,Sportino Inowrocław,Sezon 2006/2007
2006-10-07 17:30,Spójnia Stargard Szcz.(d),96 : 66W,96,33,45,73.3,6,18,33.3,39,63,61.9,12,20,60.0,10,31,41,23,18,0,11,13,1,0,131,Sportino Inowrocław,Sezon 2006/2007
2006-10-14 18:30,Górnik Wałbrzych(w),59 : 60W,60,16,25,64.0,7,33,21.2,23,58,39.7,7,13,53.8,5,23,28,13,25,0,12,11,2,0,61,Sportino Inowrocław,Sezon 2006/2007
2006-10-21 18:00,Resovia Rzeszów(d),90 : 84W,90,18,38,47.4,12,29,41.4,30,67,44.8,18,26,69.2,10,22,32,24,28,0,14,13,3,0,103,Sportino Inowrocław,Sezon 2006/2007
2006-10-29 16:00,Tarnovia Tarnowo Podgórne(w),68 : 76W,76,17,31,54.8,8,23,34.8,25,54,46.3,18,24,75.0,8,19,27,3,19,0,6,1,0,0,66,Sportino Inowrocław,Sezon 2006/2007
2006-11-04 16:30,Stal Stalowa Wola(d),82 : 77W,82,24,50,48.0,6,14,42.9,30,64,46.9,16,18,88.9,8,26,34,13,16,0,13,8,7,0,95,Sportino Inowrocław,Sezon 2006/2007
2006-11-08 18:00,MKS Start AZS Lublin(w),55 : 56W,56,18,39,46.2,4,25,16.0,22,64,34.4,8,13,61.5,11,27,38,11,20,0,14,11,5,0,60,Sportino Inowrocław,Sezon 2006/2007
2006-11-11 17:30,Znicz Basket Pruszków(d),89 : 96P,89,21,40,52.5,8,20,40.0,29,60,48.3,23,33,69.7,13,20,33,17,25,0,16,10,6,0,98,Sportino Inowrocław,Sezon 2006/2007
2006-11-18 16:00,Grono Zielona Góra(d),68 : 77P,68,18,37,48.6,6,27,22.2,24,64,37.5,14,21,66.7,10,21,31,14,21,0,10,13,2,0,71,Sportino Inowrocław,Sezon 2006/2007
2006-11-26 18:00,Basket Kwidzyn(w),70 : 67P,67,18,39,46.2,8,15,53.3,26,54,48.1,7,11,63.6,6,22,28,14,25,0,16,13,1,0,75,Sportino Inowrocław,Sezon 2006/2007
2006-12-02 17:30,PTG Sokół Łańcut(d),81 : 75W,81,12,28,42.9,12,24,50.0,24,52,46.2,21,29,72.4,9,24,33,17,23,0,18,17,2,0,96,Sportino Inowrocław,Sezon 2006/2007
2006-12-09 17:00,PBG Basket Poznań(w),102 : 86P,86,24,38,63.2,7,20,35.0,31,58,53.4,17,20,85.0,4,21,25,9,28,0,17,14,1,0,88,Sportino Inowrocław,Sezon 2006/2007
2006-12-16 17:30,Siarka Tarnobrzeg(d),69 : 64W,69,17,30,56.7,7,22,31.8,24,52,46.2,14,20,70.0,13,23,36,17,25,0,20,10,6,0,84,Sportino Inowrocław,Sezon 2006/2007
2007-01-06 18:00,Sportowiec Częstochowa(d),95 : 74W,95,29,48,60.4,10,22,45.5,39,70,55.7,7,8,87.5,7,20,27,27,20,0,15,16,8,0,126,Sportino Inowrocław,Sezon 2006/2007
2007-01-13 17:00,Spójnia Stargard Szcz.(w),80 : 69P,69,16,35,45.7,6,24,25.0,22,59,37.3,19,23,82.6,13,20,33,8,31,0,20,14,2,0,65,Sportino Inowrocław,Sezon 2006/2007
2007-01-20 17:00,Górnik Wałbrzych(d),64 : 76P,64,12,27,44.4,9,27,33.3,21,54,38.9,13,20,65.0,5,23,28,16,23,0,15,12,5,0,70,Sportino Inowrocław,Sezon 2006/2007
2007-01-27 17:30,Resovia Rzeszów(w),97 : 103W,103,28,42,66.7,6,30,20.0,34,72,47.2,29,36,80.6,14,27,41,10,32,0,19,17,2,0,109,Sportino Inowrocław,Sezon 2006/2007
2007-02-03 17:00,Tarnovia Tarnowo Podgórne(d),90 : 71W,90,31,49,63.3,3,11,27.3,34,60,56.7,19,28,67.9,12,25,37,14,17,0,12,9,0,0,103,Sportino Inowrocław,Sezon 2006/2007
2007-02-10 17:00,Stal Stalowa Wola(w),86 : 70P,70,25,45,55.6,4,18,22.2,29,63,46.0,8,14,57.1,7,18,25,12,21,0,11,6,2,0,64,Sportino Inowrocław,Sezon 2006/2007
2007-02-14 18:00,MKS Start AZS Lublin(d),84 : 71W,84,27,53,50.9,6,16,37.5,33,69,47.8,12,18,66.7,10,18,28,21,17,0,8,16,7,0,106,Sportino Inowrocław,Sezon 2006/2007
2007-02-18 18:00,Znicz Basket Pruszków(w),63 : 74W,74,21,38,55.3,9,20,45.0,30,58,51.7,5,7,71.4,8,18,26,15,18,0,19,13,1,0,80,Sportino Inowrocław,Sezon 2006/2007
2007-02-24 18:00,Grono Zielona Góra(w),46 : 62W,62,10,18,55.6,8,23,34.8,18,41,43.9,18,23,78.3,4,23,27,6,24,0,13,14,1,0,69,Sportino Inowrocław,Sezon 2006/2007
2007-03-07 18:00,Basket Kwidzyn(d),67 : 59W,67,17,32,53.1,5,16,31.3,22,48,45.8,18,28,64.3,9,24,33,12,18,0,12,9,4,0,77,Sportino Inowrocław,Sezon 2006/2007
2007-03-10 17:30,PTG Sokół Łańcut(w),80 : 79P,79,17,35,48.6,10,31,32.3,27,66,40.9,15,21,71.4,11,20,31,14,27,0,15,12,0,0,76,Sportino Inowrocław,Sezon 2006/2007
2007-03-15 18:00,PBG Basket Poznań(d),66 : 61W,66,16,31,51.6,7,23,30.4,23,54,42.6,13,21,61.9,8,24,32,12,28,0,17,9,7,0,70,Sportino Inowrocław,Sezon 2006/2007
2007-03-24 18:00,Stal Stalowa Wola(d),75 : 79P,75,21,43,48.8,6,22,27.3,27,65,41.5,15,20,75.0,14,20,34,11,23,0,12,8,3,0,76,Sportino Inowrocław,Sezon 2006/2007
2007-03-25 18:00,Stal Stalowa Wola(d),81 : 64W,81,21,40,52.5,8,30,26.7,29,70,41.4,15,22,68.2,19,19,38,10,20,0,6,13,4,0,92,Sportino Inowrocław,Sezon 2006/2007
2007-04-03 18:00,Stal Stalowa Wola(w),55 : 73W,73,19,40,47.5,9,17,52.9,28,57,49.1,8,9,88.9,9,25,34,9,23,0,10,9,4,0,89,Sportino Inowrocław,Sezon 2006/2007
2007-04-04 18:00,Stal Stalowa Wola(w),51 : 76W,76,18,33,54.5,6,22,27.3,24,55,43.6,22,26,84.6,7,21,28,12,21,0,7,8,2,0,84,Sportino Inowrocław,Sezon 2006/2007
2007-04-14 16:00,Górnik Wałbrzych(w),69 : 77W,77,20,35,57.1,7,19,36.8,27,54,50.0,16,22,72.7,2,19,21,17,23,0,13,11,2,0,82,Sportino Inowrocław,Sezon 2006/2007
2007-04-15 17:00,Górnik Wałbrzych(w),75 : 97W,97,17,23,73.9,16,33,48.5,33,56,58.9,15,17,88.2,7,22,29,19,23,0,8,7,3,0,122,Sportino Inowrocław,Sezon 2006/2007
2007-04-21 18:00,Górnik Wałbrzych(d),62 : 63P,62,18,37,48.6,5,23,21.7,23,60,38.3,11,18,61.1,11,18,29,7,21,0,11,11,5,0,59,Sportino Inowrocław,Sezon 2006/2007
2007-04-22 17:30,Górnik Wałbrzych(d),75 : 84P,75,14,34,41.2,9,26,34.6,23,60,38.3,20,26,76.9,6,17,23,9,26,0,13,15,1,0,67,Sportino Inowrocław,Sezon 2006/2007
2007-04-25 19:30,Górnik Wałbrzych(w),88 : 74P,74,23,41,56.1,5,24,20.8,28,65,43.1,13,22,59.1,7,14,21,10,26,0,12,11,1,0,59,Sportino Inowrocław,Sezon 2006/2007
2006-09-24 16:00,Stal Stalowa Wola(w),88 : 70P,70,15,32,46.9,10,27,37.0,25,59,42.4,10,14,71.4,8,13,21,11,27,0,11,8,0,0,61,Spójnia Stargard Szcz.,Sezon 2006/2007
2006-09-27 17:00,MKS Start AZS Lublin(w),68 : 71W,71,16,33,48.5,9,25,36.0,25,58,43.1,12,17,70.6,6,21,27,10,28,0,14,11,2,0,69,Spójnia Stargard Szcz.,Sezon 2006/2007
2006-10-07 17:30,Sportino Inowrocław(w),96 : 66P,66,13,28,46.4,10,32,31.3,23,60,38.3,10,15,66.7,6,15,21,10,18,0,12,7,2,0,52,Spójnia Stargard Szcz.,Sezon 2006/2007
2006-10-14 17:00,Grono Zielona Góra(d),55 : 63P,55,14,28,50.0,6,19,31.6,20,47,42.6,9,12,75.0,3,22,25,8,19,0,15,8,1,0,52,Spójnia Stargard Szcz.,Sezon 2006/2007
2006-10-21 18:00,Basket Kwidzyn(w),64 : 67W,67,18,29,62.1,7,26,26.9,25,55,45.5,10,15,66.7,5,26,31,7,18,0,13,8,2,0,67,Spójnia Stargard Szcz.,Sezon 2006/2007
2006-10-28 17:00,PTG Sokół Łańcut(d),61 : 70P,61,12,29,41.4,10,25,40.0,22,54,40.7,7,11,63.6,2,19,21,10,20,0,11,7,2,0,54,Spójnia Stargard Szcz.,Sezon 2006/2007
2006-11-04 18:00,PBG Basket Poznań(w),75 : 80W,80,23,32,71.9,9,24,37.5,32,56,57.1,7,7,100.0,2,20,22,14,24,0,11,6,0,0,87,Spójnia Stargard Szcz.,Sezon 2006/2007
2006-11-08 18:00,Siarka Tarnobrzeg(d),75 : 82P,75,18,35,51.4,8,23,34.8,26,58,44.8,15,19,78.9,7,20,27,11,24,0,18,9,4,0,72,Spójnia Stargard Szcz.,Sezon 2006/2007
2006-11-11 17:00,Sportowiec Częstochowa(w),89 : 92W,92,24,38,63.2,10,27,37.0,34,65,52.3,14,22,63.6,10,18,28,16,28,0,7,7,6,0,103,Spójnia Stargard Szcz.,Sezon 2006/2007
2006-11-18 17:00,Znicz Basket Pruszków(d),74 : 77P,74,21,36,58.3,6,28,21.4,27,64,42.2,14,18,77.8,9,16,25,12,20,0,14,14,3,0,73,Spójnia Stargard Szcz.,Sezon 2006/2007
2006-11-26 17:00,Górnik Wałbrzych(d),67 : 79P,67,10,26,38.5,10,27,37.0,20,53,37.7,17,26,65.4,6,10,16,18,24,0,13,8,1,0,55,Spójnia Stargard Szcz.,Sezon 2006/2007
2006-12-02 17:30,Resovia Rzeszów(w),96 : 72P,72,17,40,42.5,10,22,45.5,27,62,43.5,8,13,61.5,6,18,24,12,18,0,13,6,2,0,63,Spójnia Stargard Szcz.,Sezon 2006/2007
2006-12-09 17:00,Tarnovia Tarnowo Podgórne(d),67 : 77P,67,18,40,45.0,4,15,26.7,22,55,40.0,19,27,70.4,7,18,25,7,18,0,9,9,3,0,61,Spójnia Stargard Szcz.,Sezon 2006/2007
2006-12-16 17:00,Stal Stalowa Wola(d),70 : 62W,70,16,36,44.4,9,23,39.1,25,59,42.4,11,18,61.1,10,27,37,12,21,0,9,8,0,0,77,Spójnia Stargard Szcz.,Sezon 2006/2007
2007-01-06 17:00,MKS Start AZS Lublin(d),76 : 70W,76,15,35,42.9,9,26,34.6,24,61,39.3,19,26,73.1,12,27,39,19,21,0,12,9,1,0,88,Spójnia Stargard Szcz.,Sezon 2006/2007
2007-01-13 17:00,Sportino Inowrocław(d),80 : 69W,80,20,35,57.1,6,18,33.3,26,53,49.1,22,31,71.0,6,23,29,14,26,0,18,16,3,0,88,Spójnia Stargard Szcz.,Sezon 2006/2007
2007-01-20 18:30,Grono Zielona Góra(w),75 : 60P,60,18,32,56.3,5,14,35.7,23,46,50.0,9,18,50.0,5,20,25,7,21,0,13,4,4,0,55,Spójnia Stargard Szcz.,Sezon 2006/2007
2007-01-27 17:00,Basket Kwidzyn(d),68 : 62W,68,23,38,60.5,4,16,25.0,27,54,50.0,10,21,47.6,5,30,35,15,18,0,16,9,6,0,79,Spójnia Stargard Szcz.,Sezon 2006/2007
2007-02-04 18:00,PTG Sokół Łańcut(w),75 : 55P,55,11,30,36.7,9,20,45.0,20,50,40.0,6,9,66.7,4,26,30,14,16,0,12,5,0,0,59,Spójnia Stargard Szcz.,Sezon 2006/2007
2007-02-07 18:00,Siarka Tarnobrzeg(w),85 : 57P,57,16,35,45.7,3,23,13.0,19,58,32.8,16,21,76.2,13,15,28,7,30,0,19,7,1,0,37,Spójnia Stargard Szcz.,Sezon 2006/2007
2007-02-11 17:00,PBG Basket Poznań(d),67 : 66W,67,19,38,50.0,6,24,25.0,25,62,40.3,11,14,78.6,7,19,26,9,19,0,14,12,5,0,65,Spójnia Stargard Szcz.,Sezon 2006/2007
2007-02-17 17:00,Sportowiec Częstochowa(d),73 : 84P,73,23,39,59.0,5,23,21.7,28,62,45.2,12,21,57.1,11,20,31,17,27,0,16,9,4,0,75,Spójnia Stargard Szcz.,Sezon 2006/2007
2007-02-24 18:00,Znicz Basket Pruszków(w),81 : 64P,64,17,34,50.0,3,18,16.7,20,52,38.5,21,25,84.0,8,17,25,10,20,0,17,8,2,0,56,Spójnia Stargard Szcz.,Sezon 2006/2007
2007-03-07 18:00,Górnik Wałbrzych(w),63 : 57P,57,12,35,34.3,6,19,31.6,18,54,33.3,15,25,60.0,7,19,26,10,18,0,10,8,3,0,48,Spójnia Stargard Szcz.,Sezon 2006/2007
2007-03-11 17:00,Resovia Rzeszów(d),62 : 88P,62,17,37,45.9,3,24,12.5,20,61,32.8,19,26,73.1,11,20,31,7,22,0,15,9,2,0,48,Spójnia Stargard Szcz.,Sezon 2006/2007
2007-03-17 17:00,Tarnovia Tarnowo Podgórne(w),72 : 80W,80,21,40,52.5,7,14,50.0,28,54,51.9,17,20,85.0,4,17,21,8,16,0,9,5,0,0,76,Spójnia Stargard Szcz.,Sezon 2006/2007
2007-03-24 17:00,Sportowiec Częstochowa(d),69 : 84P,69,17,30,56.7,8,28,28.6,25,58,43.1,11,17,64.7,12,19,31,15,25,0,14,4,4,0,70,Spójnia Stargard Szcz.,Sezon 2006/2007
2007-04-01 17:00,Sportowiec Częstochowa(w),84 : 76P,76,18,34,52.9,10,22,45.5,28,56,50.0,10,16,62.5,9,19,28,14,22,0,18,7,4,0,77,Spójnia Stargard Szcz.,Sezon 2006/2007
2007-04-14 16:30,PBG Basket Poznań(d),69 : 55W,69,19,35,54.3,7,16,43.8,26,51,51.0,10,17,58.8,4,26,30,14,17,0,13,8,3,0,79,Spójnia Stargard Szcz.,Sezon 2006/2007
2007-04-19 18:00,PBG Basket Poznań(w),80 : 65P,65,16,33,48.5,5,22,22.7,21,55,38.2,18,20,90.0,6,24,30,9,15,0,18,9,4,0,63,Spójnia Stargard Szcz.,Sezon 2006/2007
2007-04-25 18:00,PBG Basket Poznań(d),67 : 70P,67,12,23,52.2,9,20,45.0,21,43,48.8,16,26,61.5,3,12,15,12,26,0,13,9,3,0,61,Spójnia Stargard Szcz.,Sezon 2006/2007
2006-09-24 16:00,Spójnia Stargard Szcz.(d),88 : 70W,88,28,39,71.8,3,14,21.4,31,53,58.5,23,33,69.7,8,22,30,15,20,0,12,9,2,0,100,Stal Stalowa Wola,Sezon 2006/2007
2006-09-30 18:00,Górnik Wałbrzych(w),89 : 62P,62,16,28,57.1,7,27,25.9,23,55,41.8,9,20,45.0,4,18,22,11,26,0,20,20,0,0,52,Stal Stalowa Wola,Sezon 2006/2007
2006-10-07 17:00,Resovia Rzeszów(d),97 : 71W,97,25,44,56.8,8,14,57.1,33,58,56.9,23,31,74.2,10,27,37,18,26,0,18,10,6,0,117,Stal Stalowa Wola,Sezon 2006/2007
2006-10-15 17:00,Tarnovia Tarnowo Podgórne(w),64 : 94W,94,29,45,64.4,7,15,46.7,36,60,60.0,15,23,65.2,10,22,32,10,16,0,6,3,2,0,103,Stal Stalowa Wola,Sezon 2006/2007
2006-10-21 18:00,Znicz Basket Pruszków(d),92 : 94P,92,20,38,52.6,9,25,36.0,29,63,46.0,25,34,73.5,13,25,38,14,31,0,15,9,4,0,99,Stal Stalowa Wola,Sezon 2006/2007
2006-10-28 18:00,MKS Start AZS Lublin(d),72 : 75P,72,20,36,55.6,4,30,13.3,24,66,36.4,20,31,64.5,12,18,30,9,23,0,12,16,1,0,63,Stal Stalowa Wola,Sezon 2006/2007
2006-11-04 16:30,Sportino Inowrocław(w),82 : 77P,77,24,46,52.2,8,24,33.3,32,70,45.7,5,11,45.5,11,20,31,26,18,0,12,6,5,0,89,Stal Stalowa Wola,Sezon 2006/2007
2006-11-08 18:00,Grono Zielona Góra(d),56 : 51W,56,14,31,45.2,4,20,20.0,18,51,35.3,16,24,66.7,8,21,29,8,17,0,12,12,4,0,56,Stal Stalowa Wola,Sezon 2006/2007
2006-11-11 18:00,Basket Kwidzyn(w),75 : 58P,58,17,34,50.0,4,16,25.0,21,50,42.0,12,17,70.6,7,19,26,9,18,0,20,8,2,0,49,Stal Stalowa Wola,Sezon 2006/2007
2006-11-18 17:00,PTG Sokół Łańcut(d),77 : 68W,77,19,30,63.3,7,23,30.4,26,53,49.1,18,31,58.1,11,29,40,15,22,0,21,8,6,0,85,Stal Stalowa Wola,Sezon 2006/2007
2006-11-27 16:00,PBG Basket Poznań(w),97 : 94P,94,27,42,64.3,10,26,38.5,37,68,54.4,10,13,76.9,6,20,26,21,23,0,17,8,2,0,100,Stal Stalowa Wola,Sezon 2006/2007
2006-12-02 17:00,Siarka Tarnobrzeg(d),86 : 57W,86,27,46,58.7,8,21,38.1,35,67,52.2,8,13,61.5,14,31,45,17,19,0,14,5,6,0,108,Stal Stalowa Wola,Sezon 2006/2007
2006-12-09 17:00,Sportowiec Częstochowa(d),83 : 65W,83,24,41,58.5,9,21,42.9,33,62,53.2,8,17,47.1,15,29,44,15,14,0,18,12,7,0,105,Stal Stalowa Wola,Sezon 2006/2007
2006-12-16 17:00,Spójnia Stargard Szcz.(w),70 : 62P,62,12,34,35.3,7,18,38.9,19,52,36.5,17,22,77.3,5,27,32,8,15,0,11,5,6,0,64,Stal Stalowa Wola,Sezon 2006/2007
2007-01-06 17:00,Górnik Wałbrzych(d),95 : 98P,95,20,40,50.0,8,21,38.1,28,61,45.9,31,42,73.8,6,26,32,10,28,0,16,5,3,0,85,Stal Stalowa Wola,Sezon 2006/2007
2007-01-13 17:30,Resovia Rzeszów(w),76 : 75P,75,19,39,48.7,8,18,44.4,27,57,47.4,13,17,76.5,6,26,32,15,24,0,22,7,2,0,75,Stal Stalowa Wola,Sezon 2006/2007
2007-01-20 17:00,Tarnovia Tarnowo Podgórne(d),83 : 67W,83,28,46,60.9,4,18,22.2,32,64,50.0,15,18,83.3,9,24,33,13,9,0,8,8,0,0,94,Stal Stalowa Wola,Sezon 2006/2007
2007-01-26 19:00,Znicz Basket Pruszków(w),87 : 89W,89,21,45,46.7,7,18,38.9,28,63,44.4,26,32,81.3,12,23,35,12,25,0,15,7,5,0,92,Stal Stalowa Wola,Sezon 2006/2007
2007-02-03 17:00,MKS Start AZS Lublin(w),93 : 99W,99,28,49,57.1,6,22,27.3,34,71,47.9,25,37,67.6,13,22,35,17,25,0,13,9,1,0,99,Stal Stalowa Wola,Sezon 2006/2007
2007-02-10 17:00,Sportino Inowrocław(d),86 : 70W,86,20,35,57.1,10,22,45.5,30,57,52.6,16,23,69.6,7,24,31,24,17,0,13,8,0,0,102,Stal Stalowa Wola,Sezon 2006/2007
2007-02-14 18:00,Grono Zielona Góra(w),79 : 64P,64,19,36,52.8,3,18,16.7,22,54,40.7,17,26,65.4,8,14,22,12,17,0,9,9,4,0,61,Stal Stalowa Wola,Sezon 2006/2007
2007-02-17 17:00,Basket Kwidzyn(d),62 : 93P,62,22,47,46.8,3,16,18.8,25,63,39.7,9,11,81.8,11,19,30,9,25,0,19,9,4,0,55,Stal Stalowa Wola,Sezon 2006/2007
2007-02-25 17:00,PTG Sokół Łańcut(w),74 : 93W,93,23,36,63.9,9,21,42.9,32,57,56.1,20,29,69.0,7,21,28,17,21,0,15,13,2,0,104,Stal Stalowa Wola,Sezon 2006/2007
2007-03-07 17:00,PBG Basket Poznań(d),74 : 69W,74,22,49,44.9,5,19,26.3,27,68,39.7,15,24,62.5,9,34,43,17,23,0,13,9,8,0,88,Stal Stalowa Wola,Sezon 2006/2007
2007-03-10 17:00,Siarka Tarnobrzeg(w),83 : 77P,77,23,38,60.5,5,16,31.3,28,54,51.9,16,19,84.2,6,14,20,21,18,0,17,11,5,0,88,Stal Stalowa Wola,Sezon 2006/2007
2007-03-17 17:00,Sportowiec Częstochowa(w),103 : 79P,79,22,41,53.7,7,14,50.0,29,55,52.7,14,19,73.7,4,23,27,18,21,0,24,10,1,0,80,Stal Stalowa Wola,Sezon 2006/2007
2007-03-24 18:00,Sportino Inowrocław(w),75 : 79W,79,22,36,61.1,7,16,43.8,29,52,55.8,14,21,66.7,3,23,26,20,21,0,14,10,4,0,95,Stal Stalowa Wola,Sezon 2006/2007
2007-03-25 18:00,Sportino Inowrocław(w),81 : 64P,64,11,26,42.3,8,18,44.4,19,44,43.2,18,21,85.7,5,18,23,15,21,0,17,6,4,0,67,Stal Stalowa Wola,Sezon 2006/2007
2007-04-03 18:00,Sportino Inowrocław(d),55 : 73P,55,15,33,45.5,4,18,22.2,19,51,37.3,13,18,72.2,5,17,22,9,17,0,14,9,1,0,45,Stal Stalowa Wola,Sezon 2006/2007
2007-04-04 18:00,Sportino Inowrocław(d),51 : 76P,51,14,32,43.8,6,21,28.6,20,53,37.7,5,13,38.5,10,21,31,6,23,0,16,5,2,0,38,Stal Stalowa Wola,Sezon 2006/2007
2005-10-01 18:00,Sokołów Znicz Jarosław(d),98 : 101P,98,23,31,74.2,11,27,40.7,34,58,58.6,19,19,100.0,9,12,21,13,30,0,15,4,2,0,99,CZELADZKI KLUB SPORTOWY 1924 (CKS) Czeladź,Sezon 2005/2006
2005-10-08 18:00,Znicz Basket Pruszków(w),69 : 58P,58,19,38,50.0,4,21,19.0,23,59,39.0,8,14,57.1,6,27,33,15,25,0,23,9,0,0,50,CZELADZKI KLUB SPORTOWY 1924 (CKS) Czeladź,Sezon 2005/2006
2005-10-12 18:00,PBG Basket Poznań(d),96 : 71W,96,20,28,71.4,11,30,36.7,31,58,53.4,23,30,76.7,13,27,40,9,16,0,15,5,1,0,102,CZELADZKI KLUB SPORTOWY 1924 (CKS) Czeladź,Sezon 2005/2006
2005-10-15 18:00,KS Legion Legionowo(d),101 : 87W,101,29,42,69.0,6,18,33.3,35,60,58.3,25,28,89.3,8,28,36,17,20,0,17,8,1,0,118,CZELADZKI KLUB SPORTOWY 1924 (CKS) Czeladź,Sezon 2005/2006
2005-10-22 17:00,KS AZS AWF Katowice(w),81 : 99W,99,27,52,51.9,6,19,31.6,33,71,46.5,27,38,71.1,12,30,42,23,26,0,14,14,0,0,115,CZELADZKI KLUB SPORTOWY 1924 (CKS) Czeladź,Sezon 2005/2006
2005-10-26 18:00,Basket Kwidzyn(d),85 : 70W,85,25,48,52.1,6,16,37.5,31,64,48.4,17,18,94.4,17,26,43,12,17,0,14,4,3,0,99,CZELADZKI KLUB SPORTOWY 1924 (CKS) Czeladź,Sezon 2005/2006
2005-10-29 17:30,PTG Sokół Łańcut(w),87 : 84P,84,21,32,65.6,9,23,39.1,30,55,54.5,15,19,78.9,7,18,25,20,22,0,14,5,3,0,94,CZELADZKI KLUB SPORTOWY 1924 (CKS) Czeladź,Sezon 2005/2006
2005-11-05 18:00,Stal Stalowa Wola(d),83 : 98P,83,26,51,51.0,8,21,38.1,34,72,47.2,7,8,87.5,13,19,32,18,26,0,23,4,2,0,77,CZELADZKI KLUB SPORTOWY 1924 (CKS) Czeladź,Sezon 2005/2006
2005-11-09 18:00,Górnik Wałbrzych(w),74 : 87W,87,22,36,61.1,9,29,31.0,31,65,47.7,16,25,64.0,12,17,29,16,17,0,9,11,1,0,92,CZELADZKI KLUB SPORTOWY 1924 (CKS) Czeladź,Sezon 2005/2006
2005-11-12 18:00,Siarka Tarnobrzeg(d),107 : 92W,107,30,44,68.2,10,21,47.6,40,65,61.5,17,20,85.0,7,23,30,32,26,0,18,14,3,0,140,CZELADZKI KLUB SPORTOWY 1924 (CKS) Czeladź,Sezon 2005/2006
2005-11-19 17:00,Spójnia Stargard Szcz.(w),106 : 100P,100,23,50,46.0,8,22,36.4,31,72,43.1,30,42,71.4,16,19,35,13,28,0,12,10,1,0,94,CZELADZKI KLUB SPORTOWY 1924 (CKS) Czeladź,Sezon 2005/2006
2005-11-23 18:00,AZS Politechnika Radomska(d),93 : 78W,93,31,48,64.6,7,20,35.0,38,68,55.9,10,12,83.3,8,27,35,23,24,0,20,15,4,0,118,CZELADZKI KLUB SPORTOWY 1924 (CKS) Czeladź,Sezon 2005/2006
2005-11-27 17:00,Grono Zielona Góra(w),80 : 70P,70,12,30,40.0,9,22,40.9,21,52,40.4,19,25,76.0,6,17,23,11,25,0,18,7,2,0,58,CZELADZKI KLUB SPORTOWY 1924 (CKS) Czeladź,Sezon 2005/2006
2005-12-03 18:00,Sportowiec Częstochowa(d),92 : 86W,92,19,39,48.7,11,28,39.3,30,67,44.8,21,22,95.5,15,23,38,22,19,0,17,9,4,0,110,CZELADZKI KLUB SPORTOWY 1924 (CKS) Czeladź,Sezon 2005/2006
2005-12-10 18:00,Viking Gdynia(w),81 : 61P,61,21,47,44.7,4,15,26.7,25,62,40.3,7,8,87.5,4,12,16,10,20,0,12,11,1,0,49,CZELADZKI KLUB SPORTOWY 1924 (CKS) Czeladź,Sezon 2005/2006
2005-12-17 17:30,Sokołów Znicz Jarosław(w),91 : 75P,75,21,39,53.8,5,17,29.4,26,56,46.4,18,21,85.7,4,16,20,8,22,0,15,8,1,0,64,CZELADZKI KLUB SPORTOWY 1924 (CKS) Czeladź,Sezon 2005/2006
2006-01-07 18:00,Znicz Basket Pruszków(d),93 : 83W,93,27,40,67.5,7,21,33.3,34,61,55.7,18,20,90.0,8,21,29,22,15,0,20,18,3,0,116,CZELADZKI KLUB SPORTOWY 1924 (CKS) Czeladź,Sezon 2005/2006
2006-01-11 16:00,PBG Basket Poznań(w),75 : 80W,80,25,40,62.5,5,17,29.4,30,57,52.6,15,16,93.8,5,17,22,6,22,0,15,13,1,0,79,CZELADZKI KLUB SPORTOWY 1924 (CKS) Czeladź,Sezon 2005/2006
2006-01-14 17:00,KS Legion Legionowo(w),64 : 58P,58,13,31,41.9,8,27,29.6,21,58,36.2,8,14,57.1,6,18,24,8,23,0,16,15,0,0,46,CZELADZKI KLUB SPORTOWY 1924 (CKS) Czeladź,Sezon 2005/2006
2006-01-22 18:00,KS AZS AWF Katowice(d),93 : 82W,93,29,41,70.7,6,17,35.3,35,58,60.3,17,17,100.0,7,17,24,29,17,0,25,19,2,0,119,CZELADZKI KLUB SPORTOWY 1924 (CKS) Czeladź,Sezon 2005/2006
2006-01-25 17:00,Basket Kwidzyn(w),74 : 72P,72,27,43,62.8,1,13,7.7,28,56,50.0,15,22,68.2,6,25,31,10,20,0,16,5,2,0,69,CZELADZKI KLUB SPORTOWY 1924 (CKS) Czeladź,Sezon 2005/2006
2006-01-28 18:00,PTG Sokół Łańcut(d),87 : 80W,87,20,28,71.4,7,17,41.2,27,45,60.0,26,30,86.7,8,23,31,18,25,0,27,12,1,0,100,CZELADZKI KLUB SPORTOWY 1924 (CKS) Czeladź,Sezon 2005/2006
2006-02-04 17:00,Stal Stalowa Wola(w),88 : 66P,66,22,41,53.7,5,16,31.3,27,57,47.4,7,16,43.8,6,24,30,12,20,0,22,10,1,0,58,CZELADZKI KLUB SPORTOWY 1924 (CKS) Czeladź,Sezon 2005/2006
2006-02-08 18:00,Górnik Wałbrzych(d),104 : 99W,104,18,29,62.1,14,18,77.8,32,47,68.1,26,37,70.3,2,16,18,29,23,0,24,12,1,0,114,CZELADZKI KLUB SPORTOWY 1924 (CKS) Czeladź,Sezon 2005/2006
2006-02-11 18:30,Siarka Tarnobrzeg(w),76 : 63P,63,16,27,59.3,6,21,28.6,22,48,45.8,13,16,81.3,2,22,24,8,24,0,23,17,1,0,61,CZELADZKI KLUB SPORTOWY 1924 (CKS) Czeladź,Sezon 2005/2006
2006-02-18 18:00,Spójnia Stargard Szcz.(d),94 : 69W,94,27,45,60.0,10,26,38.5,37,71,52.1,10,14,71.4,10,21,31,22,17,0,14,17,2,0,114,CZELADZKI KLUB SPORTOWY 1924 (CKS) Czeladź,Sezon 2005/2006
2006-02-22 17:00,AZS Politechnika Radomska(w),71 : 77W,77,15,39,38.5,10,22,45.5,25,61,41.0,17,27,63.0,10,13,23,6,25,0,11,6,4,0,59,CZELADZKI KLUB SPORTOWY 1924 (CKS) Czeladź,Sezon 2005/2006
2006-02-25 18:00,Grono Zielona Góra(d),83 : 66W,83,23,35,65.7,6,14,42.9,29,49,59.2,19,24,79.2,7,28,35,16,19,0,23,8,1,0,95,CZELADZKI KLUB SPORTOWY 1924 (CKS) Czeladź,Sezon 2005/2006
2006-03-04 17:00,Sportowiec Częstochowa(w),92 : 99W,99,27,48,56.3,10,29,34.5,37,77,48.1,15,19,78.9,8,24,32,22,25,0,9,19,1,0,120,CZELADZKI KLUB SPORTOWY 1924 (CKS) Czeladź,Sezon 2005/2006
2006-03-11 18:00,Viking Gdynia(d),87 : 74W,87,20,31,64.5,10,23,43.5,30,54,55.6,17,23,73.9,4,26,30,18,17,0,14,10,0,0,101,CZELADZKI KLUB SPORTOWY 1924 (CKS) Czeladź,Sezon 2005/2006
2006-03-18 18:00,Basket Kwidzyn(d),84 : 86P,84,18,33,54.5,7,20,35.0,25,53,47.2,27,29,93.1,5,22,27,15,22,0,12,8,3,0,95,CZELADZKI KLUB SPORTOWY 1924 (CKS) Czeladź,Sezon 2005/2006
2006-03-19 18:00,Basket Kwidzyn(d),90 : 80W,90,30,51,58.8,3,12,25.0,33,63,52.4,21,24,87.5,12,25,37,11,26,0,12,9,0,0,102,CZELADZKI KLUB SPORTOWY 1924 (CKS) Czeladź,Sezon 2005/2006
2006-03-25 18:00,Basket Kwidzyn(w),79 : 80W,80,29,42,69.0,5,16,31.3,34,58,58.6,7,13,53.8,4,22,26,16,24,0,15,7,2,0,86,CZELADZKI KLUB SPORTOWY 1924 (CKS) Czeladź,Sezon 2005/2006
2006-03-26 18:00,Basket Kwidzyn(w),70 : 74W,74,18,40,45.0,6,17,35.3,24,57,42.1,20,25,80.0,11,23,34,9,20,0,17,7,2,0,71,CZELADZKI KLUB SPORTOWY 1924 (CKS) Czeladź,Sezon 2005/2006
2006-04-01 17:30,Sokołów Znicz Jarosław(w),74 : 59P,59,15,40,37.5,7,26,26.9,22,66,33.3,8,13,61.5,6,18,24,12,27,0,15,10,1,0,42,CZELADZKI KLUB SPORTOWY 1924 (CKS) Czeladź,Sezon 2005/2006
2006-04-02 17:00,Sokołów Znicz Jarosław(w),80 : 72P,72,15,36,41.7,8,25,32.0,23,61,37.7,18,23,78.3,10,13,23,13,25,0,14,8,1,0,60,CZELADZKI KLUB SPORTOWY 1924 (CKS) Czeladź,Sezon 2005/2006
2006-04-08 18:00,Sokołów Znicz Jarosław(d),79 : 96P,79,22,45,48.9,6,23,26.1,28,68,41.2,17,19,89.5,12,10,22,9,23,0,10,15,0,0,73,CZELADZKI KLUB SPORTOWY 1924 (CKS) Czeladź,Sezon 2005/2006
2005-10-01 18:00,Viking Gdynia(w),89 : 94W,94,16,25,64.0,15,39,38.5,31,64,48.4,17,23,73.9,12,22,34,15,25,0,13,10,1,0,102,KS Legion Legionowo,Sezon 2005/2006
2005-10-08 17:30,Sokołów Znicz Jarosław(w),61 : 78W,78,11,16,68.8,14,30,46.7,25,46,54.3,14,22,63.6,5,22,27,16,22,0,24,14,1,0,83,KS Legion Legionowo,Sezon 2005/2006
2005-10-12 17:00,Znicz Basket Pruszków(d),81 : 83P,81,13,32,40.6,11,32,34.4,24,64,37.5,22,36,61.1,13,20,33,8,21,0,12,13,0,0,69,KS Legion Legionowo,Sezon 2005/2006
2005-10-15 18:00,CZELADZKI KLUB SPORTOWY 1924 (CKS) Czeladź(w),101 : 87P,87,17,35,48.6,14,36,38.9,31,71,43.7,11,18,61.1,13,16,29,15,25,0,16,8,0,0,76,KS Legion Legionowo,Sezon 2005/2006
2005-10-22 14:30,PBG Basket Poznań(d),96 : 77W,96,22,33,66.7,10,30,33.3,32,63,50.8,22,24,91.7,11,24,35,17,31,0,19,13,0,0,109,KS Legion Legionowo,Sezon 2005/2006
2005-10-26 18:00,KS AZS AWF Katowice(d),82 : 88P,82,19,35,54.3,9,27,33.3,28,62,45.2,17,23,73.9,12,13,25,14,19,0,21,15,2,0,77,KS Legion Legionowo,Sezon 2005/2006
2005-10-29 17:00,Basket Kwidzyn(w),81 : 73P,73,21,33,63.6,6,16,37.5,27,49,55.1,13,21,61.9,3,23,26,10,27,0,19,9,0,0,69,KS Legion Legionowo,Sezon 2005/2006
2005-11-05 14:30,PTG Sokół Łańcut(d),74 : 85P,74,17,26,65.4,8,29,27.6,25,55,45.5,16,22,72.7,7,21,28,14,26,0,26,7,0,0,61,KS Legion Legionowo,Sezon 2005/2006
2005-11-09 18:00,Stal Stalowa Wola(w),94 : 87P,87,22,41,53.7,7,28,25.0,29,69,42.0,22,29,75.9,13,21,34,16,24,0,17,9,3,0,85,KS Legion Legionowo,Sezon 2005/2006
2005-11-12 17:00,Górnik Wałbrzych(d),82 : 85P,82,13,25,52.0,15,31,48.4,28,56,50.0,11,18,61.1,6,15,21,17,22,0,13,12,2,0,86,KS Legion Legionowo,Sezon 2005/2006
2005-11-19 18:30,Siarka Tarnobrzeg(w),75 : 69P,69,20,39,51.3,4,19,21.1,24,58,41.4,17,25,68.0,11,16,27,7,25,0,17,15,1,0,60,KS Legion Legionowo,Sezon 2005/2006
2005-11-23 18:00,Spójnia Stargard Szcz.(d),68 : 80P,68,22,42,52.4,1,23,4.3,23,65,35.4,21,27,77.8,17,17,34,11,19,0,16,11,1,0,61,KS Legion Legionowo,Sezon 2005/2006
2005-11-26 18:00,AZS Politechnika Radomska(w),87 : 75P,75,22,42,52.4,6,26,23.1,28,68,41.2,13,18,72.2,11,9,20,11,24,0,14,12,3,0,62,KS Legion Legionowo,Sezon 2005/2006
2005-12-03 17:00,Grono Zielona Góra(d),55 : 62P,55,12,27,44.4,8,18,44.4,20,45,44.4,7,15,46.7,4,21,25,13,23,0,21,12,3,0,54,KS Legion Legionowo,Sezon 2005/2006
2005-12-10 17:00,Sportowiec Częstochowa(w),77 : 88W,88,19,36,52.8,9,34,26.5,28,70,40.0,23,28,82.1,13,20,33,15,20,0,20,14,1,0,84,KS Legion Legionowo,Sezon 2005/2006
2005-12-17 17:00,Viking Gdynia(d),62 : 61W,62,14,38,36.8,8,22,36.4,22,60,36.7,10,14,71.4,10,25,35,11,22,0,12,9,3,0,66,KS Legion Legionowo,Sezon 2005/2006
2006-01-07 17:00,Sokołów Znicz Jarosław(d),81 : 80W,81,21,32,65.6,9,24,37.5,30,56,53.6,12,22,54.5,9,18,27,21,22,0,21,16,1,0,89,KS Legion Legionowo,Sezon 2005/2006
2006-01-11 18:00,Znicz Basket Pruszków(w),70 : 80W,80,24,36,66.7,5,28,17.9,29,64,45.3,17,30,56.7,12,24,36,12,25,0,19,14,3,0,78,KS Legion Legionowo,Sezon 2005/2006
2006-01-14 17:00,CZELADZKI KLUB SPORTOWY 1924 (CKS) Czeladź(d),64 : 58W,64,13,30,43.3,6,17,35.3,19,47,40.4,20,26,76.9,12,26,38,13,18,0,27,10,1,0,65,KS Legion Legionowo,Sezon 2005/2006
2006-01-25 19:00,KS AZS AWF Katowice(w),70 : 78W,78,14,36,38.9,7,19,36.8,21,55,38.2,29,41,70.7,9,23,32,17,19,0,19,22,3,0,87,KS Legion Legionowo,Sezon 2005/2006
2006-01-28 18:00,Basket Kwidzyn(d),79 : 73W,79,23,38,60.5,4,16,25.0,27,54,50.0,21,38,55.3,6,29,35,10,25,0,11,10,2,0,81,KS Legion Legionowo,Sezon 2005/2006
2006-02-04 17:30,PTG Sokół Łańcut(w),64 : 75W,75,15,32,46.9,8,26,30.8,23,58,39.7,21,24,87.5,10,29,39,11,22,0,14,9,3,0,85,KS Legion Legionowo,Sezon 2005/2006
2006-02-08 18:30,Stal Stalowa Wola(d),78 : 76W,78,25,47,53.2,5,20,25.0,30,67,44.8,13,28,46.4,17,28,45,17,26,0,17,8,0,0,79,KS Legion Legionowo,Sezon 2005/2006
2006-02-11 18:30,Górnik Wałbrzych(w),78 : 58P,58,18,35,51.4,4,27,14.8,22,62,35.5,10,15,66.7,12,15,27,11,23,0,18,10,1,0,44,KS Legion Legionowo,Sezon 2005/2006
2006-02-18 15:00,Siarka Tarnobrzeg(d),75 : 64W,75,24,43,55.8,2,13,15.4,26,56,46.4,21,33,63.6,9,20,29,18,26,0,19,17,3,0,81,KS Legion Legionowo,Sezon 2005/2006
2006-02-22 18:00,Spójnia Stargard Szcz.(w),81 : 63P,63,18,43,41.9,2,19,10.5,20,62,32.3,21,25,84.0,17,20,37,8,20,0,11,10,5,0,66,KS Legion Legionowo,Sezon 2005/2006
2006-02-25 14:00,AZS Politechnika Radomska(d),69 : 65W,69,21,44,47.7,5,29,17.2,26,73,35.6,12,16,75.0,16,27,43,14,24,0,19,9,3,0,68,KS Legion Legionowo,Sezon 2005/2006
2006-03-01 16:00,PBG Basket Poznań(w),98 : 82P,82,21,45,46.7,8,23,34.8,29,68,42.6,16,22,72.7,13,17,30,17,28,0,21,9,0,0,72,KS Legion Legionowo,Sezon 2005/2006
2006-03-04 17:00,Grono Zielona Góra(w),86 : 69P,69,14,31,45.2,8,20,40.0,22,51,43.1,17,25,68.0,11,23,34,10,18,0,10,4,1,0,71,KS Legion Legionowo,Sezon 2005/2006
2006-03-11 17:00,Sportowiec Częstochowa(d),79 : 76W,79,26,46,56.5,4,20,20.0,30,66,45.5,15,25,60.0,12,20,32,13,21,0,22,17,3,0,76,KS Legion Legionowo,Sezon 2005/2006
2006-03-18 17:00,KS AZS AWF Katowice(d),87 : 77W,87,27,46,58.7,6,13,46.2,33,59,55.9,15,24,62.5,12,22,34,16,18,0,19,11,2,0,96,KS Legion Legionowo,Sezon 2005/2006
2006-03-22 19:00,KS AZS AWF Katowice(w),90 : 77P,77,23,45,51.1,2,13,15.4,25,58,43.1,25,32,78.1,10,21,31,13,19,0,22,12,3,0,74,KS Legion Legionowo,Sezon 2005/2006
2006-03-25 19:00,KS AZS AWF Katowice(d),71 : 65W,71,22,47,46.8,4,12,33.3,26,59,44.1,15,28,53.6,14,28,42,17,28,0,20,14,1,0,79,KS Legion Legionowo,Sezon 2005/2006
2005-10-01 18:00,Znicz Basket Pruszków(w),68 : 66P,66,15,39,38.5,5,21,23.8,20,60,33.3,21,30,70.0,15,20,35,7,25,0,14,14,2,0,61,PBG Basket Poznań,Sezon 2005/2006
2005-10-08 16:30,Siarka Tarnobrzeg(d),87 : 79W,87,26,47,55.3,5,16,31.3,31,63,49.2,20,27,74.1,4,29,33,1,30,0,16,17,0,0,83,PBG Basket Poznań,Sezon 2005/2006
2005-10-12 18:00,CZELADZKI KLUB SPORTOWY 1924 (CKS) Czeladź(w),96 : 71P,71,26,57,45.6,5,14,35.7,31,71,43.7,4,9,44.4,13,19,32,8,26,0,11,6,2,0,63,PBG Basket Poznań,Sezon 2005/2006
2005-10-15 17:00,Spójnia Stargard Szcz.(d),79 : 88P,79,24,47,51.1,7,26,26.9,31,73,42.5,10,16,62.5,15,18,33,6,25,0,11,12,1,0,72,PBG Basket Poznań,Sezon 2005/2006
2005-10-22 14:30,KS Legion Legionowo(w),96 : 77P,77,23,43,53.5,3,17,17.6,26,60,43.3,22,33,66.7,5,13,18,4,24,0,16,12,0,0,50,PBG Basket Poznań,Sezon 2005/2006
2005-10-26 16:00,AZS Politechnika Radomska(d),81 : 75W,81,23,41,56.1,6,16,37.5,29,57,50.9,17,20,85.0,11,26,37,12,24,0,23,15,1,0,92,PBG Basket Poznań,Sezon 2005/2006
2005-10-30 17:00,KS AZS AWF Katowice(w),116 : 107P,107,35,53,66.0,2,14,14.3,37,67,55.2,31,45,68.9,17,21,38,15,27,0,19,10,1,0,108,PBG Basket Poznań,Sezon 2005/2006
2005-11-06 17:00,Grono Zielona Góra(d),69 : 65W,69,19,36,52.8,3,16,18.8,22,52,42.3,22,26,84.6,5,22,27,6,19,0,18,19,2,0,71,PBG Basket Poznań,Sezon 2005/2006
2005-11-09 17:00,Basket Kwidzyn(w),75 : 65P,65,15,31,48.4,6,20,30.0,21,51,41.2,17,20,85.0,4,15,19,4,24,0,14,11,0,0,52,PBG Basket Poznań,Sezon 2005/2006
2005-11-12 18:00,Sportowiec Częstochowa(d),75 : 82P,75,23,60,38.3,6,22,27.3,29,82,35.4,11,14,78.6,15,15,30,12,24,0,9,17,0,0,69,PBG Basket Poznań,Sezon 2005/2006
2005-11-19 18:30,PTG Sokół Łańcut(w),90 : 83P,83,30,56,53.6,3,16,18.8,33,72,45.8,14,18,77.8,14,22,36,6,24,0,15,12,2,0,81,PBG Basket Poznań,Sezon 2005/2006
2005-11-23 16:00,Viking Gdynia(d),84 : 90P,84,20,39,51.3,9,27,33.3,29,66,43.9,17,24,70.8,10,18,28,12,22,0,15,14,2,0,81,PBG Basket Poznań,Sezon 2005/2006
2005-11-26 17:00,Stal Stalowa Wola(w),92 : 75P,75,21,41,51.2,6,19,31.6,27,60,45.0,15,23,65.2,10,16,26,7,24,0,11,12,2,0,70,PBG Basket Poznań,Sezon 2005/2006
2005-12-03 17:00,Sokołów Znicz Jarosław(d),89 : 94P,89,18,41,43.9,11,23,47.8,29,64,45.3,20,26,76.9,10,14,24,10,25,0,12,13,3,0,86,PBG Basket Poznań,Sezon 2005/2006
2005-12-10 17:00,Górnik Wałbrzych(w),76 : 68P,68,15,41,36.6,7,26,26.9,22,67,32.8,17,26,65.4,10,20,30,4,22,0,14,12,1,0,47,PBG Basket Poznań,Sezon 2005/2006
2005-12-17 17:00,Znicz Basket Pruszków(d),89 : 85W,89,17,34,50.0,11,31,35.5,28,65,43.1,22,31,71.0,14,15,29,10,25,0,18,23,1,0,88,PBG Basket Poznań,Sezon 2005/2006
2006-01-07 18:30,Siarka Tarnobrzeg(w),83 : 90W,90,18,36,50.0,6,15,40.0,24,51,47.1,36,43,83.7,13,28,41,10,22,0,20,6,0,0,93,PBG Basket Poznań,Sezon 2005/2006
2006-01-11 16:00,CZELADZKI KLUB SPORTOWY 1924 (CKS) Czeladź(d),75 : 80P,75,22,43,51.2,5,23,21.7,27,66,40.9,16,23,69.6,18,19,37,11,21,0,16,15,3,0,79,PBG Basket Poznań,Sezon 2005/2006
2006-01-14 17:00,Spójnia Stargard Szcz.(w),62 : 59P,59,20,52,38.5,4,17,23.5,24,69,34.8,7,8,87.5,13,23,36,7,22,0,11,6,1,0,52,PBG Basket Poznań,Sezon 2005/2006
2006-01-25 17:00,AZS Politechnika Radomska(w),77 : 69P,69,13,38,34.2,8,24,33.3,21,62,33.9,19,25,76.0,10,20,30,7,21,0,12,8,1,0,56,PBG Basket Poznań,Sezon 2005/2006
2006-01-28 17:00,KS AZS AWF Katowice(d),99 : 80W,99,24,47,51.1,8,14,57.1,32,61,52.5,27,33,81.8,9,25,34,19,16,0,20,14,5,0,116,PBG Basket Poznań,Sezon 2005/2006
2006-02-04 17:00,Grono Zielona Góra(w),76 : 68P,68,17,41,41.5,4,12,33.3,21,53,39.6,22,35,62.9,9,21,30,9,29,0,13,9,0,0,58,PBG Basket Poznań,Sezon 2005/2006
2006-02-08 16:00,Basket Kwidzyn(d),89 : 86W,89,25,51,49.0,5,18,27.8,30,69,43.5,24,31,77.4,12,22,34,10,21,0,10,13,2,0,92,PBG Basket Poznań,Sezon 2005/2006
2006-02-11 17:00,Sportowiec Częstochowa(w),80 : 91W,91,17,36,47.2,10,28,35.7,27,64,42.2,27,36,75.0,14,23,37,13,28,0,18,12,1,0,90,PBG Basket Poznań,Sezon 2005/2006
2006-02-18 17:30,PTG Sokół Łańcut(d),87 : 93P,87,18,35,51.4,8,27,29.6,26,62,41.9,27,33,81.8,10,19,29,15,37,0,18,12,2,0,85,PBG Basket Poznań,Sezon 2005/2006
2006-02-22 18:00,Viking Gdynia(w),79 : 81W,81,23,40,57.5,6,14,42.9,29,54,53.7,17,22,77.3,3,20,23,8,22,0,13,8,0,0,77,PBG Basket Poznań,Sezon 2005/2006
2006-02-25 18:00,Stal Stalowa Wola(d),86 : 97P,86,25,52,48.1,6,19,31.6,31,71,43.7,18,23,78.3,13,24,37,16,19,0,12,10,2,0,94,PBG Basket Poznań,Sezon 2005/2006
2006-03-01 16:00,KS Legion Legionowo(d),98 : 82W,98,27,49,55.1,6,14,42.9,33,63,52.4,26,27,96.3,8,19,27,12,20,0,17,19,2,0,110,PBG Basket Poznań,Sezon 2005/2006
2006-03-04 17:00,Sokołów Znicz Jarosław(w),90 : 76P,76,29,61,47.5,2,10,20.0,31,71,43.7,12,12,100.0,9,18,27,7,19,0,14,4,2,0,62,PBG Basket Poznań,Sezon 2005/2006
2006-03-11 17:00,Górnik Wałbrzych(d),106 : 86W,106,32,47,68.1,5,19,26.3,37,66,56.1,27,35,77.1,11,14,25,15,21,0,22,20,1,0,108,PBG Basket Poznań,Sezon 2005/2006
2006-03-18 16:00,Sportowiec Częstochowa(w),88 : 73P,73,20,40,50.0,6,21,28.6,26,61,42.6,15,20,75.0,10,21,31,11,25,0,11,11,2,0,77,PBG Basket Poznań,Sezon 2005/2006
2006-03-22 16:00,Sportowiec Częstochowa(d),105 : 78W,105,27,47,57.4,10,24,41.7,37,71,52.1,21,32,65.6,13,28,41,16,22,0,15,8,5,0,115,PBG Basket Poznań,Sezon 2005/2006
2006-03-27 17:00,Sportowiec Częstochowa(w),91 : 77P,77,20,43,46.5,6,19,31.6,26,62,41.9,19,26,73.1,11,20,31,11,24,0,20,10,4,0,70,PBG Basket Poznań,Sezon 2005/2006
2006-04-01 17:00,KS AZS AWF Katowice(d),98 : 76W,98,30,48,62.5,7,14,50.0,37,62,59.7,17,25,68.0,11,28,39,19,21,0,15,8,3,0,119,PBG Basket Poznań,Sezon 2005/2006
2006-04-02 16:00,KS AZS AWF Katowice(d),86 : 71W,86,27,45,60.0,3,14,21.4,30,59,50.8,23,27,85.2,11,23,34,16,16,0,16,13,5,0,105,PBG Basket Poznań,Sezon 2005/2006
2006-04-08 17:30,KS AZS AWF Katowice(w),74 : 67P,67,26,40,65.0,2,14,14.3,28,54,51.9,9,17,52.9,7,22,29,12,26,0,18,19,2,0,77,PBG Basket Poznań,Sezon 2005/2006
2006-04-09 19:30,KS AZS AWF Katowice(w),51 : 72W,72,23,44,52.3,2,14,14.3,25,58,43.1,20,32,62.5,6,16,22,15,23,0,13,26,1,0,78,PBG Basket Poznań,Sezon 2005/2006
2005-10-02 17:00,KS AZS AWF Katowice(w),86 : 100W,100,31,53,58.5,7,14,50.0,38,67,56.7,17,23,73.9,13,19,32,19,22,0,17,8,2,0,109,Sportowiec Częstochowa,Sezon 2005/2006
2005-10-08 18:00,Basket Kwidzyn(d),76 : 96P,76,26,44,59.1,3,10,30.0,29,54,53.7,15,30,50.0,7,16,23,18,23,0,12,12,4,0,81,Sportowiec Częstochowa,Sezon 2005/2006
2005-10-12 17:30,PTG Sokół Łańcut(w),71 : 57P,57,20,45,44.4,2,13,15.4,22,58,37.9,11,17,64.7,9,17,26,10,17,0,15,8,4,0,48,Sportowiec Częstochowa,Sezon 2005/2006
2005-10-16 16:00,Stal Stalowa Wola(d),77 : 79P,77,27,51,52.9,4,22,18.2,31,73,42.5,11,15,73.3,12,28,40,22,25,0,17,9,3,0,88,Sportowiec Częstochowa,Sezon 2005/2006
2005-10-22 19:00,Górnik Wałbrzych(w),99 : 90P,90,18,40,45.0,8,24,33.3,26,64,40.6,30,37,81.1,10,20,30,13,20,0,13,6,3,0,84,Sportowiec Częstochowa,Sezon 2005/2006
2005-10-26 19:00,Siarka Tarnobrzeg(d),80 : 63W,80,27,52,51.9,5,18,27.8,32,70,45.7,11,15,73.3,16,28,44,24,20,0,18,9,10,0,107,Sportowiec Częstochowa,Sezon 2005/2006
2005-10-29 17:00,Spójnia Stargard Szcz.(w),88 : 96W,96,22,34,64.7,9,18,50.0,31,52,59.6,25,32,78.1,5,22,27,15,17,0,17,7,4,0,104,Sportowiec Częstochowa,Sezon 2005/2006
2005-11-05 16:00,AZS Politechnika Radomska(d),89 : 81W,89,25,42,59.5,11,26,42.3,36,68,52.9,6,7,85.7,10,25,35,28,16,0,11,10,6,0,124,Sportowiec Częstochowa,Sezon 2005/2006
2005-11-09 18:00,Grono Zielona Góra(w),60 : 89W,89,26,44,59.1,6,15,40.0,32,59,54.2,19,22,86.4,5,31,36,16,18,0,12,6,2,0,107,Sportowiec Częstochowa,Sezon 2005/2006
2005-11-12 18:00,PBG Basket Poznań(w),75 : 82W,82,25,41,61.0,5,17,29.4,30,58,51.7,17,26,65.4,9,24,33,17,19,0,19,4,3,0,83,Sportowiec Częstochowa,Sezon 2005/2006
2005-11-19 18:00,Viking Gdynia(d),86 : 89P,86,20,35,57.1,5,13,38.5,25,48,52.1,31,41,75.6,5,22,27,14,25,0,9,9,4,0,98,Sportowiec Częstochowa,Sezon 2005/2006
2005-11-23 17:30,Sokołów Znicz Jarosław(w),96 : 79P,79,19,42,45.2,12,27,44.4,31,69,44.9,5,8,62.5,9,16,25,12,27,0,18,6,2,0,65,Sportowiec Częstochowa,Sezon 2005/2006
2005-11-26 16:00,Znicz Basket Pruszków(d),101 : 89W,101,19,38,50.0,14,28,50.0,33,66,50.0,21,28,75.0,14,23,37,28,19,0,21,18,8,0,131,Sportowiec Częstochowa,Sezon 2005/2006
2005-12-03 18:00,CZELADZKI KLUB SPORTOWY 1924 (CKS) Czeladź(w),92 : 86P,86,18,43,41.9,10,20,50.0,28,63,44.4,20,21,95.2,14,19,33,16,27,0,18,9,0,0,90,Sportowiec Częstochowa,Sezon 2005/2006
2005-12-10 17:00,KS Legion Legionowo(d),77 : 88P,77,20,39,51.3,10,22,45.5,30,61,49.2,7,8,87.5,7,28,35,25,25,0,22,11,2,0,96,Sportowiec Częstochowa,Sezon 2005/2006
2005-12-17 16:00,KS AZS AWF Katowice(d),99 : 79W,99,37,58,63.8,3,11,27.3,40,69,58.0,16,19,84.2,15,21,36,34,16,0,12,14,4,0,143,Sportowiec Częstochowa,Sezon 2005/2006
2006-01-07 17:00,Basket Kwidzyn(w),56 : 53P,53,19,50,38.0,2,13,15.4,21,63,33.3,9,14,64.3,10,21,31,8,19,0,10,5,4,0,44,Sportowiec Częstochowa,Sezon 2005/2006
2006-01-11 19:00,PTG Sokół Łańcut(d),93 : 86W,93,23,37,62.2,8,20,40.0,31,57,54.4,23,27,85.2,7,32,39,21,26,0,21,14,6,0,122,Sportowiec Częstochowa,Sezon 2005/2006
2006-01-14 17:00,Stal Stalowa Wola(w),74 : 83W,83,27,52,51.9,5,18,27.8,32,70,45.7,14,19,73.7,12,30,42,17,14,0,11,7,2,0,97,Sportowiec Częstochowa,Sezon 2005/2006
2006-01-22 16:00,Górnik Wałbrzych(d),75 : 72W,75,17,37,45.9,8,19,42.1,25,56,44.6,17,21,81.0,5,36,41,20,20,0,15,5,5,0,96,Sportowiec Częstochowa,Sezon 2005/2006
2006-01-25 18:00,Siarka Tarnobrzeg(w),81 : 53P,53,20,44,45.5,3,17,17.6,23,61,37.7,4,8,50.0,5,20,25,13,18,0,17,13,3,0,48,Sportowiec Częstochowa,Sezon 2005/2006
2006-01-28 17:00,Spójnia Stargard Szcz.(d),99 : 76W,99,33,52,63.5,6,16,37.5,39,68,57.4,15,18,83.3,11,23,34,19,13,0,12,11,4,0,123,Sportowiec Częstochowa,Sezon 2005/2006
2006-02-04 18:00,AZS Politechnika Radomska(w),62 : 80W,80,22,40,55.0,8,19,42.1,30,59,50.8,12,15,80.0,5,23,28,9,21,0,8,7,5,0,89,Sportowiec Częstochowa,Sezon 2005/2006
2006-02-08 19:00,Grono Zielona Góra(d),70 : 74P,70,24,57,42.1,5,13,38.5,29,70,41.4,7,12,58.3,14,25,39,17,22,0,10,10,7,0,87,Sportowiec Częstochowa,Sezon 2005/2006
2006-02-11 17:00,PBG Basket Poznań(d),80 : 91P,80,23,46,50.0,6,17,35.3,29,63,46.0,16,20,80.0,12,23,35,13,33,0,21,13,3,0,85,Sportowiec Częstochowa,Sezon 2005/2006
2006-02-18 18:00,Viking Gdynia(w),95 : 88P,88,27,39,69.2,8,25,32.0,35,64,54.7,10,16,62.5,4,20,24,12,25,0,12,8,1,0,86,Sportowiec Częstochowa,Sezon 2005/2006
2006-02-22 19:00,Sokołów Znicz Jarosław(d),87 : 108P,87,26,56,46.4,6,24,25.0,32,80,40.0,17,20,85.0,15,20,35,20,26,0,12,13,9,0,101,Sportowiec Częstochowa,Sezon 2005/2006
2006-02-25 18:00,Znicz Basket Pruszków(w),77 : 58P,58,13,36,36.1,5,25,20.0,18,61,29.5,17,25,68.0,9,22,31,10,17,0,15,10,3,0,46,Sportowiec Częstochowa,Sezon 2005/2006
2006-03-04 17:00,CZELADZKI KLUB SPORTOWY 1924 (CKS) Czeladź(d),92 : 99P,92,31,54,57.4,6,22,27.3,37,76,48.7,12,21,57.1,18,30,48,27,23,0,20,5,4,0,108,Sportowiec Częstochowa,Sezon 2005/2006
2006-03-11 17:00,KS Legion Legionowo(w),79 : 76P,76,24,42,57.1,7,19,36.8,31,61,50.8,7,13,53.8,12,20,32,14,23,0,26,14,1,0,75,Sportowiec Częstochowa,Sezon 2005/2006
2006-03-18 16:00,PBG Basket Poznań(d),88 : 73W,88,25,47,53.2,6,17,35.3,31,64,48.4,20,25,80.0,12,28,40,19,21,0,15,10,3,0,107,Sportowiec Częstochowa,Sezon 2005/2006
2006-03-22 16:00,PBG Basket Poznań(w),105 : 78P,78,24,50,48.0,4,14,28.6,28,64,43.8,18,24,75.0,10,19,29,6,29,0,17,14,0,0,68,Sportowiec Częstochowa,Sezon 2005/2006
2006-03-27 17:00,PBG Basket Poznań(d),91 : 77W,91,27,53,50.9,7,14,50.0,34,67,50.7,16,23,69.6,12,25,37,16,25,0,15,14,7,0,110,Sportowiec Częstochowa,Sezon 2005/2006
2005-10-01 18:00,PBG Basket Poznań(d),68 : 66W,68,12,29,41.4,10,27,37.0,22,56,39.3,14,21,66.7,16,23,39,15,28,0,21,8,1,0,69,Znicz Basket Pruszków,Sezon 2005/2006
2005-10-08 18:00,CZELADZKI KLUB SPORTOWY 1924 (CKS) Czeladź(d),69 : 58W,69,16,38,42.1,7,23,30.4,23,61,37.7,16,26,61.5,9,26,35,12,22,0,16,15,0,0,67,Znicz Basket Pruszków,Sezon 2005/2006
2005-10-12 17:00,KS Legion Legionowo(w),81 : 83W,83,22,33,66.7,10,25,40.0,32,58,55.2,9,14,64.3,6,10,16,5,33,0,13,8,0,0,68,Znicz Basket Pruszków,Sezon 2005/2006
2005-10-15 18:00,KS AZS AWF Katowice(d),85 : 89P,85,25,48,52.1,8,23,34.8,33,71,46.5,11,13,84.6,5,27,32,14,23,0,18,10,5,0,88,Znicz Basket Pruszków,Sezon 2005/2006
2005-10-22 11:00,Basket Kwidzyn(w),100 : 68P,68,20,38,52.6,6,15,40.0,26,53,49.1,10,11,90.9,6,16,22,16,20,0,24,11,4,0,69,Znicz Basket Pruszków,Sezon 2005/2006
2005-10-26 18:00,PTG Sokół Łańcut(d),91 : 70W,91,19,35,54.3,11,29,37.9,30,64,46.9,20,24,83.3,17,24,41,18,21,0,18,11,3,0,108,Znicz Basket Pruszków,Sezon 2005/2006
2005-10-29 17:00,Stal Stalowa Wola(w),59 : 89W,89,18,41,43.9,14,24,58.3,32,65,49.2,11,17,64.7,9,33,42,16,26,0,23,16,6,0,107,Znicz Basket Pruszków,Sezon 2005/2006
2005-11-05 18:00,Górnik Wałbrzych(d),81 : 56W,81,24,32,75.0,7,19,36.8,31,51,60.8,12,18,66.7,7,29,36,19,21,0,29,13,5,0,99,Znicz Basket Pruszków,Sezon 2005/2006
2005-11-09 18:00,Siarka Tarnobrzeg(w),94 : 85P,85,19,32,59.4,10,31,32.3,29,63,46.0,17,21,81.0,12,25,37,10,27,0,23,9,0,0,80,Znicz Basket Pruszków,Sezon 2005/2006
2005-11-12 18:00,Spójnia Stargard Szcz.(d),71 : 83P,71,14,48,29.2,5,21,23.8,19,69,27.5,28,41,68.3,15,20,35,11,22,0,14,12,1,0,53,Znicz Basket Pruszków,Sezon 2005/2006
2005-11-19 18:00,AZS Politechnika Radomska(w),63 : 73W,73,20,39,51.3,8,20,40.0,28,59,47.5,9,13,69.2,7,29,36,11,19,0,15,2,1,0,73,Znicz Basket Pruszków,Sezon 2005/2006
2005-11-23 18:00,Grono Zielona Góra(d),82 : 76W,82,20,34,58.8,6,18,33.3,26,52,50.0,24,35,68.6,11,23,34,15,25,0,20,9,2,0,85,Znicz Basket Pruszków,Sezon 2005/2006
2005-11-26 16:00,Sportowiec Częstochowa(w),101 : 89P,89,19,42,45.2,12,26,46.2,31,68,45.6,15,18,83.3,9,16,25,18,22,0,19,13,3,0,89,Znicz Basket Pruszków,Sezon 2005/2006
2005-12-03 18:00,Viking Gdynia(d),86 : 75W,86,21,38,55.3,9,18,50.0,30,56,53.6,17,27,63.0,11,27,38,14,24,0,19,10,0,0,93,Znicz Basket Pruszków,Sezon 2005/2006
2005-12-11 17:00,Sokołów Znicz Jarosław(w),74 : 69P,69,15,36,41.7,11,35,31.4,26,71,36.6,6,10,60.0,15,19,34,9,26,0,14,7,1,0,57,Znicz Basket Pruszków,Sezon 2005/2006
2005-12-17 17:00,PBG Basket Poznań(w),89 : 85P,85,28,49,57.1,3,13,23.1,31,62,50.0,20,23,87.0,17,18,35,4,35,0,21,8,0,0,77,Znicz Basket Pruszków,Sezon 2005/2006
2006-01-07 18:00,CZELADZKI KLUB SPORTOWY 1924 (CKS) Czeladź(w),93 : 83P,83,20,35,57.1,11,24,45.8,31,59,52.5,10,13,76.9,9,18,27,19,23,0,27,10,1,0,82,Znicz Basket Pruszków,Sezon 2005/2006
2006-01-11 18:00,KS Legion Legionowo(d),70 : 80P,70,18,37,48.6,6,24,25.0,24,61,39.3,16,25,64.0,11,27,38,14,27,0,21,9,1,0,65,Znicz Basket Pruszków,Sezon 2005/2006
2006-01-15 17:00,KS AZS AWF Katowice(w),89 : 78P,78,21,40,52.5,4,18,22.2,25,58,43.1,24,30,80.0,7,21,28,13,22,0,14,13,0,0,79,Znicz Basket Pruszków,Sezon 2005/2006
2006-01-21 18:00,Basket Kwidzyn(d),69 : 80P,69,21,43,48.8,4,16,25.0,25,59,42.4,15,19,78.9,7,26,33,5,18,0,17,5,1,0,58,Znicz Basket Pruszków,Sezon 2005/2006
2006-01-25 17:30,PTG Sokół Łańcut(w),89 : 72P,72,18,37,48.6,7,21,33.3,25,58,43.1,15,19,78.9,9,20,29,14,27,0,19,14,0,0,73,Znicz Basket Pruszków,Sezon 2005/2006
2006-01-28 18:00,Stal Stalowa Wola(d),88 : 86W,88,24,42,57.1,8,19,42.1,32,61,52.5,16,27,59.3,9,15,24,19,28,0,19,10,2,0,84,Znicz Basket Pruszków,Sezon 2005/2006
2006-02-04 17:00,Górnik Wałbrzych(w),86 : 78P,78,15,30,50.0,11,25,44.0,26,55,47.3,15,22,68.2,7,19,26,14,25,0,18,9,4,0,77,Znicz Basket Pruszków,Sezon 2005/2006
2006-02-08 18:00,Siarka Tarnobrzeg(d),82 : 75W,82,23,42,54.8,6,22,27.3,29,64,45.3,18,23,78.3,13,27,40,9,30,0,22,13,0,0,82,Znicz Basket Pruszków,Sezon 2005/2006
2006-02-11 17:00,Spójnia Stargard Szcz.(w),86 : 69P,69,19,42,45.2,4,20,20.0,23,62,37.1,19,24,79.2,11,17,28,6,29,0,16,14,2,0,59,Znicz Basket Pruszków,Sezon 2005/2006
2006-02-19 18:00,AZS Politechnika Radomska(d),83 : 70W,83,17,38,44.7,11,30,36.7,28,68,41.2,16,20,80.0,13,24,37,17,29,0,19,18,3,0,95,Znicz Basket Pruszków,Sezon 2005/2006
2006-02-22 18:00,Grono Zielona Góra(w),84 : 71P,71,14,30,46.7,9,20,45.0,23,50,46.0,16,21,76.2,8,21,29,9,21,0,19,12,5,0,75,Znicz Basket Pruszków,Sezon 2005/2006
2006-02-25 18:00,Sportowiec Częstochowa(d),77 : 58W,77,21,40,52.5,7,26,26.9,28,66,42.4,14,17,82.4,13,31,44,13,26,0,19,11,3,0,88,Znicz Basket Pruszków,Sezon 2005/2006
2006-03-04 19:00,Viking Gdynia(w),87 : 73P,73,17,29,58.6,9,29,31.0,26,58,44.8,12,17,70.6,2,23,25,11,33,0,14,4,0,0,62,Znicz Basket Pruszków,Sezon 2005/2006
2006-03-11 17:00,Sokołów Znicz Jarosław(d),72 : 91P,72,21,40,52.5,8,27,29.6,29,67,43.3,6,9,66.7,7,16,23,12,24,0,13,14,3,0,70,Znicz Basket Pruszków,Sezon 2005/2006
2006-03-18 18:00,Siarka Tarnobrzeg(d),76 : 57W,76,26,53,49.1,5,20,25.0,31,73,42.5,9,14,64.3,16,22,38,17,23,0,11,16,5,0,94,Znicz Basket Pruszków,Sezon 2005/2006
2006-03-22 18:00,Siarka Tarnobrzeg(w),83 : 90W,90,20,35,57.1,10,19,52.6,30,54,55.6,20,25,80.0,5,13,18,12,31,0,21,18,2,0,90,Znicz Basket Pruszków,Sezon 2005/2006
2005-10-01 17:30,PTG Sokół Łańcut(w),84 : 53P,53,14,33,42.4,2,16,12.5,16,49,32.7,19,30,63.3,10,27,37,7,17,0,19,3,1,0,38,AZS Politechnika Radomska,Sezon 2005/2006
2005-10-08 18:00,Stal Stalowa Wola(d),70 : 66W,70,23,47,48.9,3,10,30.0,26,57,45.6,15,25,60.0,10,26,36,7,28,0,17,11,1,0,67,AZS Politechnika Radomska,Sezon 2005/2006
2005-10-12 18:00,Górnik Wałbrzych(w),99 : 81P,81,20,34,58.8,7,17,41.2,27,51,52.9,20,32,62.5,9,13,22,10,22,0,18,12,0,0,71,AZS Politechnika Radomska,Sezon 2005/2006
2005-10-15 18:00,Siarka Tarnobrzeg(d),71 : 57W,71,17,42,40.5,7,16,43.8,24,58,41.4,16,23,69.6,6,20,26,5,21,0,14,10,0,0,57,AZS Politechnika Radomska,Sezon 2005/2006
2005-10-19 17:30,Viking Gdynia(d),70 : 76P,70,18,53,34.0,8,21,38.1,26,74,35.1,10,14,71.4,14,18,32,8,22,0,8,12,1,0,63,AZS Politechnika Radomska,Sezon 2005/2006
2005-10-22 17:00,Spójnia Stargard Szcz.(w),73 : 68P,68,20,48,41.7,4,11,36.4,24,59,40.7,16,23,69.6,5,23,28,5,21,0,14,12,0,0,57,AZS Politechnika Radomska,Sezon 2005/2006
2005-10-26 16:00,PBG Basket Poznań(w),81 : 75P,75,24,43,55.8,4,17,23.5,28,60,46.7,15,24,62.5,9,13,22,2,21,0,14,15,0,0,59,AZS Politechnika Radomska,Sezon 2005/2006
2005-10-29 18:00,Grono Zielona Góra(d),58 : 77P,58,17,45,37.8,5,14,35.7,22,59,37.3,9,18,50.0,11,21,32,7,20,0,15,5,1,0,42,AZS Politechnika Radomska,Sezon 2005/2006
2005-11-05 16:00,Sportowiec Częstochowa(w),89 : 81P,81,17,46,37.0,12,19,63.2,29,65,44.6,11,14,78.6,7,19,26,15,13,0,14,7,0,0,76,AZS Politechnika Radomska,Sezon 2005/2006
2005-11-12 16:30,Sokołów Znicz Jarosław(w),93 : 77P,77,19,41,46.3,6,20,30.0,25,61,41.0,21,27,77.8,8,15,23,7,23,0,18,8,1,0,56,AZS Politechnika Radomska,Sezon 2005/2006
2005-11-19 18:00,Znicz Basket Pruszków(d),63 : 73P,63,16,45,35.6,9,19,47.4,25,64,39.1,4,7,57.1,7,22,29,9,18,0,14,8,2,0,55,AZS Politechnika Radomska,Sezon 2005/2006
2005-11-23 18:00,CZELADZKI KLUB SPORTOWY 1924 (CKS) Czeladź(w),93 : 78P,78,23,43,53.5,4,15,26.7,27,58,46.6,20,27,74.1,10,21,31,9,20,0,23,11,0,0,68,AZS Politechnika Radomska,Sezon 2005/2006
2005-11-26 18:00,KS Legion Legionowo(d),87 : 75W,87,18,30,60.0,9,16,56.3,27,46,58.7,24,34,70.6,8,27,35,22,17,0,21,11,0,0,105,AZS Politechnika Radomska,Sezon 2005/2006
2005-12-04 17:00,KS AZS AWF Katowice(w),89 : 85P,85,24,44,54.5,10,22,45.5,34,66,51.5,7,9,77.8,7,19,26,15,24,0,20,10,2,0,84,AZS Politechnika Radomska,Sezon 2005/2006
2005-12-10 18:00,Basket Kwidzyn(d),64 : 70P,64,19,46,41.3,6,11,54.5,25,57,43.9,8,14,57.1,3,24,27,11,22,0,10,8,0,0,62,AZS Politechnika Radomska,Sezon 2005/2006
2005-12-17 18:00,PTG Sokół Łańcut(d),84 : 78W,84,14,31,45.2,8,18,44.4,22,49,44.9,32,41,78.0,9,20,29,6,28,0,12,12,0,0,83,AZS Politechnika Radomska,Sezon 2005/2006
2006-01-07 17:00,Stal Stalowa Wola(w),91 : 87P,87,26,48,54.2,7,16,43.8,33,64,51.6,14,26,53.8,6,23,29,16,20,0,15,13,1,0,88,AZS Politechnika Radomska,Sezon 2005/2006
2006-01-15 17:00,Siarka Tarnobrzeg(w),79 : 52P,52,15,32,46.9,1,15,6.7,16,47,34.0,19,26,73.1,10,23,33,5,19,0,23,4,0,0,33,AZS Politechnika Radomska,Sezon 2005/2006
2006-01-18 16:00,Górnik Wałbrzych(d),77 : 57W,77,21,39,53.8,5,16,31.3,26,55,47.3,20,29,69.0,13,20,33,13,22,0,9,13,4,0,93,AZS Politechnika Radomska,Sezon 2005/2006
2006-01-21 18:00,Spójnia Stargard Szcz.(d),64 : 71P,64,21,52,40.4,3,18,16.7,24,70,34.3,13,17,76.5,17,17,34,10,15,0,5,13,0,0,66,AZS Politechnika Radomska,Sezon 2005/2006
2006-01-25 17:00,PBG Basket Poznań(d),77 : 69W,77,24,44,54.5,3,16,18.8,27,60,45.0,20,29,69.0,11,30,41,10,26,0,13,10,0,0,83,AZS Politechnika Radomska,Sezon 2005/2006
2006-01-28 15:00,Grono Zielona Góra(w),89 : 71P,71,18,49,36.7,3,13,23.1,21,62,33.9,26,32,81.3,9,28,37,7,23,0,15,5,1,0,59,AZS Politechnika Radomska,Sezon 2005/2006
2006-02-04 18:00,Sportowiec Częstochowa(d),62 : 80P,62,20,44,45.5,3,18,16.7,23,62,37.1,13,22,59.1,13,23,36,4,20,0,12,5,1,0,48,AZS Politechnika Radomska,Sezon 2005/2006
2006-02-08 19:00,Viking Gdynia(w),91 : 62P,62,16,43,37.2,4,18,22.2,20,61,32.8,18,22,81.8,7,19,26,8,20,0,15,5,0,0,41,AZS Politechnika Radomska,Sezon 2005/2006
2006-02-11 18:00,Sokołów Znicz Jarosław(d),65 : 90P,65,18,45,40.0,8,14,57.1,26,59,44.1,5,12,41.7,9,16,25,10,26,0,14,8,2,0,56,AZS Politechnika Radomska,Sezon 2005/2006
2006-02-19 18:00,Znicz Basket Pruszków(w),83 : 70P,70,18,39,46.2,4,16,25.0,22,55,40.0,22,34,64.7,8,21,29,11,25,0,20,13,1,0,59,AZS Politechnika Radomska,Sezon 2005/2006
2006-02-22 17:00,CZELADZKI KLUB SPORTOWY 1924 (CKS) Czeladź(d),71 : 77P,71,23,43,53.5,1,10,10.0,24,53,45.3,22,28,78.6,8,26,34,6,27,0,21,9,0,0,64,AZS Politechnika Radomska,Sezon 2005/2006
2006-02-25 14:00,KS Legion Legionowo(w),69 : 65P,65,16,44,36.4,6,13,46.2,22,57,38.6,15,25,60.0,9,21,30,9,22,0,18,10,0,0,51,AZS Politechnika Radomska,Sezon 2005/2006
2006-03-02 19:00,KS AZS AWF Katowice(d),79 : 67W,79,27,47,57.4,4,11,36.4,31,58,53.4,13,14,92.9,7,27,34,14,17,0,13,4,2,0,92,AZS Politechnika Radomska,Sezon 2005/2006
2006-03-11 17:00,Basket Kwidzyn(w),71 : 68P,68,26,45,57.8,3,15,20.0,29,60,48.3,7,9,77.8,5,17,22,6,22,0,16,8,1,0,56,AZS Politechnika Radomska,Sezon 2005/2006
2006-03-18 17:00,Górnik Wałbrzych(w),85 : 67P,67,16,40,40.0,5,12,41.7,21,52,40.4,20,25,80.0,4,20,24,9,24,0,17,8,1,0,56,AZS Politechnika Radomska,Sezon 2005/2006
2006-03-22 16:00,Górnik Wałbrzych(d),75 : 65W,75,19,33,57.6,9,20,45.0,28,53,52.8,10,17,58.8,7,23,30,17,23,0,16,11,2,0,87,AZS Politechnika Radomska,Sezon 2005/2006
2006-03-25 17:00,Górnik Wałbrzych(w),56 : 54P,54,13,38,34.2,8,21,38.1,21,59,35.6,4,4,100.0,4,27,31,7,16,0,13,16,4,0,61,AZS Politechnika Radomska,Sezon 2005/2006
2006-04-01 18:00,Siarka Tarnobrzeg(w),72 : 77W,77,23,46,50.0,5,11,45.5,28,57,49.1,16,18,88.9,3,17,20,11,21,0,17,17,2,0,79,AZS Politechnika Radomska,Sezon 2005/2006
2006-04-02 18:00,Siarka Tarnobrzeg(w),101 : 90P,90,22,42,52.4,7,13,53.8,29,55,52.7,25,26,96.2,4,14,18,11,27,0,16,16,3,0,95,AZS Politechnika Radomska,Sezon 2005/2006
2006-04-08 18:00,Siarka Tarnobrzeg(d),63 : 65P,63,28,56,50.0,1,6,16.7,29,62,46.8,4,7,57.1,8,29,37,7,18,0,15,9,0,0,65,AZS Politechnika Radomska,Sezon 2005/2006
2006-04-09 18:00,Siarka Tarnobrzeg(d),75 : 94P,75,22,46,47.8,6,15,40.0,28,61,45.9,13,17,76.5,9,23,32,8,20,0,6,5,1,0,78,AZS Politechnika Radomska,Sezon 2005/2006
2005-10-01 17:30,AZS Politechnika Radomska(d),84 : 53W,84,26,46,56.5,7,22,31.8,33,68,48.5,11,16,68.8,7,24,31,17,25,0,8,15,4,0,103,PTG Sokół Łańcut,Sezon 2005/2006
2005-10-09 18:00,Grono Zielona Góra(w),68 : 77W,77,19,39,48.7,6,15,40.0,25,54,46.3,21,31,67.7,6,24,30,15,24,0,12,10,0,0,81,PTG Sokół Łańcut,Sezon 2005/2006
2005-10-12 17:30,Sportowiec Częstochowa(d),71 : 57W,71,18,37,48.6,9,28,32.1,27,65,41.5,8,10,80.0,16,25,41,21,18,0,15,12,6,0,96,PTG Sokół Łańcut,Sezon 2005/2006
2005-10-16 17:00,Viking Gdynia(d),66 : 65W,66,13,31,41.9,8,21,38.1,21,52,40.4,16,19,84.2,6,22,28,14,17,0,11,17,3,0,83,PTG Sokół Łańcut,Sezon 2005/2006
2005-10-22 17:30,Sokołów Znicz Jarosław(d),83 : 77W,83,26,50,52.0,5,18,27.8,31,68,45.6,16,21,76.2,11,24,35,22,23,0,17,12,1,0,94,PTG Sokół Łańcut,Sezon 2005/2006
2005-10-26 18:00,Znicz Basket Pruszków(w),91 : 70P,70,16,36,44.4,6,27,22.2,22,63,34.9,20,26,76.9,10,15,25,14,22,0,16,12,2,0,60,PTG Sokół Łańcut,Sezon 2005/2006
2005-10-29 17:30,CZELADZKI KLUB SPORTOWY 1924 (CKS) Czeladź(d),87 : 84W,87,19,37,51.4,10,20,50.0,29,57,50.9,19,23,82.6,10,18,28,28,22,0,13,12,0,0,110,PTG Sokół Łańcut,Sezon 2005/2006
2005-11-05 14:30,KS Legion Legionowo(w),74 : 85W,85,30,51,58.8,3,16,18.8,33,67,49.3,16,21,76.2,11,20,31,9,25,0,13,11,3,0,87,PTG Sokół Łańcut,Sezon 2005/2006
2005-11-09 17:30,KS AZS AWF Katowice(d),84 : 82W,84,20,45,44.4,8,16,50.0,28,61,45.9,20,32,62.5,10,25,35,23,14,0,14,9,3,0,95,PTG Sokół Łańcut,Sezon 2005/2006
2005-11-12 17:00,Basket Kwidzyn(w),73 : 56P,56,19,44,43.2,3,13,23.1,22,57,38.6,9,11,81.8,7,19,26,9,19,0,14,7,1,0,48,PTG Sokół Łańcut,Sezon 2005/2006
2005-11-19 18:30,PBG Basket Poznań(d),90 : 83W,90,17,36,47.2,12,26,46.2,29,62,46.8,20,24,83.3,9,25,34,16,18,0,16,11,0,0,98,PTG Sokół Łańcut,Sezon 2005/2006
2005-11-23 17:30,Stal Stalowa Wola(d),73 : 78P,73,25,58,43.1,4,23,17.4,29,81,35.8,11,15,73.3,19,28,47,15,20,0,12,17,5,0,89,PTG Sokół Łańcut,Sezon 2005/2006
2005-11-27 18:00,Górnik Wałbrzych(w),76 : 75P,75,13,26,50.0,12,24,50.0,25,50,50.0,13,22,59.1,3,14,17,8,23,0,16,15,0,0,65,PTG Sokół Łańcut,Sezon 2005/2006
2005-12-03 18:30,Siarka Tarnobrzeg(d),82 : 57W,82,29,48,60.4,5,13,38.5,34,61,55.7,9,17,52.9,12,23,35,23,15,0,12,16,1,0,110,PTG Sokół Łańcut,Sezon 2005/2006
2005-12-10 17:00,Spójnia Stargard Szcz.(w),71 : 73W,73,20,45,44.4,7,20,35.0,27,65,41.5,12,20,60.0,11,18,29,9,17,0,9,9,4,0,69,PTG Sokół Łańcut,Sezon 2005/2006
2005-12-17 18:00,AZS Politechnika Radomska(w),84 : 78P,78,18,37,48.6,6,23,26.1,24,60,40.0,24,28,85.7,10,15,25,7,32,0,13,6,5,0,68,PTG Sokół Łańcut,Sezon 2005/2006
2006-01-07 17:30,Grono Zielona Góra(d),67 : 60W,67,18,38,47.4,6,19,31.6,24,57,42.1,13,22,59.1,8,27,35,20,22,0,10,13,1,0,84,PTG Sokół Łańcut,Sezon 2005/2006
2006-01-11 19:00,Sportowiec Częstochowa(w),93 : 86P,86,20,43,46.5,8,25,32.0,28,68,41.2,22,28,78.6,14,17,31,10,26,0,16,17,1,0,83,PTG Sokół Łańcut,Sezon 2005/2006
2006-01-14 18:00,Viking Gdynia(w),86 : 81P,81,18,37,48.6,11,27,40.7,29,64,45.3,12,18,66.7,8,18,26,9,22,0,11,11,1,0,76,PTG Sokół Łańcut,Sezon 2005/2006
2006-01-22 18:30,Sokołów Znicz Jarosław(w),80 : 68P,68,13,38,34.2,9,31,29.0,22,69,31.9,15,19,78.9,11,8,19,9,22,0,14,14,4,0,49,PTG Sokół Łańcut,Sezon 2005/2006
2006-01-25 17:30,Znicz Basket Pruszków(d),89 : 72W,89,21,39,53.8,6,22,27.3,27,61,44.3,29,32,90.6,11,26,37,18,21,0,15,16,3,0,111,PTG Sokół Łańcut,Sezon 2005/2006
2006-01-28 18:00,CZELADZKI KLUB SPORTOWY 1924 (CKS) Czeladź(w),87 : 80P,80,22,39,56.4,9,20,45.0,31,59,52.5,9,17,52.9,9,16,25,18,23,0,19,17,2,0,87,PTG Sokół Łańcut,Sezon 2005/2006
2006-02-04 17:30,KS Legion Legionowo(d),64 : 75P,64,14,32,43.8,7,26,26.9,21,58,36.2,15,18,83.3,6,21,27,12,19,0,14,15,6,0,70,PTG Sokół Łańcut,Sezon 2005/2006
2006-02-08 19:00,KS AZS AWF Katowice(w),90 : 86P,86,28,44,63.6,3,15,20.0,31,59,52.5,21,25,84.0,7,14,21,15,20,0,15,14,1,0,90,PTG Sokół Łańcut,Sezon 2005/2006
2006-02-11 17:30,Basket Kwidzyn(d),78 : 51W,78,23,45,51.1,6,12,50.0,29,57,50.9,14,21,66.7,14,26,40,16,14,0,11,12,5,0,105,PTG Sokół Łańcut,Sezon 2005/2006
2006-02-18 17:30,PBG Basket Poznań(w),87 : 93W,93,20,33,60.6,5,18,27.8,25,51,49.0,38,46,82.6,6,26,32,2,30,0,17,9,0,0,85,PTG Sokół Łańcut,Sezon 2005/2006
2006-02-22 18:00,Stal Stalowa Wola(w),74 : 81W,81,28,57,49.1,4,10,40.0,32,67,47.8,13,20,65.0,13,23,36,14,26,0,12,10,3,0,90,PTG Sokół Łańcut,Sezon 2005/2006
2006-02-25 17:30,Górnik Wałbrzych(d),84 : 65W,84,18,38,47.4,10,22,45.5,28,60,46.7,18,25,72.0,11,25,36,22,21,0,13,18,4,0,112,PTG Sokół Łańcut,Sezon 2005/2006
2006-03-04 18:30,Siarka Tarnobrzeg(w),75 : 77W,77,22,39,56.4,5,17,29.4,27,56,48.2,18,24,75.0,7,27,34,11,20,0,19,12,2,0,82,PTG Sokół Łańcut,Sezon 2005/2006
2006-03-11 17:30,Spójnia Stargard Szcz.(d),73 : 65W,73,22,44,50.0,5,16,31.3,27,60,45.0,14,18,77.8,7,21,28,18,13,0,8,10,2,0,86,PTG Sokół Łańcut,Sezon 2005/2006
2006-03-18 19:00,Viking Gdynia(d),78 : 65W,78,23,36,63.9,4,19,21.1,27,55,49.1,20,29,69.0,13,15,28,15,19,0,12,12,3,0,87,PTG Sokół Łańcut,Sezon 2005/2006
2006-03-19 16:30,Viking Gdynia(d),56 : 72P,56,13,38,34.2,4,24,16.7,17,62,27.4,18,19,94.7,11,23,34,12,23,0,10,9,0,0,55,PTG Sokół Łańcut,Sezon 2005/2006
2006-03-25 18:00,Viking Gdynia(w),91 : 69P,69,25,44,56.8,3,17,17.6,28,61,45.9,10,12,83.3,6,16,22,7,16,0,9,10,1,0,65,PTG Sokół Łańcut,Sezon 2005/2006
2006-03-26 18:00,Viking Gdynia(w),78 : 66P,66,18,35,51.4,7,20,35.0,25,55,45.5,9,12,75.0,4,17,21,8,20,0,12,11,0,0,61,PTG Sokół Łańcut,Sezon 2005/2006
2005-10-02 17:00,Sportowiec Częstochowa(d),86 : 100P,86,26,51,51.0,7,19,36.8,33,70,47.1,13,21,61.9,15,14,29,14,26,0,16,8,1,0,77,KS AZS AWF Katowice,Sezon 2005/2006
2005-10-08 18:00,Viking Gdynia(w),102 : 81P,81,28,45,62.2,6,22,27.3,34,67,50.7,7,11,63.6,8,21,29,15,21,0,14,8,2,0,84,KS AZS AWF Katowice,Sezon 2005/2006
2005-10-12 19:00,Sokołów Znicz Jarosław(d),87 : 84W,87,23,41,56.1,9,23,39.1,32,64,50.0,14,16,87.5,11,15,26,19,22,0,14,9,3,0,96,KS AZS AWF Katowice,Sezon 2005/2006
2005-10-15 18:00,Znicz Basket Pruszków(w),85 : 89W,89,24,52,46.2,10,23,43.5,34,75,45.3,11,17,64.7,14,26,40,13,20,0,16,11,4,0,94,KS AZS AWF Katowice,Sezon 2005/2006
2005-10-22 17:00,CZELADZKI KLUB SPORTOWY 1924 (CKS) Czeladź(d),81 : 99P,81,17,41,41.5,10,25,40.0,27,66,40.9,17,26,65.4,8,22,30,18,29,0,16,6,2,0,73,KS AZS AWF Katowice,Sezon 2005/2006
2005-10-26 18:00,KS Legion Legionowo(w),82 : 88W,88,26,39,66.7,7,17,41.2,33,56,58.9,15,22,68.2,7,21,28,5,21,0,18,14,0,0,87,KS AZS AWF Katowice,Sezon 2005/2006
2005-10-30 17:00,PBG Basket Poznań(d),116 : 107W,116,26,49,53.1,14,34,41.2,40,83,48.2,22,32,68.8,17,21,38,24,35,0,23,16,5,0,123,KS AZS AWF Katowice,Sezon 2005/2006
2005-11-05 17:00,Basket Kwidzyn(d),92 : 93P,92,33,55,60.0,4,11,36.4,37,66,56.1,14,20,70.0,9,22,31,11,24,0,15,8,2,0,94,KS AZS AWF Katowice,Sezon 2005/2006
2005-11-09 17:30,PTG Sokół Łańcut(w),84 : 82P,82,22,46,47.8,9,22,40.9,31,68,45.6,11,17,64.7,12,22,34,13,25,0,13,8,4,0,85,KS AZS AWF Katowice,Sezon 2005/2006
2005-11-12 17:00,Stal Stalowa Wola(d),80 : 89P,80,21,59,35.6,7,20,35.0,28,79,35.4,17,25,68.0,16,17,33,13,26,0,10,9,6,0,72,KS AZS AWF Katowice,Sezon 2005/2006
2005-11-19 17:00,Górnik Wałbrzych(w),101 : 84P,84,24,46,52.2,6,14,42.9,30,60,50.0,18,27,66.7,4,13,17,15,21,0,14,10,2,0,75,KS AZS AWF Katowice,Sezon 2005/2006
2005-11-23 19:00,Siarka Tarnobrzeg(d),60 : 85P,60,21,41,51.2,2,18,11.1,23,59,39.0,12,15,80.0,8,15,23,15,28,0,17,13,2,0,57,KS AZS AWF Katowice,Sezon 2005/2006
2005-11-26 17:00,Spójnia Stargard Szcz.(w),83 : 75P,75,26,51,51.0,4,12,33.3,30,63,47.6,11,15,73.3,11,21,32,13,20,0,16,7,3,0,77,KS AZS AWF Katowice,Sezon 2005/2006
2005-12-04 17:00,AZS Politechnika Radomska(d),89 : 85W,89,22,35,62.9,8,28,28.6,30,63,47.6,21,27,77.8,7,19,26,17,19,0,15,16,3,0,97,KS AZS AWF Katowice,Sezon 2005/2006
2005-12-11 17:00,Grono Zielona Góra(w),71 : 66P,66,15,46,32.6,4,15,26.7,19,61,31.1,24,38,63.2,14,22,36,6,25,0,11,8,1,0,50,KS AZS AWF Katowice,Sezon 2005/2006
2005-12-17 16:00,Sportowiec Częstochowa(w),99 : 79P,79,23,41,56.1,8,21,38.1,31,62,50.0,9,14,64.3,11,18,29,14,17,0,20,8,3,0,77,KS AZS AWF Katowice,Sezon 2005/2006
2006-01-08 17:00,Viking Gdynia(d),71 : 91P,71,21,44,47.7,6,26,23.1,27,70,38.6,11,13,84.6,15,16,31,15,24,0,18,14,5,0,73,KS AZS AWF Katowice,Sezon 2005/2006
2006-01-15 17:00,Znicz Basket Pruszków(d),89 : 78W,89,23,39,59.0,9,25,36.0,32,64,50.0,16,20,80.0,13,22,35,15,24,0,16,11,3,0,101,KS AZS AWF Katowice,Sezon 2005/2006
2006-01-18 17:30,Sokołów Znicz Jarosław(w),85 : 54P,54,18,48,37.5,4,20,20.0,22,68,32.4,6,9,66.7,11,14,25,10,22,0,15,8,3,0,36,KS AZS AWF Katowice,Sezon 2005/2006
2006-01-22 18:00,CZELADZKI KLUB SPORTOWY 1924 (CKS) Czeladź(w),93 : 82P,82,25,36,69.4,6,15,40.0,31,51,60.8,14,22,63.6,8,19,27,14,21,0,30,13,4,0,82,KS AZS AWF Katowice,Sezon 2005/2006
2006-01-25 19:00,KS Legion Legionowo(d),70 : 78P,70,17,52,32.7,8,18,44.4,25,70,35.7,12,16,75.0,11,25,36,10,34,0,26,16,2,0,59,KS AZS AWF Katowice,Sezon 2005/2006
2006-01-28 17:00,PBG Basket Poznań(w),99 : 80P,80,23,44,52.3,9,21,42.9,32,65,49.2,7,8,87.5,7,14,21,2,27,0,18,11,4,0,66,KS AZS AWF Katowice,Sezon 2005/2006
2006-02-04 17:00,Basket Kwidzyn(w),92 : 73P,73,23,43,53.5,6,19,31.6,29,62,46.8,9,21,42.9,9,15,24,5,23,0,12,6,1,0,52,KS AZS AWF Katowice,Sezon 2005/2006
2006-02-08 19:00,PTG Sokół Łańcut(d),90 : 86W,90,28,46,60.9,7,18,38.9,35,64,54.7,13,15,86.7,12,20,32,19,30,0,18,12,2,0,106,KS AZS AWF Katowice,Sezon 2005/2006
2006-02-11 18:15,Stal Stalowa Wola(w),82 : 76P,76,25,50,50.0,6,14,42.9,31,64,48.4,8,17,47.1,9,25,34,15,26,0,15,8,3,0,79,KS AZS AWF Katowice,Sezon 2005/2006
2006-02-16 19:00,Spójnia Stargard Szcz.(d),77 : 108P,77,20,43,46.5,10,19,52.6,30,62,48.4,7,14,50.0,5,18,23,15,20,0,19,10,3,0,70,KS AZS AWF Katowice,Sezon 2005/2006
2006-02-19 17:00,Górnik Wałbrzych(d),67 : 83P,67,18,38,47.4,7,27,25.9,25,65,38.5,10,21,47.6,15,24,39,13,20,0,19,11,3,0,63,KS AZS AWF Katowice,Sezon 2005/2006
2006-02-22 18:00,Siarka Tarnobrzeg(w),92 : 71P,71,24,52,46.2,4,12,33.3,28,64,43.8,11,16,68.8,12,19,31,13,16,0,15,9,3,0,71,KS AZS AWF Katowice,Sezon 2005/2006
2006-03-02 19:00,AZS Politechnika Radomska(w),79 : 67P,67,22,52,42.3,4,15,26.7,26,67,38.8,11,14,78.6,10,23,33,7,17,0,11,11,3,0,66,KS AZS AWF Katowice,Sezon 2005/2006
2006-03-11 17:00,Grono Zielona Góra(d),69 : 79P,69,20,35,57.1,2,16,12.5,22,51,43.1,23,31,74.2,9,24,33,5,16,0,14,11,1,0,68,KS AZS AWF Katowice,Sezon 2005/2006
2006-03-18 17:00,KS Legion Legionowo(w),87 : 77P,77,19,41,46.3,10,20,50.0,29,61,47.5,9,15,60.0,7,17,24,15,25,0,15,10,2,0,75,KS AZS AWF Katowice,Sezon 2005/2006
2006-03-22 19:00,KS Legion Legionowo(d),90 : 77W,90,23,44,52.3,10,23,43.5,33,67,49.3,14,17,82.4,10,18,28,18,24,0,17,18,4,0,104,KS AZS AWF Katowice,Sezon 2005/2006
2006-03-25 19:00,KS Legion Legionowo(w),71 : 65P,65,16,39,41.0,6,23,26.1,22,62,35.5,15,22,68.2,12,19,31,7,29,0,18,13,1,0,52,KS AZS AWF Katowice,Sezon 2005/2006
2006-04-01 17:00,PBG Basket Poznań(w),98 : 76P,76,23,40,57.5,5,23,21.7,28,63,44.4,15,27,55.6,14,18,32,8,26,0,15,10,1,0,65,KS AZS AWF Katowice,Sezon 2005/2006
2006-04-02 16:00,PBG Basket Poznań(w),86 : 71P,71,18,42,42.9,7,25,28.0,25,67,37.3,14,18,77.8,13,15,28,6,26,0,15,9,1,0,54,KS AZS AWF Katowice,Sezon 2005/2006
2006-04-08 17:30,PBG Basket Poznań(d),74 : 67W,74,14,29,48.3,8,25,32.0,22,54,40.7,22,28,78.6,7,18,25,13,22,0,18,16,1,0,73,KS AZS AWF Katowice,Sezon 2005/2006
2006-04-09 19:30,PBG Basket Poznań(d),51 : 72P,51,11,28,39.3,3,18,16.7,14,46,30.4,20,27,74.1,13,20,33,10,31,0,33,8,3,0,33,KS AZS AWF Katowice,Sezon 2005/2006
2005-10-01 17:00,Grono Zielona Góra(d),74 : 61W,74,18,41,43.9,7,19,36.8,25,60,41.7,17,24,70.8,9,26,35,13,19,0,8,5,3,0,80,Basket Kwidzyn,Sezon 2005/2006
2005-10-08 18:00,Sportowiec Częstochowa(w),76 : 96W,96,27,46,58.7,10,20,50.0,37,66,56.1,12,19,63.2,5,25,30,20,28,0,17,4,0,0,97,Basket Kwidzyn,Sezon 2005/2006
2005-10-12 17:00,Viking Gdynia(d),81 : 86P,81,25,37,67.6,6,22,27.3,31,59,52.5,13,16,81.3,4,16,20,17,22,0,5,9,5,0,96,Basket Kwidzyn,Sezon 2005/2006
2005-10-15 17:30,Sokołów Znicz Jarosław(w),84 : 65P,65,17,38,44.7,8,23,34.8,25,61,41.0,7,14,50.0,8,14,22,9,26,0,15,9,3,0,50,Basket Kwidzyn,Sezon 2005/2006
2005-10-22 11:00,Znicz Basket Pruszków(d),100 : 68W,100,29,42,69.0,10,19,52.6,39,61,63.9,12,14,85.7,8,19,27,20,22,0,10,19,3,0,135,Basket Kwidzyn,Sezon 2005/2006
2005-10-26 18:00,CZELADZKI KLUB SPORTOWY 1924 (CKS) Czeladź(w),85 : 70P,70,23,36,63.9,5,21,23.8,28,57,49.1,9,14,64.3,10,17,27,8,17,0,14,8,3,0,68,Basket Kwidzyn,Sezon 2005/2006
2005-10-29 17:00,KS Legion Legionowo(d),81 : 73W,81,26,45,57.8,4,16,25.0,30,61,49.2,17,22,77.3,8,17,25,14,22,0,11,15,2,0,90,Basket Kwidzyn,Sezon 2005/2006
2005-11-05 17:00,KS AZS AWF Katowice(w),92 : 93W,93,27,51,52.9,7,15,46.7,34,66,51.5,18,24,75.0,8,19,27,18,22,0,8,8,1,0,101,Basket Kwidzyn,Sezon 2005/2006
2005-11-09 17:00,PBG Basket Poznań(d),75 : 65W,75,17,27,63.0,8,21,38.1,25,48,52.1,17,22,77.3,10,23,33,18,25,0,17,11,3,0,95,Basket Kwidzyn,Sezon 2005/2006
2005-11-12 17:00,PTG Sokół Łańcut(d),73 : 56W,73,20,35,57.1,6,19,31.6,26,54,48.1,15,21,71.4,8,25,33,18,16,0,11,11,2,0,92,Basket Kwidzyn,Sezon 2005/2006
2005-11-19 17:00,Stal Stalowa Wola(w),63 : 59P,59,22,53,41.5,4,17,23.5,26,70,37.1,3,5,60.0,17,26,43,7,20,0,15,6,4,0,58,Basket Kwidzyn,Sezon 2005/2006
2005-11-23 16:30,Górnik Wałbrzych(d),74 : 58W,74,22,37,59.5,7,16,43.8,29,53,54.7,9,19,47.4,9,13,22,20,20,0,9,16,3,0,92,Basket Kwidzyn,Sezon 2005/2006
2005-11-26 11:00,Siarka Tarnobrzeg(w),69 : 60P,60,23,42,54.8,2,11,18.2,25,53,47.2,8,11,72.7,7,25,32,10,25,0,20,8,2,0,61,Basket Kwidzyn,Sezon 2005/2006
2005-12-03 17:00,Spójnia Stargard Szcz.(d),77 : 67W,77,19,31,61.3,6,20,30.0,25,51,49.0,21,26,80.8,4,27,31,11,17,0,9,6,4,0,89,Basket Kwidzyn,Sezon 2005/2006
2005-12-10 18:00,AZS Politechnika Radomska(w),64 : 70W,70,22,42,52.4,4,20,20.0,26,62,41.9,14,20,70.0,10,26,36,12,14,0,8,2,2,0,72,Basket Kwidzyn,Sezon 2005/2006
2005-12-17 17:00,Grono Zielona Góra(w),57 : 62W,62,10,28,35.7,8,22,36.4,18,50,36.0,18,28,64.3,6,23,29,11,23,0,12,8,5,0,61,Basket Kwidzyn,Sezon 2005/2006
2006-01-07 17:00,Sportowiec Częstochowa(d),56 : 53W,56,15,32,46.9,3,21,14.3,18,53,34.0,17,23,73.9,12,28,40,10,16,0,11,8,7,0,69,Basket Kwidzyn,Sezon 2005/2006
2006-01-14 17:00,Sokołów Znicz Jarosław(d),80 : 60W,80,25,47,53.2,7,17,41.2,32,64,50.0,9,12,75.0,10,26,36,17,25,0,7,6,3,0,100,Basket Kwidzyn,Sezon 2005/2006
2006-01-18 18:00,Viking Gdynia(w),78 : 76P,76,23,45,51.1,7,22,31.8,30,67,44.8,9,13,69.2,9,20,29,6,21,0,6,3,1,0,68,Basket Kwidzyn,Sezon 2005/2006
2006-01-21 18:00,Znicz Basket Pruszków(w),69 : 80W,80,16,42,38.1,11,21,52.4,27,63,42.9,15,18,83.3,10,25,35,15,21,0,15,13,2,0,91,Basket Kwidzyn,Sezon 2005/2006
2006-01-25 17:00,CZELADZKI KLUB SPORTOWY 1924 (CKS) Czeladź(d),74 : 72W,74,18,37,48.6,9,23,39.1,27,60,45.0,11,19,57.9,9,21,30,12,24,0,9,9,3,0,78,Basket Kwidzyn,Sezon 2005/2006
2006-01-28 18:00,KS Legion Legionowo(w),79 : 73P,73,21,45,46.7,5,22,22.7,26,67,38.8,16,23,69.6,14,23,37,5,29,0,13,6,1,0,61,Basket Kwidzyn,Sezon 2005/2006
2006-02-04 17:00,KS AZS AWF Katowice(d),92 : 73W,92,31,47,66.0,4,15,26.7,35,62,56.5,18,24,75.0,10,28,38,17,20,0,12,8,3,0,113,Basket Kwidzyn,Sezon 2005/2006
2006-02-08 16:00,PBG Basket Poznań(w),89 : 86P,86,26,46,56.5,5,20,25.0,31,66,47.0,19,26,73.1,12,22,34,6,25,0,11,7,0,0,80,Basket Kwidzyn,Sezon 2005/2006
2006-02-11 17:30,PTG Sokół Łańcut(w),78 : 51P,51,11,30,36.7,6,20,30.0,17,50,34.0,11,17,64.7,9,12,21,10,25,0,15,8,1,0,37,Basket Kwidzyn,Sezon 2005/2006
2006-02-17 17:00,Stal Stalowa Wola(d),67 : 72P,67,20,42,47.6,7,19,36.8,27,61,44.3,6,9,66.7,11,25,36,14,23,0,10,5,3,0,78,Basket Kwidzyn,Sezon 2005/2006
2006-02-22 18:00,Górnik Wałbrzych(w),77 : 76P,76,20,38,52.6,8,19,42.1,28,57,49.1,12,17,70.6,9,16,25,14,20,0,9,10,2,0,84,Basket Kwidzyn,Sezon 2005/2006
2006-02-25 17:00,Siarka Tarnobrzeg(d),85 : 74W,85,22,40,55.0,9,24,37.5,31,64,48.4,14,20,70.0,13,24,37,17,18,0,5,5,2,0,102,Basket Kwidzyn,Sezon 2005/2006
2006-03-07 18:00,Spójnia Stargard Szcz.(w),77 : 76P,76,23,49,46.9,8,25,32.0,31,74,41.9,6,10,60.0,11,25,36,11,24,0,6,7,3,0,80,Basket Kwidzyn,Sezon 2005/2006
2006-03-11 17:00,AZS Politechnika Radomska(d),71 : 68W,71,21,37,56.8,7,19,36.8,28,56,50.0,8,16,50.0,8,21,29,17,15,0,15,13,1,0,80,Basket Kwidzyn,Sezon 2005/2006
2006-03-18 18:00,CZELADZKI KLUB SPORTOWY 1924 (CKS) Czeladź(w),84 : 86W,86,25,43,58.1,7,19,36.8,32,62,51.6,15,23,65.2,12,23,35,10,26,0,12,9,1,0,91,Basket Kwidzyn,Sezon 2005/2006
2006-03-19 18:00,CZELADZKI KLUB SPORTOWY 1924 (CKS) Czeladź(w),90 : 80P,80,17,35,48.6,8,23,34.8,25,58,43.1,22,29,75.9,6,13,19,20,24,0,12,10,2,0,79,Basket Kwidzyn,Sezon 2005/2006
2006-03-25 18:00,CZELADZKI KLUB SPORTOWY 1924 (CKS) Czeladź(d),79 : 80P,79,23,36,63.9,4,17,23.5,27,53,50.9,21,31,67.7,6,19,25,12,19,0,10,12,3,0,85,Basket Kwidzyn,Sezon 2005/2006
2006-03-26 18:00,CZELADZKI KLUB SPORTOWY 1924 (CKS) Czeladź(d),70 : 74P,70,20,38,52.6,6,25,24.0,26,63,41.3,12,19,63.2,9,22,31,14,25,0,8,6,4,0,73,Basket Kwidzyn,Sezon 2005/2006
2005-10-02 17:00,Siarka Tarnobrzeg(d),73 : 72W,73,16,33,48.5,6,19,31.6,22,52,42.3,23,36,63.9,11,24,35,14,35,0,20,18,4,0,81,Górnik Wałbrzych,Sezon 2005/2006
2005-10-08 17:00,Spójnia Stargard Szcz.(w),92 : 72P,72,22,49,44.9,3,14,21.4,25,63,39.7,19,27,70.4,17,20,37,9,26,0,21,9,1,0,61,Górnik Wałbrzych,Sezon 2005/2006
2005-10-12 18:00,AZS Politechnika Radomska(d),99 : 81W,99,30,41,73.2,9,22,40.9,39,63,61.9,12,16,75.0,9,17,26,22,25,0,17,15,3,0,120,Górnik Wałbrzych,Sezon 2005/2006
2005-10-15 17:30,Grono Zielona Góra(w),61 : 57P,57,13,31,41.9,8,18,44.4,21,49,42.9,7,14,50.0,6,23,29,7,20,0,14,8,1,0,53,Górnik Wałbrzych,Sezon 2005/2006
2005-10-22 19:00,Sportowiec Częstochowa(d),99 : 90W,99,29,46,63.0,10,25,40.0,39,71,54.9,11,16,68.8,13,26,39,24,30,0,11,15,4,0,133,Górnik Wałbrzych,Sezon 2005/2006
2005-10-26 18:00,Viking Gdynia(w),75 : 56P,56,16,33,48.5,2,20,10.0,18,53,34.0,18,23,78.3,6,23,29,11,15,0,18,9,2,0,49,Górnik Wałbrzych,Sezon 2005/2006
2005-10-29 17:00,Sokołów Znicz Jarosław(d),74 : 79P,74,22,39,56.4,6,15,40.0,28,54,51.9,12,15,80.0,11,15,26,22,26,0,16,18,1,0,96,Górnik Wałbrzych,Sezon 2005/2006
2005-11-05 18:00,Znicz Basket Pruszków(w),81 : 56P,56,18,51,35.3,2,19,10.5,20,70,28.6,14,22,63.6,16,11,27,13,20,0,23,18,3,0,36,Górnik Wałbrzych,Sezon 2005/2006
2005-11-09 18:00,CZELADZKI KLUB SPORTOWY 1924 (CKS) Czeladź(d),74 : 87P,74,20,38,52.6,8,20,40.0,28,58,48.3,10,16,62.5,8,24,32,19,25,0,18,10,2,0,83,Górnik Wałbrzych,Sezon 2005/2006
2005-11-12 17:00,KS Legion Legionowo(w),82 : 85W,85,22,38,57.9,8,18,44.4,30,56,53.6,17,27,63.0,11,16,27,13,20,0,18,5,0,0,76,Górnik Wałbrzych,Sezon 2005/2006
2005-11-19 17:00,KS AZS AWF Katowice(d),101 : 84W,101,35,59,59.3,7,14,50.0,42,73,57.5,10,19,52.6,14,24,38,29,24,0,13,11,5,0,131,Górnik Wałbrzych,Sezon 2005/2006
2005-11-23 16:30,Basket Kwidzyn(w),74 : 58P,58,14,31,45.2,5,14,35.7,19,45,42.2,15,17,88.2,9,18,27,10,21,0,24,3,1,0,47,Górnik Wałbrzych,Sezon 2005/2006
2005-11-27 18:00,PTG Sokół Łańcut(d),76 : 75W,76,20,34,58.8,6,16,37.5,26,50,52.0,18,21,85.7,10,23,33,17,24,0,21,15,1,0,94,Górnik Wałbrzych,Sezon 2005/2006
2005-12-03 17:00,Stal Stalowa Wola(w),83 : 79P,79,19,41,46.3,8,18,44.4,27,59,45.8,17,24,70.8,13,25,38,12,18,0,17,10,4,0,87,Górnik Wałbrzych,Sezon 2005/2006
2005-12-10 17:00,PBG Basket Poznań(d),76 : 68W,76,23,47,48.9,5,16,31.3,28,63,44.4,15,21,71.4,15,32,47,17,28,0,16,13,8,0,104,Górnik Wałbrzych,Sezon 2005/2006
2005-12-17 18:30,Siarka Tarnobrzeg(w),67 : 82W,82,27,39,69.2,3,13,23.1,30,52,57.7,19,22,86.4,9,20,29,23,23,0,22,12,1,0,100,Górnik Wałbrzych,Sezon 2005/2006
2006-01-07 17:00,Spójnia Stargard Szcz.(d),79 : 72W,79,26,48,54.2,5,19,26.3,31,67,46.3,12,17,70.6,11,23,34,19,21,0,9,8,5,0,95,Górnik Wałbrzych,Sezon 2005/2006
2006-01-14 17:00,Grono Zielona Góra(d),86 : 71W,86,24,45,53.3,5,10,50.0,29,55,52.7,23,29,79.3,13,27,40,15,21,0,11,7,7,0,112,Górnik Wałbrzych,Sezon 2005/2006
2006-01-18 16:00,AZS Politechnika Radomska(w),77 : 57P,57,15,36,41.7,4,20,20.0,19,56,33.9,15,23,65.2,12,24,36,11,26,0,17,3,4,0,49,Górnik Wałbrzych,Sezon 2005/2006
2006-01-22 16:00,Sportowiec Częstochowa(w),75 : 72P,72,21,55,38.2,6,22,27.3,27,77,35.1,12,19,63.2,14,23,37,14,22,0,15,10,2,0,63,Górnik Wałbrzych,Sezon 2005/2006
2006-01-25 18:00,Viking Gdynia(d),68 : 82P,68,23,47,48.9,3,11,27.3,26,58,44.8,13,15,86.7,8,20,28,23,22,0,8,9,2,0,88,Górnik Wałbrzych,Sezon 2005/2006
2006-02-04 17:00,Znicz Basket Pruszków(d),86 : 78W,86,20,36,55.6,8,25,32.0,28,61,45.9,22,28,78.6,10,22,32,24,20,0,10,15,3,0,111,Górnik Wałbrzych,Sezon 2005/2006
2006-02-08 18:00,CZELADZKI KLUB SPORTOWY 1924 (CKS) Czeladź(w),104 : 99P,99,27,38,71.1,9,29,31.0,36,67,53.7,18,20,90.0,13,18,31,14,32,0,25,12,0,0,98,Górnik Wałbrzych,Sezon 2005/2006
2006-02-11 18:30,KS Legion Legionowo(d),78 : 58W,78,28,45,62.2,2,11,18.2,30,56,53.6,16,22,72.7,10,29,39,19,19,0,15,22,2,0,113,Górnik Wałbrzych,Sezon 2005/2006
2006-02-19 17:00,KS AZS AWF Katowice(w),67 : 83W,83,25,50,50.0,7,12,58.3,32,62,51.6,12,17,70.6,6,23,29,16,23,0,13,13,1,0,94,Górnik Wałbrzych,Sezon 2005/2006
2006-02-22 18:00,Basket Kwidzyn(d),77 : 76W,77,25,41,61.0,5,12,41.7,30,53,56.6,12,15,80.0,4,25,29,17,20,0,11,7,1,0,94,Górnik Wałbrzych,Sezon 2005/2006
2006-02-25 17:30,PTG Sokół Łańcut(w),84 : 65P,65,13,34,38.2,8,23,34.8,21,57,36.8,15,19,78.9,9,18,27,10,23,0,22,9,1,0,50,Górnik Wałbrzych,Sezon 2005/2006
2006-03-05 17:00,Stal Stalowa Wola(d),77 : 88P,77,25,46,54.3,4,14,28.6,29,60,48.3,15,24,62.5,10,22,32,17,17,0,16,15,3,0,88,Górnik Wałbrzych,Sezon 2005/2006
2006-03-08 18:00,Sokołów Znicz Jarosław(w),96 : 82P,82,23,43,53.5,10,22,45.5,33,65,50.8,6,13,46.2,8,18,26,14,34,0,18,6,3,0,74,Górnik Wałbrzych,Sezon 2005/2006
2006-03-11 17:00,PBG Basket Poznań(w),106 : 86P,86,25,41,61.0,8,21,38.1,33,62,53.2,12,18,66.7,6,17,23,4,25,0,23,9,0,0,64,Górnik Wałbrzych,Sezon 2005/2006
2006-03-18 17:00,AZS Politechnika Radomska(d),85 : 67W,85,25,52,48.1,7,16,43.8,32,68,47.1,14,19,73.7,18,27,45,18,22,0,12,17,5,0,117,Górnik Wałbrzych,Sezon 2005/2006
2006-03-22 16:00,AZS Politechnika Radomska(w),75 : 65P,65,25,47,53.2,2,10,20.0,27,57,47.4,9,21,42.9,7,19,26,8,18,0,16,15,1,0,57,Górnik Wałbrzych,Sezon 2005/2006
2006-03-25 17:00,AZS Politechnika Radomska(d),56 : 54W,56,16,43,37.2,5,20,25.0,21,63,33.3,9,12,75.0,12,32,44,12,14,0,15,12,4,0,68,Górnik Wałbrzych,Sezon 2005/2006
2005-10-01 17:00,Basket Kwidzyn(w),74 : 61P,61,21,40,52.5,3,9,33.3,24,49,49.0,10,14,71.4,11,15,26,7,21,0,11,4,1,0,59,Grono Zielona Góra,Sezon 2005/2006
2005-10-09 18:00,PTG Sokół Łańcut(d),68 : 77P,68,13,28,46.4,10,30,33.3,23,58,39.7,12,23,52.2,10,27,37,15,28,0,14,10,0,0,70,Grono Zielona Góra,Sezon 2005/2006
2005-10-12 18:00,Stal Stalowa Wola(w),105 : 68P,68,22,50,44.0,6,26,23.1,28,76,36.8,6,10,60.0,8,16,24,14,25,0,17,14,4,0,55,Grono Zielona Góra,Sezon 2005/2006
2005-10-15 17:30,Górnik Wałbrzych(d),61 : 57W,61,18,32,56.3,6,26,23.1,24,58,41.4,7,16,43.8,14,22,36,12,19,0,14,13,3,0,68,Grono Zielona Góra,Sezon 2005/2006
2005-10-22 18:00,Siarka Tarnobrzeg(w),76 : 71P,71,17,33,51.5,9,31,29.0,26,64,40.6,10,15,66.7,10,26,36,8,31,0,20,7,0,0,59,Grono Zielona Góra,Sezon 2005/2006
2005-10-26 17:30,Spójnia Stargard Szcz.(d),79 : 75W,79,16,40,40.0,10,27,37.0,26,67,38.8,17,27,63.0,16,24,40,11,20,0,7,7,2,0,81,Grono Zielona Góra,Sezon 2005/2006
2005-10-29 18:00,AZS Politechnika Radomska(w),58 : 77W,77,18,40,45.0,9,25,36.0,27,65,41.5,14,22,63.6,14,20,34,10,20,0,7,6,3,0,77,Grono Zielona Góra,Sezon 2005/2006
2005-11-06 17:00,PBG Basket Poznań(w),69 : 65P,65,11,24,45.8,10,32,31.3,21,56,37.5,13,16,81.3,9,19,28,2,27,0,17,8,0,0,48,Grono Zielona Góra,Sezon 2005/2006
2005-11-09 18:00,Sportowiec Częstochowa(d),60 : 89P,60,16,35,45.7,6,30,20.0,22,65,33.8,10,19,52.6,12,20,32,13,22,0,14,7,3,0,49,Grono Zielona Góra,Sezon 2005/2006
2005-11-12 18:00,Viking Gdynia(w),72 : 79W,79,23,35,65.7,6,19,31.6,29,54,53.7,15,19,78.9,4,20,24,9,16,0,10,6,0,0,79,Grono Zielona Góra,Sezon 2005/2006
2005-11-19 17:00,Sokołów Znicz Jarosław(d),58 : 63P,58,15,32,46.9,6,21,28.6,21,53,39.6,10,15,66.7,5,20,25,8,25,0,14,13,0,0,53,Grono Zielona Góra,Sezon 2005/2006
2005-11-23 18:00,Znicz Basket Pruszków(w),82 : 76P,76,20,34,58.8,5,30,16.7,25,64,39.1,21,29,72.4,13,16,29,13,30,0,11,9,1,0,70,Grono Zielona Góra,Sezon 2005/2006
2005-11-27 17:00,CZELADZKI KLUB SPORTOWY 1924 (CKS) Czeladź(d),80 : 70W,80,16,32,50.0,10,28,35.7,26,60,43.3,18,26,69.2,14,22,36,15,22,0,13,9,4,0,89,Grono Zielona Góra,Sezon 2005/2006
2005-12-03 17:00,KS Legion Legionowo(w),55 : 62W,62,13,25,52.0,8,26,30.8,21,51,41.2,12,23,52.2,7,14,21,8,18,0,11,14,3,0,56,Grono Zielona Góra,Sezon 2005/2006
2005-12-11 17:00,KS AZS AWF Katowice(d),71 : 66W,71,20,44,45.5,5,14,35.7,25,58,43.1,16,33,48.5,12,25,37,15,29,0,10,7,3,0,73,Grono Zielona Góra,Sezon 2005/2006
2005-12-17 17:00,Basket Kwidzyn(d),57 : 62P,57,14,32,43.8,5,22,22.7,19,54,35.2,14,22,63.6,5,27,32,9,23,0,10,9,0,0,54,Grono Zielona Góra,Sezon 2005/2006
2006-01-07 17:30,PTG Sokół Łańcut(w),67 : 60P,60,14,32,43.8,7,28,25.0,21,60,35.0,11,19,57.9,11,25,36,11,24,0,15,10,0,0,55,Grono Zielona Góra,Sezon 2005/2006
2006-01-11 17:30,Stal Stalowa Wola(d),63 : 60W,63,15,35,42.9,5,26,19.2,20,61,32.8,18,32,56.3,15,22,37,9,20,0,11,15,4,0,62,Grono Zielona Góra,Sezon 2005/2006
2006-01-14 17:00,Górnik Wałbrzych(w),86 : 71P,71,16,32,50.0,8,35,22.9,24,67,35.8,15,17,88.2,14,13,27,8,29,0,11,9,5,0,64,Grono Zielona Góra,Sezon 2005/2006
2006-01-21 18:00,Siarka Tarnobrzeg(d),55 : 44W,55,18,40,45.0,4,18,22.2,22,58,37.9,7,11,63.6,10,25,35,10,23,0,14,16,6,0,68,Grono Zielona Góra,Sezon 2005/2006
2006-01-25 18:00,Spójnia Stargard Szcz.(w),75 : 81W,81,21,44,47.7,7,18,38.9,28,62,45.2,18,19,94.7,11,20,31,13,20,0,9,9,3,0,93,Grono Zielona Góra,Sezon 2005/2006
2006-01-28 15:00,AZS Politechnika Radomska(d),89 : 71W,89,27,47,57.4,7,19,36.8,34,66,51.5,14,22,63.6,10,28,38,17,25,0,11,12,5,0,110,Grono Zielona Góra,Sezon 2005/2006
2006-02-04 17:00,PBG Basket Poznań(d),76 : 68W,76,17,30,56.7,7,23,30.4,24,53,45.3,21,29,72.4,11,18,29,11,28,0,14,7,5,0,77,Grono Zielona Góra,Sezon 2005/2006
2006-02-08 19:00,Sportowiec Częstochowa(w),70 : 74W,74,18,38,47.4,7,25,28.0,25,63,39.7,17,21,81.0,15,28,43,14,18,0,13,7,2,0,85,Grono Zielona Góra,Sezon 2005/2006
2006-02-11 15:00,Viking Gdynia(d),73 : 54W,73,18,49,36.7,7,16,43.8,25,65,38.5,16,25,64.0,17,25,42,17,27,0,10,8,4,0,85,Grono Zielona Góra,Sezon 2005/2006
2006-02-18 17:30,Sokołów Znicz Jarosław(w),70 : 62P,62,19,47,40.4,3,15,20.0,22,62,35.5,15,19,78.9,11,20,31,9,22,0,18,4,1,0,45,Grono Zielona Góra,Sezon 2005/2006
2006-02-22 18:00,Znicz Basket Pruszków(d),84 : 71W,84,18,40,45.0,11,28,39.3,29,68,42.6,15,18,83.3,16,16,32,17,24,0,17,11,3,0,88,Grono Zielona Góra,Sezon 2005/2006
2006-02-25 18:00,CZELADZKI KLUB SPORTOWY 1924 (CKS) Czeladź(w),83 : 66P,66,17,36,47.2,7,28,25.0,24,64,37.5,11,13,84.6,11,17,28,10,24,0,18,12,3,0,59,Grono Zielona Góra,Sezon 2005/2006
2006-03-04 17:00,KS Legion Legionowo(d),86 : 69W,86,21,36,58.3,11,22,50.0,32,58,55.2,11,16,68.8,5,20,25,11,21,0,9,7,3,0,92,Grono Zielona Góra,Sezon 2005/2006
2006-03-11 17:00,KS AZS AWF Katowice(w),69 : 79W,79,27,43,62.8,5,20,25.0,32,63,50.8,10,10,100.0,6,17,23,18,26,0,13,9,1,0,86,Grono Zielona Góra,Sezon 2005/2006
2006-03-21 18:00,Stal Stalowa Wola(w),72 : 61P,61,23,43,53.5,3,23,13.0,26,66,39.4,6,9,66.7,5,17,22,14,19,0,12,15,1,0,58,Grono Zielona Góra,Sezon 2005/2006
2006-03-22 18:00,Stal Stalowa Wola(w),73 : 86W,86,19,40,47.5,9,18,50.0,28,58,48.3,21,30,70.0,9,19,28,13,31,0,15,10,3,0,86,Grono Zielona Góra,Sezon 2005/2006
2006-03-25 16:00,Stal Stalowa Wola(d),59 : 58W,59,15,45,33.3,7,21,33.3,22,66,33.3,8,17,47.1,10,23,33,11,25,0,9,9,5,0,55,Grono Zielona Góra,Sezon 2005/2006
2006-03-26 16:00,Stal Stalowa Wola(d),52 : 62P,52,13,38,34.2,7,29,24.1,20,67,29.9,5,8,62.5,13,24,37,7,19,0,15,9,5,0,45,Grono Zielona Góra,Sezon 2005/2006
2006-03-29 18:00,Stal Stalowa Wola(w),69 : 80W,80,25,44,56.8,8,18,44.4,33,62,53.2,6,18,33.3,3,22,25,16,19,0,11,11,2,0,82,Grono Zielona Góra,Sezon 2005/2006
2006-04-01 20:00,Viking Gdynia(d),68 : 77P,68,14,30,46.7,9,30,30.0,23,60,38.3,13,20,65.0,11,22,33,11,23,0,11,8,3,0,68,Grono Zielona Góra,Sezon 2005/2006
2006-04-02 17:00,Viking Gdynia(d),66 : 55W,66,11,34,32.4,11,22,50.0,22,56,39.3,11,21,52.4,5,23,28,13,15,0,9,13,3,0,70,Grono Zielona Góra,Sezon 2005/2006
2006-04-11 19:00,Viking Gdynia(w),73 : 58P,58,13,29,44.8,6,25,24.0,19,54,35.2,14,21,66.7,6,20,26,11,16,0,17,9,2,0,47,Grono Zielona Góra,Sezon 2005/2006
2006-04-12 19:00,Viking Gdynia(w),78 : 91W,91,21,33,63.6,8,22,36.4,29,55,52.7,25,33,75.8,5,22,27,14,21,0,7,10,3,0,104,Grono Zielona Góra,Sezon 2005/2006
2006-04-19 18:00,Viking Gdynia(d),43 : 60P,43,7,22,31.8,6,30,20.0,13,52,25.0,11,16,68.8,7,23,30,8,20,0,10,10,7,0,44,Grono Zielona Góra,Sezon 2005/2006
2005-10-02 17:00,Górnik Wałbrzych(w),73 : 72P,72,19,38,50.0,3,14,21.4,22,52,42.3,25,40,62.5,5,18,23,14,30,0,15,11,0,0,60,Siarka Tarnobrzeg,Sezon 2005/2006
2005-10-08 16:30,PBG Basket Poznań(w),87 : 79P,79,20,40,50.0,7,16,43.8,27,56,48.2,18,29,62.1,4,19,23,2,31,0,16,5,0,0,53,Siarka Tarnobrzeg,Sezon 2005/2006
2005-10-12 18:00,Spójnia Stargard Szcz.(d),89 : 76W,89,32,59,54.2,4,11,36.4,36,70,51.4,13,20,65.0,16,23,39,17,17,0,5,11,0,0,110,Siarka Tarnobrzeg,Sezon 2005/2006
2005-10-15 18:00,AZS Politechnika Radomska(w),71 : 57P,57,19,45,42.2,2,17,11.8,21,62,33.9,13,16,81.3,9,21,30,7,26,0,16,12,1,0,47,Siarka Tarnobrzeg,Sezon 2005/2006
2005-10-22 18:00,Grono Zielona Góra(d),76 : 71W,76,18,39,46.2,6,16,37.5,24,55,43.6,22,38,57.9,9,23,32,13,18,0,16,16,0,0,74,Siarka Tarnobrzeg,Sezon 2005/2006
2005-10-26 19:00,Sportowiec Częstochowa(w),80 : 63P,63,17,49,34.7,3,15,20.0,20,64,31.3,20,26,76.9,12,18,30,11,13,0,18,12,2,0,50,Siarka Tarnobrzeg,Sezon 2005/2006
2005-10-29 17:00,Viking Gdynia(d),60 : 62P,60,15,41,36.6,6,15,40.0,21,56,37.5,12,16,75.0,12,28,40,15,20,0,16,6,0,0,66,Siarka Tarnobrzeg,Sezon 2005/2006
2005-11-05 18:30,Sokołów Znicz Jarosław(w),85 : 71P,71,18,33,54.5,9,20,45.0,27,53,50.9,8,14,57.1,3,16,19,8,23,0,16,9,1,0,60,Siarka Tarnobrzeg,Sezon 2005/2006
2005-11-09 18:00,Znicz Basket Pruszków(d),94 : 85W,94,22,48,45.8,10,18,55.6,32,66,48.5,20,31,64.5,11,13,24,20,25,0,9,15,1,0,100,Siarka Tarnobrzeg,Sezon 2005/2006
2005-11-12 18:00,CZELADZKI KLUB SPORTOWY 1924 (CKS) Czeladź(w),107 : 92P,92,19,34,55.9,10,23,43.5,29,57,50.9,24,27,88.9,8,20,28,11,23,0,23,11,2,0,90,Siarka Tarnobrzeg,Sezon 2005/2006
2005-11-19 18:30,KS Legion Legionowo(d),75 : 69W,75,17,34,50.0,9,23,39.1,26,57,45.6,14,20,70.0,11,20,31,16,20,0,23,15,7,0,84,Siarka Tarnobrzeg,Sezon 2005/2006
2005-11-23 19:00,KS AZS AWF Katowice(w),60 : 85W,85,23,37,62.2,7,17,41.2,30,54,55.6,18,26,69.2,11,22,33,18,18,0,18,11,0,0,97,Siarka Tarnobrzeg,Sezon 2005/2006
2005-11-26 11:00,Basket Kwidzyn(d),69 : 60W,69,19,46,41.3,5,18,27.8,24,64,37.5,16,22,72.7,11,17,28,6,17,0,9,11,2,0,61,Siarka Tarnobrzeg,Sezon 2005/2006
2005-12-03 18:30,PTG Sokół Łańcut(w),82 : 57P,57,18,33,54.5,4,20,20.0,22,53,41.5,9,14,64.3,6,18,24,15,22,0,17,11,1,0,55,Siarka Tarnobrzeg,Sezon 2005/2006
2005-12-10 18:30,Stal Stalowa Wola(d),74 : 83P,74,23,43,53.5,5,20,25.0,28,63,44.4,13,17,76.5,8,13,21,12,25,0,15,16,3,0,72,Siarka Tarnobrzeg,Sezon 2005/2006
2005-12-17 18:30,Górnik Wałbrzych(d),67 : 82P,67,21,38,55.3,5,20,25.0,26,58,44.8,10,14,71.4,8,8,16,11,21,0,23,14,0,0,49,Siarka Tarnobrzeg,Sezon 2005/2006
2006-01-07 18:30,PBG Basket Poznań(d),83 : 90P,83,19,36,52.8,8,31,25.8,27,67,40.3,21,30,70.0,11,14,25,16,31,0,11,16,4,0,84,Siarka Tarnobrzeg,Sezon 2005/2006
2006-01-11 18:00,Spójnia Stargard Szcz.(w),76 : 58P,58,20,44,45.5,5,21,23.8,25,65,38.5,3,5,60.0,15,20,35,6,17,0,17,12,1,0,53,Siarka Tarnobrzeg,Sezon 2005/2006
2006-01-15 17:00,AZS Politechnika Radomska(d),79 : 52W,79,20,37,54.1,9,29,31.0,29,66,43.9,12,17,70.6,15,20,35,12,23,0,12,15,3,0,90,Siarka Tarnobrzeg,Sezon 2005/2006
2006-01-21 18:00,Grono Zielona Góra(w),55 : 44P,44,10,37,27.0,6,17,35.3,16,54,29.6,6,9,66.7,11,26,37,6,19,0,19,12,2,0,41,Siarka Tarnobrzeg,Sezon 2005/2006
2006-01-25 18:00,Sportowiec Częstochowa(d),81 : 53W,81,17,28,60.7,13,31,41.9,30,59,50.8,8,13,61.5,7,30,37,18,14,0,15,13,2,0,102,Siarka Tarnobrzeg,Sezon 2005/2006
2006-01-28 18:00,Viking Gdynia(w),85 : 94W,94,22,41,53.7,7,22,31.8,29,63,46.0,29,39,74.4,4,31,35,16,25,0,10,10,1,0,102,Siarka Tarnobrzeg,Sezon 2005/2006
2006-02-04 17:00,Sokołów Znicz Jarosław(d),68 : 112P,68,20,39,51.3,7,23,30.4,27,62,43.5,7,10,70.0,6,9,15,10,18,0,19,10,6,0,52,Siarka Tarnobrzeg,Sezon 2005/2006
2006-02-08 18:00,Znicz Basket Pruszków(w),82 : 75P,75,14,31,45.2,9,31,29.0,23,62,37.1,20,26,76.9,10,21,31,11,23,0,21,13,1,0,65,Siarka Tarnobrzeg,Sezon 2005/2006
2006-02-11 18:30,CZELADZKI KLUB SPORTOWY 1924 (CKS) Czeladź(d),76 : 63W,76,18,37,48.6,7,27,25.9,25,64,39.1,19,22,86.4,16,26,42,11,18,0,22,17,1,0,83,Siarka Tarnobrzeg,Sezon 2005/2006
2006-02-18 15:00,KS Legion Legionowo(w),75 : 64P,64,13,27,48.1,8,27,29.6,21,54,38.9,14,23,60.9,3,17,20,8,36,0,22,13,1,0,42,Siarka Tarnobrzeg,Sezon 2005/2006
2006-02-22 18:00,KS AZS AWF Katowice(d),92 : 71W,92,23,40,57.5,11,31,35.5,34,71,47.9,13,14,92.9,14,24,38,15,18,0,13,13,2,0,109,Siarka Tarnobrzeg,Sezon 2005/2006
2006-02-25 17:00,Basket Kwidzyn(w),85 : 74P,74,19,37,51.4,6,19,31.6,25,56,44.6,18,20,90.0,7,20,27,9,17,0,10,2,3,0,72,Siarka Tarnobrzeg,Sezon 2005/2006
2006-03-04 18:30,PTG Sokół Łańcut(d),75 : 77P,75,17,34,50.0,8,24,33.3,25,58,43.1,17,19,89.5,4,23,27,14,20,0,17,13,3,0,80,Siarka Tarnobrzeg,Sezon 2005/2006
2006-03-11 17:00,Stal Stalowa Wola(w),74 : 61P,61,18,47,38.3,5,19,26.3,23,66,34.8,10,15,66.7,10,21,31,10,18,0,10,6,6,0,56,Siarka Tarnobrzeg,Sezon 2005/2006
2006-03-18 18:00,Znicz Basket Pruszków(w),76 : 57P,57,12,36,33.3,6,22,27.3,18,58,31.0,15,19,78.9,14,21,35,11,21,0,17,6,3,0,51,Siarka Tarnobrzeg,Sezon 2005/2006
2006-03-22 18:00,Znicz Basket Pruszków(d),83 : 90P,83,18,30,60.0,9,20,45.0,27,50,54.0,20,25,80.0,11,14,25,16,27,0,31,16,1,0,82,Siarka Tarnobrzeg,Sezon 2005/2006
2006-04-01 18:00,AZS Politechnika Radomska(d),72 : 77P,72,22,37,59.5,7,25,28.0,29,62,46.8,7,11,63.6,13,27,40,12,24,0,25,12,5,0,79,Siarka Tarnobrzeg,Sezon 2005/2006
2006-04-02 18:00,AZS Politechnika Radomska(d),101 : 90W,101,17,34,50.0,14,28,50.0,31,62,50.0,25,29,86.2,16,21,37,19,24,0,21,16,2,0,119,Siarka Tarnobrzeg,Sezon 2005/2006
2006-04-08 18:00,AZS Politechnika Radomska(w),63 : 65W,65,19,45,42.2,4,18,22.2,23,63,36.5,15,19,78.9,8,21,29,14,16,0,13,7,5,0,63,Siarka Tarnobrzeg,Sezon 2005/2006
2006-04-09 18:00,AZS Politechnika Radomska(w),75 : 94W,94,19,37,51.4,13,28,46.4,32,65,49.2,17,22,77.3,7,24,31,10,17,0,6,2,3,0,96,Siarka Tarnobrzeg,Sezon 2005/2006
2005-10-01 18:00,CZELADZKI KLUB SPORTOWY 1924 (CKS) Czeladź(w),98 : 101W,101,28,47,59.6,6,10,60.0,34,57,59.6,27,30,90.0,10,8,18,10,21,0,6,5,0,0,102,Sokołów Znicz Jarosław,Sezon 2005/2006
2005-10-08 17:30,KS Legion Legionowo(d),61 : 78P,61,21,42,50.0,1,16,6.3,22,58,37.9,16,25,64.0,13,9,22,7,20,0,23,14,1,0,37,Sokołów Znicz Jarosław,Sezon 2005/2006
2005-10-12 19:00,KS AZS AWF Katowice(w),87 : 84P,84,21,39,53.8,8,18,44.4,29,57,50.9,18,27,66.7,11,18,29,22,15,0,17,5,3,0,89,Sokołów Znicz Jarosław,Sezon 2005/2006
2005-10-15 17:30,Basket Kwidzyn(d),84 : 65W,84,22,40,55.0,6,22,27.3,28,62,45.2,22,26,84.6,11,23,34,10,25,0,12,7,1,0,86,Sokołów Znicz Jarosław,Sezon 2005/2006
2005-10-22 17:30,PTG Sokół Łańcut(w),83 : 77P,77,18,30,60.0,9,30,30.0,27,60,45.0,14,21,66.7,5,23,28,16,20,0,19,11,3,0,76,Sokołów Znicz Jarosław,Sezon 2005/2006
2005-10-26 17:30,Stal Stalowa Wola(d),107 : 77W,107,32,53,60.4,7,16,43.8,39,69,56.5,22,27,81.5,12,28,40,18,26,0,14,10,1,0,127,Sokołów Znicz Jarosław,Sezon 2005/2006
2005-10-29 17:00,Górnik Wałbrzych(w),74 : 79W,79,13,24,54.2,9,21,42.9,22,45,48.9,26,29,89.7,8,15,23,16,19,0,21,10,1,0,82,Sokołów Znicz Jarosław,Sezon 2005/2006
2005-11-05 18:30,Siarka Tarnobrzeg(d),85 : 71W,85,28,50,56.0,4,16,25.0,32,66,48.5,17,19,89.5,13,22,35,15,16,0,12,14,1,0,102,Sokołów Znicz Jarosław,Sezon 2005/2006
2005-11-09 17:30,Spójnia Stargard Szcz.(d),87 : 80W,87,22,38,57.9,8,18,44.4,30,56,53.6,19,20,95.0,4,15,19,15,18,0,14,8,2,0,90,Sokołów Znicz Jarosław,Sezon 2005/2006
2005-11-12 16:30,AZS Politechnika Radomska(d),93 : 77W,93,27,48,56.3,7,20,35.0,34,68,50.0,18,20,90.0,10,24,34,18,25,0,16,12,0,0,105,Sokołów Znicz Jarosław,Sezon 2005/2006
2005-11-19 17:00,Grono Zielona Góra(w),58 : 63W,63,14,31,45.2,7,19,36.8,21,50,42.0,14,20,70.0,8,27,35,11,22,0,18,8,0,0,64,Sokołów Znicz Jarosław,Sezon 2005/2006
2005-11-23 17:30,Sportowiec Częstochowa(d),96 : 79W,96,21,37,56.8,11,25,44.0,32,62,51.6,21,27,77.8,7,25,32,22,11,0,13,12,3,0,116,Sokołów Znicz Jarosław,Sezon 2005/2006
2005-11-26 18:00,Viking Gdynia(w),74 : 101W,101,13,19,68.4,17,25,68.0,30,44,68.2,24,28,85.7,3,21,24,15,18,0,12,8,0,0,118,Sokołów Znicz Jarosław,Sezon 2005/2006
2005-12-03 17:00,PBG Basket Poznań(w),89 : 94W,94,19,26,73.1,12,29,41.4,31,55,56.4,20,23,87.0,6,20,26,3,24,0,17,11,3,0,93,Sokołów Znicz Jarosław,Sezon 2005/2006
2005-12-11 17:00,Znicz Basket Pruszków(d),74 : 69W,74,17,36,47.2,6,21,28.6,23,57,40.4,22,30,73.3,10,24,34,13,17,0,11,9,2,0,79,Sokołów Znicz Jarosław,Sezon 2005/2006
2005-12-17 17:30,CZELADZKI KLUB SPORTOWY 1924 (CKS) Czeladź(d),91 : 75W,91,27,42,64.3,7,20,35.0,34,62,54.8,16,20,80.0,7,25,32,17,22,0,15,10,2,0,105,Sokołów Znicz Jarosław,Sezon 2005/2006
2006-01-07 17:00,KS Legion Legionowo(w),81 : 80P,80,18,30,60.0,11,27,40.7,29,57,50.9,11,18,61.1,9,14,23,8,25,0,22,12,2,0,68,Sokołów Znicz Jarosław,Sezon 2005/2006
2006-01-14 17:00,Basket Kwidzyn(w),80 : 60P,60,19,37,51.4,2,14,14.3,21,51,41.2,16,26,61.5,7,22,29,12,10,0,11,4,3,0,57,Sokołów Znicz Jarosław,Sezon 2005/2006
2006-01-18 17:30,KS AZS AWF Katowice(d),85 : 54W,85,24,40,60.0,6,19,31.6,30,59,50.8,19,24,79.2,12,30,42,15,15,0,17,12,2,0,105,Sokołów Znicz Jarosław,Sezon 2005/2006
2006-01-22 18:30,PTG Sokół Łańcut(d),80 : 68W,80,23,40,57.5,7,15,46.7,30,55,54.5,13,17,76.5,8,34,42,22,24,0,25,7,4,0,101,Sokołów Znicz Jarosław,Sezon 2005/2006
2006-01-25 17:00,Stal Stalowa Wola(w),68 : 80W,80,25,43,58.1,6,20,30.0,31,63,49.2,12,17,70.6,13,27,40,17,20,0,17,10,4,0,97,Sokołów Znicz Jarosław,Sezon 2005/2006
2006-02-04 17:00,Siarka Tarnobrzeg(w),68 : 112W,112,34,47,72.3,10,18,55.6,44,65,67.7,14,18,77.8,12,28,40,23,19,0,18,10,0,0,142,Sokołów Znicz Jarosław,Sezon 2005/2006
2006-02-11 18:00,AZS Politechnika Radomska(w),65 : 90W,90,28,43,65.1,7,17,41.2,35,60,58.3,13,19,68.4,9,26,35,16,21,0,17,8,2,0,103,Sokołów Znicz Jarosław,Sezon 2005/2006
2006-02-18 17:30,Grono Zielona Góra(d),70 : 62W,70,19,37,51.4,5,18,27.8,24,55,43.6,17,24,70.8,6,28,34,10,21,0,12,9,6,0,79,Sokołów Znicz Jarosław,Sezon 2005/2006
2006-02-22 19:00,Sportowiec Częstochowa(w),87 : 108W,108,25,49,51.0,11,18,61.1,36,67,53.7,25,30,83.3,11,34,45,24,22,0,16,9,1,0,135,Sokołów Znicz Jarosław,Sezon 2005/2006
2006-02-25 17:30,Viking Gdynia(d),80 : 71W,80,26,46,56.5,5,19,26.3,31,65,47.7,13,16,81.3,12,29,41,20,18,0,19,8,2,0,95,Sokołów Znicz Jarosław,Sezon 2005/2006
2006-03-01 18:00,Spójnia Stargard Szcz.(w),70 : 69P,69,26,46,56.5,2,16,12.5,28,62,45.2,11,16,68.8,14,31,45,7,16,0,19,6,3,0,72,Sokołów Znicz Jarosław,Sezon 2005/2006
2006-03-04 17:00,PBG Basket Poznań(d),90 : 76W,90,31,49,63.3,4,18,22.2,35,67,52.2,16,21,76.2,12,28,40,15,18,0,13,9,3,0,107,Sokołów Znicz Jarosław,Sezon 2005/2006
2006-03-08 18:00,Górnik Wałbrzych(d),96 : 82W,96,20,35,57.1,6,20,30.0,26,55,47.3,38,45,84.4,11,22,33,15,19,0,14,11,6,0,111,Sokołów Znicz Jarosław,Sezon 2005/2006
2006-03-11 17:00,Znicz Basket Pruszków(w),72 : 91W,91,23,38,60.5,9,20,45.0,32,58,55.2,18,26,69.2,9,25,34,19,15,0,22,8,2,0,98,Sokołów Znicz Jarosław,Sezon 2005/2006
2006-03-20 18:00,Spójnia Stargard Szcz.(d),100 : 67W,100,32,51,62.7,7,16,43.8,39,67,58.2,15,20,75.0,5,18,23,12,28,0,16,12,6,0,104,Sokołów Znicz Jarosław,Sezon 2005/2006
2006-03-21 18:00,Spójnia Stargard Szcz.(d),90 : 55W,90,26,45,57.8,9,22,40.9,35,67,52.2,11,12,91.7,13,27,40,14,18,0,18,12,5,0,110,Sokołów Znicz Jarosław,Sezon 2005/2006
2006-03-25 17:00,Spójnia Stargard Szcz.(w),96 : 85P,85,24,41,58.5,9,19,47.4,33,60,55.0,10,17,58.8,12,16,28,14,23,0,24,17,1,0,87,Sokołów Znicz Jarosław,Sezon 2005/2006
2006-03-26 17:00,Spójnia Stargard Szcz.(w),68 : 72W,72,18,31,58.1,5,19,26.3,23,50,46.0,21,25,84.0,10,27,37,11,28,0,21,11,0,0,79,Sokołów Znicz Jarosław,Sezon 2005/2006
2006-04-01 17:30,CZELADZKI KLUB SPORTOWY 1924 (CKS) Czeladź(d),74 : 59W,74,19,34,55.9,6,18,33.3,25,52,48.1,18,27,66.7,5,34,39,18,18,0,20,7,3,0,85,Sokołów Znicz Jarosław,Sezon 2005/2006
2006-04-02 17:00,CZELADZKI KLUB SPORTOWY 1924 (CKS) Czeladź(d),80 : 72W,80,15,32,46.9,10,24,41.7,25,56,44.6,20,23,87.0,8,24,32,10,25,0,17,8,1,0,80,Sokołów Znicz Jarosław,Sezon 2005/2006
2006-04-08 18:00,CZELADZKI KLUB SPORTOWY 1924 (CKS) Czeladź(w),79 : 96W,96,26,39,66.7,10,18,55.6,36,57,63.2,14,15,93.3,12,29,41,23,17,0,20,7,4,0,129,Sokołów Znicz Jarosław,Sezon 2005/2006
2006-04-22 20:30,Viking Gdynia(w),94 : 94P,94,24,44,54.5,10,20,50.0,34,64,53.1,16,23,69.6,9,22,31,13,24,0,12,5,0,0,94,Sokołów Znicz Jarosław,Sezon 2005/2006
2006-04-26 18:00,Viking Gdynia(d),93 : 75W,93,22,35,62.9,10,24,41.7,32,59,54.2,19,27,70.4,6,25,31,19,26,0,18,10,8,0,108,Sokołów Znicz Jarosław,Sezon 2005/2006
2005-10-01 17:00,Stal Stalowa Wola(w),94 : 96W,96,27,43,62.8,7,18,38.9,34,61,55.7,21,29,72.4,11,15,26,14,28,0,13,7,2,0,97,Spójnia Stargard Szcz.,Sezon 2005/2006
2005-10-08 17:00,Górnik Wałbrzych(d),92 : 72W,92,29,45,64.4,7,16,43.8,36,61,59.0,13,24,54.2,11,17,28,26,22,0,14,11,2,0,109,Spójnia Stargard Szcz.,Sezon 2005/2006
2005-10-12 18:00,Siarka Tarnobrzeg(w),89 : 76P,76,26,42,61.9,6,19,31.6,32,61,52.5,6,8,75.0,6,19,25,16,17,0,13,4,2,0,79,Spójnia Stargard Szcz.,Sezon 2005/2006
2005-10-15 17:00,PBG Basket Poznań(w),79 : 88W,88,22,38,57.9,8,18,44.4,30,56,53.6,20,26,76.9,5,26,31,4,19,0,14,8,0,0,85,Spójnia Stargard Szcz.,Sezon 2005/2006
2005-10-22 17:00,AZS Politechnika Radomska(d),73 : 68W,73,17,33,51.5,9,27,33.3,26,60,43.3,12,17,70.6,11,28,39,13,20,0,19,10,7,0,84,Spójnia Stargard Szcz.,Sezon 2005/2006
2005-10-26 17:30,Grono Zielona Góra(w),79 : 75P,75,20,43,46.5,8,19,42.1,28,62,45.2,11,18,61.1,9,21,30,11,19,0,11,5,8,0,77,Spójnia Stargard Szcz.,Sezon 2005/2006
2005-10-29 17:00,Sportowiec Częstochowa(d),88 : 96P,88,25,48,52.1,11,30,36.7,36,78,46.2,5,8,62.5,15,16,31,20,25,0,12,7,3,0,92,Spójnia Stargard Szcz.,Sezon 2005/2006
2005-11-05 18:00,Viking Gdynia(w),75 : 79W,79,19,31,61.3,10,23,43.5,29,54,53.7,11,16,68.8,8,21,29,15,17,0,11,5,0,0,87,Spójnia Stargard Szcz.,Sezon 2005/2006
2005-11-09 17:30,Sokołów Znicz Jarosław(w),87 : 80P,80,25,41,61.0,6,18,33.3,31,59,52.5,12,16,75.0,5,18,23,12,17,0,15,5,0,0,73,Spójnia Stargard Szcz.,Sezon 2005/2006
2005-11-12 18:00,Znicz Basket Pruszków(w),71 : 83W,83,21,35,60.0,10,22,45.5,31,57,54.4,11,18,61.1,6,27,33,21,31,0,17,5,4,0,96,Spójnia Stargard Szcz.,Sezon 2005/2006
2005-11-19 17:00,CZELADZKI KLUB SPORTOWY 1924 (CKS) Czeladź(d),106 : 100W,106,26,43,60.5,9,21,42.9,35,64,54.7,27,40,67.5,9,24,33,16,32,0,17,7,8,0,111,Spójnia Stargard Szcz.,Sezon 2005/2006
2005-11-23 18:00,KS Legion Legionowo(w),68 : 80W,80,17,25,68.0,10,25,40.0,27,50,54.0,16,23,69.6,2,22,24,9,23,0,15,6,3,0,77,Spójnia Stargard Szcz.,Sezon 2005/2006
2005-11-26 17:00,KS AZS AWF Katowice(d),83 : 75W,83,25,46,54.3,8,21,38.1,33,67,49.3,9,15,60.0,13,21,34,19,19,0,10,11,1,0,98,Spójnia Stargard Szcz.,Sezon 2005/2006
2005-12-03 17:00,Basket Kwidzyn(w),77 : 67P,67,25,44,56.8,2,13,15.4,27,57,47.4,11,11,100.0,3,18,21,9,23,0,11,7,2,0,65,Spójnia Stargard Szcz.,Sezon 2005/2006
2005-12-10 17:00,PTG Sokół Łańcut(d),71 : 73P,71,18,32,56.3,8,21,38.1,26,53,49.1,11,16,68.8,5,26,31,11,20,0,17,6,6,0,76,Spójnia Stargard Szcz.,Sezon 2005/2006
2005-12-17 17:00,Stal Stalowa Wola(d),88 : 93P,88,23,47,48.9,9,26,34.6,32,73,43.8,15,25,60.0,18,26,44,15,24,0,14,4,4,0,90,Spójnia Stargard Szcz.,Sezon 2005/2006
2006-01-07 17:00,Górnik Wałbrzych(w),79 : 72P,72,15,32,46.9,8,23,34.8,23,55,41.8,18,25,72.0,6,21,27,11,19,0,12,6,3,0,68,Spójnia Stargard Szcz.,Sezon 2005/2006
2006-01-11 18:00,Siarka Tarnobrzeg(d),76 : 58W,76,20,34,58.8,10,22,45.5,30,56,53.6,6,10,60.0,7,18,25,16,14,0,14,12,4,0,89,Spójnia Stargard Szcz.,Sezon 2005/2006
2006-01-14 17:00,PBG Basket Poznań(d),62 : 59W,62,19,34,55.9,6,21,28.6,25,55,45.5,6,18,33.3,7,28,35,17,18,0,12,7,3,0,70,Spójnia Stargard Szcz.,Sezon 2005/2006
2006-01-21 18:00,AZS Politechnika Radomska(w),64 : 71W,71,17,26,65.4,10,21,47.6,27,47,57.4,7,9,77.8,8,25,33,11,21,0,18,1,2,0,78,Spójnia Stargard Szcz.,Sezon 2005/2006
2006-01-25 18:00,Grono Zielona Góra(d),75 : 81P,75,23,36,63.9,5,18,27.8,28,54,51.9,14,18,77.8,3,21,24,11,22,0,13,7,2,0,76,Spójnia Stargard Szcz.,Sezon 2005/2006
2006-01-28 17:00,Sportowiec Częstochowa(w),99 : 76P,76,19,28,67.9,11,32,34.4,30,60,50.0,5,7,71.4,6,15,21,14,20,0,7,2,0,0,74,Spójnia Stargard Szcz.,Sezon 2005/2006
2006-02-04 17:00,Viking Gdynia(d),58 : 68P,58,18,41,43.9,5,19,26.3,23,60,38.3,7,9,77.8,13,20,33,10,15,0,17,10,2,0,57,Spójnia Stargard Szcz.,Sezon 2005/2006
2006-02-11 17:00,Znicz Basket Pruszków(d),86 : 69W,86,16,40,40.0,8,19,42.1,24,59,40.7,30,40,75.0,14,28,42,20,22,0,17,11,4,0,101,Spójnia Stargard Szcz.,Sezon 2005/2006
2006-02-16 19:00,KS AZS AWF Katowice(w),77 : 108W,108,32,55,58.2,10,18,55.6,42,73,57.5,14,21,66.7,15,23,38,28,16,0,14,14,2,0,138,Spójnia Stargard Szcz.,Sezon 2005/2006
2006-02-18 18:00,CZELADZKI KLUB SPORTOWY 1924 (CKS) Czeladź(w),94 : 69P,69,21,30,70.0,6,16,37.5,27,46,58.7,9,13,69.2,4,24,28,16,17,0,25,7,1,0,73,Spójnia Stargard Szcz.,Sezon 2005/2006
2006-02-22 18:00,KS Legion Legionowo(d),81 : 63W,81,20,41,48.8,10,16,62.5,30,57,52.6,11,15,73.3,6,23,29,20,20,0,15,7,3,0,94,Spójnia Stargard Szcz.,Sezon 2005/2006
2006-03-01 18:00,Sokołów Znicz Jarosław(d),70 : 69W,70,15,34,44.1,10,29,34.5,25,63,39.7,10,11,90.9,7,17,24,16,16,0,12,12,2,0,73,Spójnia Stargard Szcz.,Sezon 2005/2006
2006-03-07 18:00,Basket Kwidzyn(d),77 : 76W,77,25,41,61.0,5,13,38.5,30,54,55.6,12,23,52.2,3,24,27,14,14,0,8,6,4,0,85,Spójnia Stargard Szcz.,Sezon 2005/2006
2006-03-11 17:30,PTG Sokół Łańcut(w),73 : 65P,65,21,34,61.8,5,21,23.8,26,55,47.3,8,12,66.7,6,24,30,11,16,0,16,8,2,0,67,Spójnia Stargard Szcz.,Sezon 2005/2006
2006-03-20 18:00,Sokołów Znicz Jarosław(w),100 : 67P,67,17,33,51.5,3,16,18.8,20,49,40.8,24,32,75.0,4,18,22,9,23,0,24,10,0,0,47,Spójnia Stargard Szcz.,Sezon 2005/2006
2006-03-21 18:00,Sokołów Znicz Jarosław(w),90 : 55P,55,14,43,32.6,6,24,25.0,20,67,29.9,9,12,75.0,7,13,20,14,17,0,17,10,2,0,34,Spójnia Stargard Szcz.,Sezon 2005/2006
2006-03-25 17:00,Sokołów Znicz Jarosław(d),96 : 85W,96,22,33,66.7,12,26,46.2,34,59,57.6,16,19,84.2,6,18,24,13,21,0,19,16,5,0,107,Spójnia Stargard Szcz.,Sezon 2005/2006
2006-03-26 17:00,Sokołów Znicz Jarosław(d),68 : 72P,68,12,27,44.4,8,31,25.8,20,58,34.5,20,29,69.0,13,16,29,14,26,0,15,15,3,0,67,Spójnia Stargard Szcz.,Sezon 2005/2006
2005-10-01 17:00,Spójnia Stargard Szcz.(d),94 : 96P,94,21,34,61.8,8,22,36.4,29,56,51.8,28,38,73.7,10,14,24,13,25,0,14,8,0,0,88,Stal Stalowa Wola,Sezon 2005/2006
2005-10-08 18:00,AZS Politechnika Radomska(w),70 : 66P,66,21,40,52.5,4,20,20.0,25,60,41.7,12,22,54.5,4,18,22,4,22,0,17,7,1,0,38,Stal Stalowa Wola,Sezon 2005/2006
2005-10-12 18:00,Grono Zielona Góra(d),105 : 68W,105,23,31,74.2,13,29,44.8,36,60,60.0,20,22,90.9,3,33,36,13,21,0,19,8,3,0,120,Stal Stalowa Wola,Sezon 2005/2006
2005-10-16 16:00,Sportowiec Częstochowa(w),77 : 79W,79,22,43,51.2,5,24,20.8,27,67,40.3,20,26,76.9,10,25,35,14,18,0,12,10,4,0,84,Stal Stalowa Wola,Sezon 2005/2006
2005-10-22 18:00,Viking Gdynia(d),92 : 85W,92,18,35,51.4,9,27,33.3,27,62,43.5,29,34,85.3,10,29,39,21,25,0,10,10,5,0,117,Stal Stalowa Wola,Sezon 2005/2006
2005-10-26 17:30,Sokołów Znicz Jarosław(w),107 : 77P,77,19,39,48.7,6,23,26.1,25,62,40.3,21,32,65.6,7,14,21,8,26,0,8,4,2,0,56,Stal Stalowa Wola,Sezon 2005/2006
2005-10-29 17:00,Znicz Basket Pruszków(d),59 : 89P,59,14,28,50.0,7,32,21.9,21,60,35.0,10,20,50.0,5,23,28,11,18,0,21,17,5,0,50,Stal Stalowa Wola,Sezon 2005/2006
2005-11-05 18:00,CZELADZKI KLUB SPORTOWY 1924 (CKS) Czeladź(w),83 : 98W,98,21,31,67.7,10,21,47.6,31,52,59.6,26,40,65.0,7,26,33,19,16,0,18,9,1,0,107,Stal Stalowa Wola,Sezon 2005/2006
2005-11-09 18:00,KS Legion Legionowo(d),94 : 87W,94,26,37,70.3,8,29,27.6,34,66,51.5,18,26,69.2,9,26,35,20,24,0,13,10,8,0,114,Stal Stalowa Wola,Sezon 2005/2006
2005-11-12 17:00,KS AZS AWF Katowice(w),80 : 89W,89,30,44,68.2,4,17,23.5,34,61,55.7,17,26,65.4,9,29,38,17,23,0,15,3,7,0,103,Stal Stalowa Wola,Sezon 2005/2006
2005-11-19 17:00,Basket Kwidzyn(d),63 : 59W,63,15,37,40.5,6,21,28.6,21,58,36.2,15,21,71.4,6,21,27,11,14,0,7,8,4,0,63,Stal Stalowa Wola,Sezon 2005/2006
2005-11-23 17:30,PTG Sokół Łańcut(w),73 : 78W,78,20,37,54.1,8,21,38.1,28,58,48.3,14,27,51.9,3,26,29,13,21,0,17,6,1,0,67,Stal Stalowa Wola,Sezon 2005/2006
2005-11-26 17:00,PBG Basket Poznań(d),92 : 75W,92,24,44,54.5,10,22,45.5,34,66,51.5,14,25,56.0,17,26,43,19,24,0,15,6,4,0,106,Stal Stalowa Wola,Sezon 2005/2006
2005-12-03 17:00,Górnik Wałbrzych(d),83 : 79W,83,12,26,46.2,15,36,41.7,27,62,43.5,14,17,82.4,7,19,26,12,21,0,14,11,2,0,82,Stal Stalowa Wola,Sezon 2005/2006
2005-12-10 18:30,Siarka Tarnobrzeg(w),74 : 83W,83,22,32,68.8,7,18,38.9,29,50,58.0,18,25,72.0,2,25,27,10,22,0,21,10,2,0,83,Stal Stalowa Wola,Sezon 2005/2006
2005-12-17 17:00,Spójnia Stargard Szcz.(w),88 : 93W,93,27,47,57.4,6,24,25.0,33,71,46.5,21,29,72.4,6,28,34,15,26,0,6,8,2,0,100,Stal Stalowa Wola,Sezon 2005/2006
2006-01-07 17:00,AZS Politechnika Radomska(d),91 : 87W,91,24,33,72.7,8,28,28.6,32,61,52.5,19,24,79.2,6,29,35,22,21,0,15,11,6,0,116,Stal Stalowa Wola,Sezon 2005/2006
2006-01-11 17:30,Grono Zielona Góra(w),63 : 60P,60,13,34,38.2,7,25,28.0,20,59,33.9,13,15,86.7,8,25,33,9,26,0,19,7,3,0,52,Stal Stalowa Wola,Sezon 2005/2006
2006-01-14 17:00,Sportowiec Częstochowa(d),74 : 83P,74,21,32,65.6,8,35,22.9,29,67,43.3,8,17,47.1,7,25,32,17,21,0,10,6,4,0,76,Stal Stalowa Wola,Sezon 2005/2006
2006-01-21 18:30,Viking Gdynia(w),94 : 69P,69,19,39,48.7,3,18,16.7,22,57,38.6,22,32,68.8,6,18,24,10,16,0,12,10,1,0,57,Stal Stalowa Wola,Sezon 2005/2006
2006-01-25 17:00,Sokołów Znicz Jarosław(d),68 : 80P,68,19,41,46.3,6,20,30.0,25,61,41.0,12,19,63.2,7,21,28,12,21,0,16,9,4,0,62,Stal Stalowa Wola,Sezon 2005/2006
2006-01-28 18:00,Znicz Basket Pruszków(w),88 : 86P,86,18,28,64.3,10,26,38.5,28,54,51.9,20,25,80.0,9,20,29,17,19,0,24,13,2,0,92,Stal Stalowa Wola,Sezon 2005/2006
2006-02-04 17:00,CZELADZKI KLUB SPORTOWY 1924 (CKS) Czeladź(d),88 : 66W,88,27,43,62.8,7,27,25.9,34,70,48.6,13,21,61.9,13,22,35,19,20,0,15,12,3,0,98,Stal Stalowa Wola,Sezon 2005/2006
2006-02-08 18:30,KS Legion Legionowo(w),78 : 76P,76,17,38,44.7,7,22,31.8,24,60,40.0,21,30,70.0,10,23,33,10,26,0,10,10,1,0,75,Stal Stalowa Wola,Sezon 2005/2006
2006-02-11 18:15,KS AZS AWF Katowice(d),82 : 76W,82,25,48,52.1,2,18,11.1,27,66,40.9,26,33,78.8,11,23,34,18,19,0,10,12,1,0,91,Stal Stalowa Wola,Sezon 2005/2006
2006-02-17 17:00,Basket Kwidzyn(w),67 : 72W,72,16,34,47.1,9,23,39.1,25,57,43.9,13,18,72.2,4,19,23,7,17,0,9,8,5,0,69,Stal Stalowa Wola,Sezon 2005/2006
2006-02-22 18:00,PTG Sokół Łańcut(d),74 : 81P,74,18,32,56.3,7,22,31.8,25,54,46.3,17,31,54.8,3,22,25,12,25,0,18,8,2,0,60,Stal Stalowa Wola,Sezon 2005/2006
2006-02-25 18:00,PBG Basket Poznań(w),86 : 97W,97,28,42,66.7,11,29,37.9,39,71,54.9,8,11,72.7,4,20,24,3,19,0,10,7,3,0,89,Stal Stalowa Wola,Sezon 2005/2006
2006-03-05 17:00,Górnik Wałbrzych(w),77 : 88W,88,22,33,66.7,13,24,54.2,35,57,61.4,5,12,41.7,6,19,25,24,24,0,16,14,2,0,108,Stal Stalowa Wola,Sezon 2005/2006
2006-03-11 17:00,Siarka Tarnobrzeg(d),74 : 61W,74,17,36,47.2,10,29,34.5,27,65,41.5,10,16,62.5,14,28,42,18,19,0,16,7,4,0,85,Stal Stalowa Wola,Sezon 2005/2006
2006-03-21 18:00,Grono Zielona Góra(d),72 : 61W,72,15,24,62.5,9,24,37.5,24,48,50.0,15,19,78.9,5,31,36,13,22,0,20,8,5,0,86,Stal Stalowa Wola,Sezon 2005/2006
2006-03-22 18:00,Grono Zielona Góra(d),73 : 86P,73,18,32,56.3,5,24,20.8,23,56,41.1,22,35,62.9,10,20,30,10,29,0,15,8,9,0,69,Stal Stalowa Wola,Sezon 2005/2006
2006-03-25 16:00,Grono Zielona Góra(w),59 : 58P,58,12,29,41.4,6,17,35.3,18,46,39.1,16,28,57.1,5,32,37,11,19,0,20,3,6,0,55,Stal Stalowa Wola,Sezon 2005/2006
2006-03-26 16:00,Grono Zielona Góra(w),52 : 62W,62,22,34,64.7,4,22,18.2,26,56,46.4,6,12,50.0,3,27,30,12,15,0,12,6,5,0,67,Stal Stalowa Wola,Sezon 2005/2006
2006-03-29 18:00,Grono Zielona Góra(d),69 : 80P,69,14,26,53.8,8,30,26.7,22,56,39.3,17,22,77.3,11,24,35,15,20,0,17,6,4,0,73,Stal Stalowa Wola,Sezon 2005/2006
2005-10-01 18:00,KS Legion Legionowo(d),89 : 94P,89,19,41,46.3,10,27,37.0,29,68,42.6,21,26,80.8,12,26,38,11,20,0,11,7,0,0,90,Viking Gdynia,Sezon 2005/2006
2005-10-08 18:00,KS AZS AWF Katowice(d),102 : 81W,102,28,46,60.9,9,18,50.0,37,64,57.8,19,25,76.0,8,16,24,14,17,0,9,10,5,0,113,Viking Gdynia,Sezon 2005/2006
2005-10-12 17:00,Basket Kwidzyn(w),81 : 86W,86,29,39,74.4,4,13,30.8,33,52,63.5,16,22,72.7,6,21,27,9,17,0,11,4,2,0,92,Viking Gdynia,Sezon 2005/2006
2005-10-16 17:00,PTG Sokół Łańcut(w),66 : 65P,65,10,30,33.3,10,25,40.0,20,55,36.4,15,17,88.2,8,24,32,16,16,0,15,9,1,0,71,Viking Gdynia,Sezon 2005/2006
2005-10-19 17:30,AZS Politechnika Radomska(w),70 : 76W,76,20,37,54.1,8,22,36.4,28,59,47.5,12,16,75.0,11,27,38,12,16,0,17,4,1,0,79,Viking Gdynia,Sezon 2005/2006
2005-10-22 18:00,Stal Stalowa Wola(w),92 : 85P,85,17,48,35.4,11,24,45.8,28,72,38.9,18,25,72.0,11,25,36,17,32,0,12,6,5,0,86,Viking Gdynia,Sezon 2005/2006
2005-10-26 18:00,Górnik Wałbrzych(d),75 : 56W,75,24,42,57.1,7,22,31.8,31,64,48.4,6,11,54.5,7,26,33,21,19,0,14,7,4,0,88,Viking Gdynia,Sezon 2005/2006
2005-10-29 17:00,Siarka Tarnobrzeg(w),60 : 62W,62,15,31,48.4,5,25,20.0,20,56,35.7,17,21,81.0,4,24,28,8,16,0,13,9,4,0,58,Viking Gdynia,Sezon 2005/2006
2005-11-05 18:00,Spójnia Stargard Szcz.(d),75 : 79P,75,24,42,57.1,5,15,33.3,29,57,50.9,12,18,66.7,4,18,22,16,21,0,9,7,3,0,80,Viking Gdynia,Sezon 2005/2006
2005-11-12 18:00,Grono Zielona Góra(d),72 : 79P,72,17,37,45.9,10,25,40.0,27,62,43.5,8,10,80.0,7,15,22,11,20,0,8,7,2,0,69,Viking Gdynia,Sezon 2005/2006
2005-11-19 18:00,Sportowiec Częstochowa(w),86 : 89W,89,22,40,55.0,10,23,43.5,32,63,50.8,15,22,68.2,11,22,33,15,29,0,11,6,1,0,95,Viking Gdynia,Sezon 2005/2006
2005-11-23 16:00,PBG Basket Poznań(w),84 : 90W,90,21,34,61.8,8,24,33.3,29,58,50.0,24,27,88.9,9,24,33,5,26,0,17,10,4,0,93,Viking Gdynia,Sezon 2005/2006
2005-11-26 18:00,Sokołów Znicz Jarosław(d),74 : 101P,74,20,36,55.6,6,19,31.6,26,55,47.3,16,18,88.9,5,11,16,15,26,0,11,7,1,0,71,Viking Gdynia,Sezon 2005/2006
2005-12-03 18:00,Znicz Basket Pruszków(w),86 : 75P,75,19,37,51.4,6,19,31.6,25,56,44.6,19,27,70.4,7,17,24,11,28,0,18,12,0,0,65,Viking Gdynia,Sezon 2005/2006
2005-12-10 18:00,CZELADZKI KLUB SPORTOWY 1924 (CKS) Czeladź(d),81 : 61W,81,23,45,51.1,8,19,42.1,31,64,48.4,11,12,91.7,6,19,25,9,16,0,15,8,2,0,76,Viking Gdynia,Sezon 2005/2006
2005-12-17 17:00,KS Legion Legionowo(w),62 : 61P,61,17,43,39.5,4,14,28.6,21,57,36.8,15,20,75.0,7,24,31,4,17,0,12,5,1,0,49,Viking Gdynia,Sezon 2005/2006
2006-01-08 17:00,KS AZS AWF Katowice(w),71 : 91W,91,25,45,55.6,6,14,42.9,31,59,52.5,23,30,76.7,8,23,31,13,18,0,16,12,5,0,101,Viking Gdynia,Sezon 2005/2006
2006-01-14 18:00,PTG Sokół Łańcut(d),86 : 81W,86,18,32,56.3,12,26,46.2,30,58,51.7,14,22,63.6,6,21,27,14,18,0,16,7,3,0,85,Viking Gdynia,Sezon 2005/2006
2006-01-18 18:00,Basket Kwidzyn(d),78 : 76W,78,21,40,52.5,7,18,38.9,28,58,48.3,15,18,83.3,5,25,30,9,17,0,11,4,6,0,83,Viking Gdynia,Sezon 2005/2006
2006-01-21 18:30,Stal Stalowa Wola(d),94 : 69W,94,27,41,65.9,8,20,40.0,35,61,57.4,16,18,88.9,6,27,33,15,24,0,15,8,6,0,113,Viking Gdynia,Sezon 2005/2006
2006-01-25 18:00,Górnik Wałbrzych(w),68 : 82W,82,18,30,60.0,10,25,40.0,28,55,50.9,16,17,94.1,5,17,22,11,16,0,9,6,6,0,90,Viking Gdynia,Sezon 2005/2006
2006-01-28 18:00,Siarka Tarnobrzeg(d),85 : 94P,85,20,40,50.0,8,35,22.9,28,75,37.3,21,24,87.5,13,25,38,11,29,0,17,4,4,0,75,Viking Gdynia,Sezon 2005/2006
2006-02-04 17:00,Spójnia Stargard Szcz.(w),58 : 68W,68,21,39,53.8,6,18,33.3,27,57,47.4,8,10,80.0,9,21,30,8,16,0,11,9,4,0,76,Viking Gdynia,Sezon 2005/2006
2006-02-08 19:00,AZS Politechnika Radomska(d),91 : 62W,91,26,39,66.7,8,26,30.8,34,65,52.3,15,23,65.2,9,28,37,13,21,0,14,7,2,0,97,Viking Gdynia,Sezon 2005/2006
2006-02-11 15:00,Grono Zielona Góra(w),73 : 54P,54,8,23,34.8,5,23,21.7,13,46,28.3,23,32,71.9,8,20,28,6,22,0,13,7,2,0,42,Viking Gdynia,Sezon 2005/2006
2006-02-18 18:00,Sportowiec Częstochowa(d),95 : 88W,95,23,32,71.9,9,30,30.0,32,62,51.6,22,26,84.6,9,24,33,17,21,0,12,8,0,0,107,Viking Gdynia,Sezon 2005/2006
2006-02-22 18:00,PBG Basket Poznań(d),79 : 81P,79,24,37,64.9,7,22,31.8,31,59,52.5,10,16,62.5,6,14,20,12,23,0,12,8,4,0,77,Viking Gdynia,Sezon 2005/2006
2006-02-25 17:30,Sokołów Znicz Jarosław(w),80 : 71P,71,19,38,50.0,9,28,32.1,28,66,42.4,6,10,60.0,5,12,17,13,19,0,12,8,4,0,59,Viking Gdynia,Sezon 2005/2006
2006-03-04 19:00,Znicz Basket Pruszków(d),87 : 73W,87,18,28,64.3,6,30,20.0,24,58,41.4,33,41,80.5,10,21,31,16,19,0,11,8,6,0,95,Viking Gdynia,Sezon 2005/2006
2006-03-11 18:00,CZELADZKI KLUB SPORTOWY 1924 (CKS) Czeladź(w),87 : 74P,74,13,30,43.3,11,25,44.0,24,55,43.6,15,17,88.2,2,24,26,14,19,0,14,8,5,0,80,Viking Gdynia,Sezon 2005/2006
2006-03-18 19:00,PTG Sokół Łańcut(w),78 : 65P,65,21,35,60.0,5,14,35.7,26,49,53.1,8,14,57.1,6,16,22,13,28,0,18,7,5,0,65,Viking Gdynia,Sezon 2005/2006
2006-03-19 16:30,PTG Sokół Łańcut(w),56 : 72W,72,17,31,54.8,6,18,33.3,23,49,46.9,20,27,74.1,4,28,32,14,23,0,14,7,4,0,82,Viking Gdynia,Sezon 2005/2006
2006-03-25 18:00,PTG Sokół Łańcut(d),91 : 69W,91,20,30,66.7,13,24,54.2,33,54,61.1,12,15,80.0,6,16,22,20,16,0,12,3,3,0,103,Viking Gdynia,Sezon 2005/2006
2006-03-26 18:00,PTG Sokół Łańcut(d),78 : 66W,78,23,31,74.2,7,22,31.8,30,53,56.6,11,12,91.7,6,18,24,13,19,0,16,8,4,0,87,Viking Gdynia,Sezon 2005/2006
2006-04-01 20:00,Grono Zielona Góra(w),68 : 77W,77,23,38,60.5,4,17,23.5,27,55,49.1,19,23,82.6,5,24,29,9,17,0,12,6,4,0,81,Viking Gdynia,Sezon 2005/2006
2006-04-02 17:00,Grono Zielona Góra(w),66 : 55P,55,15,33,45.5,5,18,27.8,20,51,39.2,10,14,71.4,9,30,39,10,25,0,19,4,1,0,55,Viking Gdynia,Sezon 2005/2006
2006-04-11 19:00,Grono Zielona Góra(d),73 : 58W,73,21,35,60.0,6,24,25.0,27,59,45.8,13,15,86.7,7,23,30,9,21,0,15,13,4,0,80,Viking Gdynia,Sezon 2005/2006
2006-04-12 19:00,Grono Zielona Góra(d),78 : 91P,78,17,35,48.6,7,24,29.2,24,59,40.7,23,25,92.0,7,21,28,12,28,0,11,4,2,0,76,Viking Gdynia,Sezon 2005/2006
2006-04-19 18:00,Grono Zielona Góra(w),43 : 60W,60,11,37,29.7,8,17,47.1,19,54,35.2,14,15,93.3,6,31,37,8,20,0,12,6,3,0,66,Viking Gdynia,Sezon 2005/2006
2006-04-22 20:30,Sokołów Znicz Jarosław(d),94 : 94P,94,21,35,60.0,9,25,36.0,30,60,50.0,25,28,89.3,9,21,30,13,24,0,9,7,4,0,106,Viking Gdynia,Sezon 2005/2006
2006-04-26 18:00,Sokołów Znicz Jarosław(w),93 : 75P,75,18,45,40.0,3,14,21.4,21,59,35.6,30,33,90.9,5,19,24,13,26,0,12,8,2,0,69,Viking Gdynia,Sezon 2005/2006
